----------------------------------------------------------------------------------------------------------------------------------------------------------------
-------------------------------------------------------------------xxx------------------------------------------------------------------------------------------
x-----------------------------------------------------------------xx--x-----------------------------------------------------------------------------------------
-x---------------------------------------------------------------xx----x----------------------------------------------------------------------------------------
--x-------------------------------------------------------------xx------x---xxx---------------------------------------------------------------------------------
---xxx--------------------------------------------------------xxxE-------xxxx--x--------------------------------------------------------------------------------
---XX-x-------------------------------------xxxxxx-----------xx-<>-------XXXX---x--oo------------------------------------------------xxxx------------QQQ?QQQQQQQ
-------x----oo----oo-----XXX---XXX---XXoo--xxXXXX-x---------xx--[]---------------x------------------?Q-------------------------------x<>-x----------------------
--------x---------------------------------xx-------x----xxxxx---[]----------------x--------------------------------------------------x[]--x---------------------
---------x-xxx---xxx----xxxx---xxx--xxxxxxx---------xxxxx--xE---[]-----------------x-------------------------xxxx-------------------xx[]---x--------------------
----------xx--xxxx--xxxxx---xxxx--xxx----x---------XXXXXX--<>---[]------------------xxxxxx---xxxx--QQ---S---xx---x-----------------xxS[]----x----------SSSSSSSSS
----------XX--XXXX--XXXXX--XXXXX-XXXX----XX-------E--------[]---[]------------------XXXXX-x-xx---x---------xx-----x---------------xx--[]-----x------------------
-----------------------------------------------------------[]---[]-------------------------xx-----x-------xx-------x-------------xx---[]------x-------E---E-----
-----------------------------------------------------------[]---[]-------------------------xX------xxxxxxxx---------xxxxxxxxxxxxxx----[]-------xxxxxxxxxxxxxxxxx
-----------------------------------------------------------[]---XX-XXX---------------------XX-----XXXXXXXXE--------XXXXXXXXXXXXXXXXXXXXXXXXXXXXXXXXXXXXXXXXXXXXX
--------------------------XX-------------------------------[]---XX-----------------------XXXX-----X----------------XXXXXXXXXXXXXXXXXXXXXXXXXXXXXXXXXXXXXXXXXXXXX