----------------------------------------------------------------------------------------------------------------------------------------------------------------
----------------------------------------------------------------------------------------------------------------------------------------------------------------
----------------------------------------------------------------------------------------------------------------------------------------------------------------
-----------------------------------------------------------------------------------------------------------XXXX-------------------------------------xxx---------
------------------------------------------------------------------------------------------------------------[]-------------------------------------xxSS---------
------------------------------------------------------------------------------------------------------------[]------------------------------------xx------------
-----------------------------QQQ?QQQQQQQQ?QQQQ--------------------------------------------------------------[]-------xxxx--------?-----o---------xx---------oooo
---x---------------------------------------[]---------------------------------------------------------------[]-------x<>-x-------E--------------xx---------XXXXX
----x--------------------------------------[]---------------------------------------------------------------[]-------x[]--x---------E----------xxXXX------------
-----x----xxxx-----------------------------[]---------------------X-EE--------------------------------------[]------xx[]---x-------<>-----xxxxxx----------------
------x--xx---xx---------------SSSSSSSSSSS-<>---------------------XSSSSSS-----------?QQQQQ?QQQQQ?QQQQQQQ?Q--<>-----xxS[]----x------[]----xx--QQQ----------------
-------xxx---XX-xxxx----------------------------------------------------------------------------------------------xx--[]-----x-----[]----x----------------------
--------x-------XX--xxx-------E---E--------xxx----------------xxx------------------------------------------------xx---[]------x----[]---------------------------
--------B-----------XX-xxxxxxxxxxxxxxxxxxxxxE-xxxxxxxxxxxxxxxxx--xxxxxxxxxxxxxxxxxxxxxxxxxxxxxxxxxxxxxxxxxxxxxxxxx----[]-------xxxx[]---------------------------
----XXXXX-----------XXXXXXXXXXXXXXXXXXXXXXX<>-XXXXXXXXXXXXXXXXX--XXXXXXXXXXXXXXXXXXXXEXXXXEEXXXXEEXXXXXEXEXXXXXXXXXXXXXXXXXXXXXXXXXXX-------XXXX----------------
X---XXXXX-----------XXXXXXXXXXXXXXXXXXXXXXX[]-XXXXXXXXXXXXXXXXX--XXXXXXXXXXXXXXXXXXXXXXXXXXXXXXXXXXXXXXXXXXXXXXXXXXXXXXXXXXXXXXXXXXXX---X---XXXX------XXXXXXXXXX