----------------------------------------------------------------------------------------------------------------------------------------------------------------
----------------------------------------------------------------------------------------------------------------------------------------------------------------
----------------------------------------------------------------------------------------------------------------------------------------------------------------
----------------------------------------------------------------------------------------------------------------------------------------------------------------
--XXXX----------------------------------------------------------------------------------------------------------------------------------------------------------
--------------------------------x-------------------------------------------------------------------------------------------------------------------------------
--------------------------x---xxx---X---------------------------------------------------------------------------------------------------------------------------
-------------------------xx--xxXX--XX----------------------------------------------------------------------?--SSSSSSS----------------------------------------Q--
------------------------xxE-xxXXX-XXX---------------------------------------------------------------------------------------------------------------------------
-----o-----------------xxEXxxXXXXXXXX----------------------------------------------------------------------------------------------------------E----------------
-----------o----------xxXXXxXXXXXXXXX----xxxx---------------------------------------------------------------------------------------------------------E---------
----------XXX--------xxXXXXXXXXXXXXXX---xx<>-x-----------B---------------------xxxx-----------------QQ?QQ--Q---SSS-----------------------S--------------xxxx-?--
--------------------xxXXXXXXXXXXXXXXX--xx-[]--x----------b--------------------xx<>-x------B-----E---------------------E--------------------------------xx<>-x---
-------------------xxXXXXXXXXXXXXXXXX-xx--[]---x---------B-----xxxxx---------xx-[]--x-----b-----------------------------------------------------------xx-[]--x--
-------------------xXXXXXXXXXXXXXXXXXxx---[]----xxxxxxxxxxxxxxxx--X-xxxxxxxxxx--[]---xxxxxxxxxxxxxxxxxxxxxxxxxxxxxxxxxxxxxxxxxxxxxxxxxxxxxxxxxxxxxxxxxx--[]---xx
------------XXXXXXXXXXXXXXXXXXXXXXXXXXXXXXXXXXXXXXXXXXXXXXXXXXXX----XXXXXXXXXXXXXXXXXXXXXXXXXXXXXXXXXXXXXXXXXXXXXXXXXXXXXXXXXXXXXXXXXXXXXXXXXXXXXXXXXXXXXXXXXXXX