-----------------------------------------------------------------------------------------XX--------XXXXXXXXXXXXXXXXXXXXX----------------------------------------
-------------------------------------------------------------------------------------XXX-[]--XXXXE-X---xxxxxxxxxxxxxxxxx----------------------------------------
---------------------------------------------------------------------------------------x-[]---xxxx-X--x---------------------------------------------------------
--------------------------------------------------------------------------------------xxx<>--x---xxX-x----------------------------------------------------------
-------------------------------------------------------------------------------------x--xxx-x-----xxx--------S--------------------------------------------------
------------------------------------------------------------------------------------x-----xx----------------------------------XXX-------------------------------
-----------------------------------------------------------------------X----------xx----------------------------------------------------------------------------
-----------------------------------------------------------------------x----------------------------------------------------------------------------------------
----------------------------------------------------------E-----------xxx-----------------------------------------XX-----XX------X------------------------------
----------------------------------------------------------------xxxxxx-ExxXXXX--------------------------------------------x---XXX-----XXX----------------------E
--------------------------------------------------?QQ---------xxx--------xxxxx-------------------------------------------xxxxxxxx-----xxx---------------------xX
--XXX--------------------oo----------------oo----------------xxXX-------------------------------------------------------x-------xx---x--xx-------------------xxX
-------------------------oo-----xxx--------oo---------------xxXXX----------------------------------------------------------------xx-x----x------------------xxXX
---------xxxxxxxxxxxxxxxxxxxxxxxxE-xxxxxxxxxxxxxxxxxxxxxxxxxxXXXX-------------x--x------------------------------------------------xx---------------xxxxxxxxxxXXX
------XXXXXXXXXXXXXXXXXXXXXXXXXX<>XXXXXXXXXXXXXXXXXXXXXXXXXXXXXXX-------------xxx------------------------------------------------------------XXXXXXxXXXXXXXXXXXX
------XXXXXXXXXXXXXXXXXXXXXXXXXX[]XXXXXXXXXXXXXXXXXXXXXXXXXXXXXXX----------------------------------------------------------------------------XXXXXXXXXXXXXXXXXXX