----------------------------------------------------------------------------------------------------------------------------------------------------------------
----------------------------------------------------------------------------------------------------------------------------------------------------------------
----------------------------------------------------------------------------------------------------------------------------------------------------------------
----------------------------------------------------------------------------------------------------------------------------------------------------------------
----------------------------------------------------------------------------------------------------------------------------------------------------------------
----------------------------------------------------------------------------------------------------------------------------------------------------------------
---------------E------------------------------------------------------------------------------------------------------------------------------------------------
--------------SQS-----------------------------?----------------------------------------------------------------XXX-------E--------------------------------------
-------------------------------------------------------------------------------------------------------------------------------------------------------xx-------
---------------------------------------------------------------------------------------------------xxxx--xxxx--xxx-------xx-xxxxx--------------xxx----xx--------
--------------------------------oo----------------xxxx-?-----------E---ooo---------------------xxxxx---xxx---xxx--xxx---xx-xx----xS--------xxxxx--x--xx--------x
--------------SQS--------------o-----------------xx<>-x-----------<>--------------------------xxXXXX---XXX---XXX-XXX-x-xx--XX-----x-------xx-XXX---xxx---x----xx
--------xxxx------------------------------------xx-[]--x---------------------E---------------xx--------XX-------------xx-----------x-----xx--XX-----x-----x--xxX
------Exx<>-x-------------------------xxx------xx--[]---x--------xx--------------xxxxx------xx-----------------------XXX------------xxxxxxX--------<>------xxxXX
xxxxxxxx-[]-Exxxxxxxxxxxxxxxxxxxxxxxxxx--xxxxxxx---[]----xxxxxxxxx-xxxxxxxxxxxxxxx----xxxxxxx---------------------------------------XXXXXXX--------[]-------xXXX
XXXXXXXXXXXXXXXXXXXXXXXXXXXXXXXXXXXXXXX--XXXXXXXXXXXXXXXX<>XXXXXXXXXXXXXXXXXXXXXXX---XXXXXXXXXXX------------------------------------XXXXXXX--------XXXXXXXXXXXXX