----------------------------------------------------------------------------------------------------------------------------------------------------------------
-------------------------------------------------------------------------------------------------------------------------x-x------------------------------------
x-----------------------------------------------------------------xx-o-----------------------------------x-x-x-x-x-x-x-x-x---x----------------------------------
-x---------------------------------------------------------------xx--------------------------------------S-S-S-S-S-S-S-S-Sx-x------------------x---x-x---x------
--x--------------------------------------------------------xxxxxxx---xox----------------------------------x-x-x-x-x-x-x-x------x-----------------x-------xx-----
---x------------------------------------------------------xx----x---xXo-----------------------------------S-S-S-S-S-S-S-S-----x--------------x---x--x--x--x-----
----x-------------xxx-----------E----xXXX----------------xxX---XX-----x--x-----------------------------x-------------------------x-----------x--xXx---xXx-------
-----x---------xxxx--x----oo----xxxxx-------------------xx------------X-xo---------------------------x--------------------------x----------x--x----X----x-------
----oox-------xxXXX---x--------xx-XX-xx----------------xx----ooooooo-------x-------------------------xx-x--------------------------x-----x-xx-X-X-------X-------
-------x-----xx--------x-xxx--xx-------x------------xxxx-----ooooooo----o-x----------------x-x-x-x-x--x------------X-X------------x----x----x-X-----------------
--------x---xx----------xx--xxx---------x----------xx--E-----------E---------x-x-x-x-------x-X-X-X-Xx------X-X-----------------------x-xx-x-X-X----------------X
---------xxxx-----------XX--XXX----------x--xxxxxxxx-XXX----------<>--------xX-X-X-X-x---x--x-x-x-x-x---------------X---------------x---x-x-X-X----E------------
---------XXXXXXXX-------------------------xxx-----x----------E----[]----------x-x-x-x--x-xx-X-X-X-X-X-------X---->-----------E--------x---X-X-X---->----------X-
------------------------------------------XXX----XX---------<>----[]----------X-X-X----X-Xx----------------------]----------->-X-X-X-Xx---X-X-X----]------------
------------------------------------------------------------[]----[]-----X-X----------x-x-----------------------<X---------X-]-X-X-X-XB---X-X-X---<]------------
----XXXX-----------------------------------X----------------[]----[]-----X-X----------X-X-----------------------[X---------X<[XXXXXXXXXX--XXXXXX--[[------------