----------------------------------------------------------------------------------------------------------------------------------------------------------------
----------------------------------------------------------------------------------------------------------------------------------------------------------------
xx-----------------xxxxxx---------------------------------------------------------------------------------------------------------------------------------------
--xxxxxxxxxxxxxxxxxx-XXX----------------------------------------------------------------------------------------------------------------------------------------
--SSSSSSSSSSSSSSSSSS-----------------------xx------------------------------------------------------------------------SSSSSSSSSSSSSSSSSSSSSSSSSSSSSSSSSSSSSSSSSSS
--SSSS-------------------x----------------xx--------------------------------------------------------------------------------------------------------------------
--SSSS--------------------x--oo---E------xx--------------------------------------------------------------------------------E------------------------------------
--SSSS---------------------x------xxxxxxxx-------Q-------------------------------------------------------------------------SS-----------------------------------
----------------------------x----xx-XXXXXX---------------------------------------------------------------------------------SS----------xx-----------------------
-----------------------------x--xx-----------------------------------------------------------------------------------------SS---------xx-x-xxx-x----------------
----E-------------------------xxx------------x---------------------------------E-------------------------------------------SS--------xx---xx--x-x---------------
---<>---------E---------------XXX-------------xx-?----------------------------<>-------------------------------QQQQ--------SS------xxx----<>-----xx-----xxxx---x
---[]--------<>----XX------------------------<>-x---------------------------------------------------------------------------------xx<>----[]----XX-xx--xxSS-x-xx
---[]--------[]---XXXXXX---------------------[]--x----xxx------------xxxxx----------x----xxx-------------------------------------xx-[]----[]----XXXX-xxx-SS--xxX
---[]--------[]-EXXXX------------------------[]---xxxxxE-xxxxxxxxxxxxx--X-xxxxxxxxxxxxxxxx--xxxxxxxxxxxxxxxxxxxxxxxxxxxxxxxxxxxxxx--[]----[]--E-XXXX--x--SS--XXX
XXXXXXXXXXXXXXXXXXXX------------------------XXXXXXXXXXXXXXXXXXXXXXXXXX--XXXXXXXXXXXXXXXXXX--XXXXXXXXXXXXXXXXXXXXXXXXXXXXXXXXXXXXXXXXXXXXXXXXXXXXXXXXXXX--XX--XXX