----------------------------------------------------------------------------------------------------------------------------------------------------------------
----------------------------------------------------------------------------------------------------------------------------------------------------------------
----------------------------------------------------------------------------------------------------------------------------------------------------------------
----------------------------------------------------------------------------------------------------------------------------------------------------------------
----------------------------------------------------------------------------------------------------------------------------------------------------------------
----------------------------------------------------------------------------------------------------------------------------------------------------------------
----------------------------------------------xxx-------------------------------------------------------------------------xxx-----------------------------------
-------------------------------SSS-----------xx--xx-----------------------Q------------SQSS--------------E-------------xxxx--x----------------------------------
--------------------------------------------xx-----x------------------------------------------------------------XXX---xxXXX---x---xxx--------------oooo---------
-------------------------------------------xx-------x----------------------------------------------------xx-xxxxx--X-xx--------xxxx--x--------------------------
---------------------B---------SSS-------xxx--o------x---ooo---------------------------------xxxxxxxx---xx-xx----x--xx---------XXXX---xxx-----------------------
---------------------b---S--------------xx<>----------xxx---------------S?SQS----------S?SS-xxXXXXXX-x-xx--XX------xx--------------------x------xxx------S------
------------------B--------------------xx-[]----------<>-x---------E-----------xxx---------xx---------xx----------xxXXXXX-----------------x----xxX-x------------
------------xxxxx-b----------xxxxx----xx--[]----------[]--x-------------------xxX-x-------xx---------XXX----------XX-----------------------x--xx-X--x-----------
---xxxxxxxxxx----xxxxxxxxxxxxx----xxxxx---[]----------[]---xxxxxxxxxxxxxxxxxxxx-X--xxxxxxxx---------------------------------------XXX-------xxx--X---xxxxxxxxxxx
XXXXXXXXXXXXX---XXXXXXXXXXXXXX----XXXXXXXXXXXXXXXXXXXXXXXXXXXXXXXXXXXXXXXXXXXXXXXXXXXXXXXXXXXX--------------------------------------------XXXXXXXXXXXXXXXXXXXXXX