----------------------------------------------------------------------------------------------------------------------------------------------------------------
----------------------------------------------------------------------------------------------------------------------------------------------------------------
x---------------------------------------------------------------------------------------------------------------------------------------------------------------
-x----------------------------------------------xxx-----------xxx-----------------------------SSSSSSSSSSS-------------------------------------------------------
--x-ooxxx--------------------------------------xx--x---------xx--x---------------------------------------SSSSSSSSSSSSSSSSSSSSSSSSSS-----------------------------
---xxxx--x----------------xxxx----------xxx---xx----x-xxx---xx----x-xxx----------------------------------------SSSS------------------------XXXX-----------------
---XXXX---x--xxx---------xx---x--------xx--x-xx------xx--x-xx------xx--x-------------oo--------xxxxxxxxx-------SSSS----------------xxxxxx-----------------------
-----------xxx--xoo-----xx-----xx-----xx----xx-------XX---xx-------XX---xoo--------------------xSSSSSSSSS-------S------------------xx----x----------------------
-----------XXX---x--xxxxx--------xxxxxx-----XX------------XX-------------x--xxxxxxxxx----------xSSSSSSSSS-------S----------------xxx------x---------------------
------------------xxx--x----------x--x------------------------------------xxx--------x------xxxxSSSSSSSSS-------S---------------xx-----------------------------x
------------------XXX-XX----------S-XX-------o-------------o--------------XXX---------xxx--xx--?SSSSSSSSS-------So??-----------xx----------------------------xxx
---E------------------XXX-----------XXX------o--XX---------o--XX----------------------XX-xxx------------S-------SSS----------xxx----------------------------xx<>
--<>--------------------------------------------------------------------------------------x---------------------------------xx<>-----------<>--x-----------xx-[]
--[]--------------------------------------------------------------------------------------X--------------------------------xx-[]-----------[]---x---------xx--[]
-X[]XXXXX---------------------------------------------------------------------------------X---XXXXXXXXXXxxxxxxxxxxxxxxxxxxxx--[]-----------[]----xxxxxxxxxx---[]
------------------------------------------------------------------------------------------X---XXXXXXXXXXXXXXXXXXXXXXXXXXXXXXXXXXXXXXXXXXXXXXXXXXXXXXXXXXXXXXXXXX