----------------------------------------------------------------------------------------------------------------------------------------------------------------
----------------------------------------------------------------------------------------------------------------------------------------------------------------
x---------------------------------------------------------------------------------------------------------------------------------------------------------------
-x--------------------------------------------------------------------------------------------------------------------------------------------------------------
--x---------------------------------------------------------------------------------------------------------------------------------------xxx-------------------
---x------------------------------xxxx---------------------------------------------------------------------------------------------xxxxxxxx--x------------------
----x------oo-----------xxx--SS--xx---x-------------------------------------------------------------------------------------------xxXXXXXXX---x-----------------
-----x-----------------xx--x----xx-----x-----------------------------------------------------------------------------------------xx------------x----------------
------x---------------xx----x--xx-------x------------------------------S--------------------------------------------------xxx---xxX-----------oox---------------
-------x----------xxxxx-----oxxx---------xxxxx------------------------------------------------------------------------xxxxx--x-xxXX--------------x--------------
--------x--------xx--xX-----XXXXEXX-------xXX-x--------------------------------------------------xxxx----------------xxXXXX---xxXXX---------------x-------------
------X--x------xx---XX-------------------XXX--x---------------------------------------------QQ-xx-X-x--------------xx--------xXXXX----------------x--------xx--
------X---x----xx----XXX-----------------XXXX---x---------------xxxxxxxxx----------------------xx--XX-x------------xx---------XXXXX-----------------x-----xxx-x-
------XX---x--xx-----XXX----------------XXXXX----xxxxxxxxxxxxxxxxE-----X-x----xxxxx-----------xx---XXX-x-----xxxxxxx----------XXXXX------------------x---xx<>--x
------XX---ExxxX-----XX-----------------XXXXXXXXXXXXXXXXXEEXEXXX<>-----X--xxxxx----xxxxxxxxxxxx----XXXX-xxxxxx--XXXXXX--------XXXXX-------------------xxxx-[]XXX
XXXXXXXXXXXXXXXX-----XX-----------------XXXXXXXXXXXXXXXXXXXXXXXX[]-----X--XXXXX----XXXXXXXXXXXX--XXXXXXXXXXXXX----------------XXXXX-----------XXXXXXXXXXXXXXXXXX