----------------------------------------------------------------------------------------------------------------------------------------------------------------
----------------------------------------------------------------------------------------------------------------------------------------------------------------
x---------------------------------------------------------------------------------------------------------------------------------------------------------------
-x----------------?---------------------------------------------------------------------------------------------------------------------------------------------
--x-----------xxx---xxx--------------------------------xx-------------------------------------------------------------------------------------------------------
---xxxxxxxxxxxx--xxxx--x---------------------------------x------------------------------------------------------------------------------------------------------
---XXXXXXXXXXXX--XXXX---x----x---x------------------------x------oo--------------------------------------------------------------------------xx-----------------
-------------------------x----x---x------------------------x-------------------------------------------------------------------S---------------x-----------SSSS?
--------------------------x----x---x------------------------x-----------------------------------------------------------------------------------xxx-------------
---------------------------xx---x---x------------------------x-------------------------------------------------------------------------------------x------------
----------------------XXXXXX---------x-------------B----------x------------------------------------o------------------------------------------------x-------E---
--------------------------------------x------------b-----------x------xx--------------------xxxxx------------B-------xxxx----------xxxx--------------x----SSSSSS
---------------------------------------xx-----?-B---------------x----xx-x---------B--------xx-<>-x-x---------b------xx---x--------xx<>-x--------------xx--------
-----------------------------------------x------b----------------x--xx---x--------b-------xx--[]--x-xxxx-----B----ExxX----x------xx-[]--x------------<>-x-------
------------------------------------------xxxxxxxxxxxxx------X-E-Exxx-----xxxxxxxxxxxxxxxxx---[]-----x--xxxxxxxxxxxx-X-E---xxxxxxxE-[]---xxxx--------[]--xxxxxxx
----------------------------XXXXXXXXXXX---XXXXXXXXXXXXX------XXXXXXXX-----XXXXXXXXXXXXXXXXX--XXXXXX--X--XXXXXXXXXXXXXXXXXXXXXXXXXXXXXXXXXXXXXXXXXXXXXXXXXXXXXXXX