----------------------------------------------------------------------------------------------------------------------------------------------------------------
----------------------------------------------------------------------------------------------------------------------------------------------------------------
x---------------------------------------------------------------------------------------------------------------------------------------------------------------
---------------------------------------------------------------------------------------------------------------------------------------------------------------x
---------------------------------------------------------------------------------------------------------------------------------------------------------------X
-------E-------------------------------------------------------------------------------------------------------------------------------------------------------X
-----------------------------------------------------------------------oo-------------------------------------------------------------E------------------oo----X
---------------E--------------------------------------?-----------------------------------------------------------------------------SSSSS----SSSS--------------X
--------------SSSS-------------------------------------------xxxx----------------------------------------------------------------------------------------------X
-xx---------------------------------------------------------xx---x-----------------------xxxxx----xxxxxx-------------------------------------------------------X
---x------X-E--E-------------------------------------------xx-----xxx------------------xxx----x-xxx---S-x-------------------------------------E----xxxx--------X
----x-----XS?SSSSS---X-----------------------------------xxx------<>-x----Q-----------xx<>-----xx<>------xx----------------------------------SSSS-xx<>-x-------X
-----xxxx---------EE-X----------------------------------xx<>------[]--x--------------xx-[]----E<>[]-----<>-x---------xxx-------------E----E------xx-[]--x------X
-E-------xSSSSSSSSSSSX-------------------xxxxxx--------xx-[]------[]---x------------xx--[]---<>[][]-----[]--x-------xxB-x-----xxxxx-------------xx--[]---x-----X
<>--------xxxxxxxxxxxxxxxxxxxxxxxxxxxxxxxx--EE-xxxxxxxxx--[]-E----[]-E-Exxxxxxxxxxxxx---[]---[][][]-----[]---xxxxxxxx-b--xxxxxx----xxxxxxxxxxxxxx---[]-E-ExxxxxX
[]XXXXXXXXXXXXXXXXXXXXXXXXXXXXXXXXXXXXXXXX--XXXXXXXXXXXXXXXXXXXXXXXXXXXXXXXX<>XXXXXXXXXXXXXXXXXXXXXXXXXXXXXXXXXXXXXXXXXXXXXXXXX---XXXXXXXXXXXXXXXXXXXXXXXXXXXXXX