-------------------------------------------------------------XXXXXXXXXXXXXXXXX-X-XoXoXoX-X-XoXoXoX-X-XoXoX-XxXxXEX[X-X-XxXxXxXxXxXxXXXXXXXX--X-XXX-X-X-XxXx-----
------------------------------------X-X----------------------X-XxXxXxXxXxXXXXX-X-X-X-X-X-X-X-X-X-X-X-X-X-X-X-XxX-X[X-X-X-X-X-X-X-X-X-X-X-X-----XXX-X-XxX-X-XX---
xx----------------------------------x-x----------------------XxX-X-X-X-XxXXXX----oooooo----oooooo----oooo-x--x--x-[]--x--x-x-x-x-x-x-X-X-X------X------xEx-xX---
--x---------x---------------x-x-x-x--Xx---X---------------X-xX-x-x-x-x-x-XxXX------------------------------x---xx-<]---x------------------------X---x-------x-X-
---x--------x-x-x---------x-----x----x--x-x---------------x--x-----------xxXX-S-SoSoSoS-S-SoSoSoS-S-SoSox------x--x]x---------------------?----------x------x-x-
----xxxxxxxxS-S-X-x-------xx-x-xEx-x---xx--Xx------------X---------------x-Xx-x-x-x-x-x-x-x-x-x-x-x-x-x--x-------x->-x--------------------x-------x----------X-X
----SSSSSSSS-x-xXx------x-Xx-----------x---xx---X-X-X---x--x---------------x-S-S-S-S-S-S-S-S-S-S-S-S-S-S---------x-x----------------------x-xx-----x---------x-x
-------------S-SX-------xxXXX-----------Ex-x--x-x-x-x----x-----------------x-x-x-xEx-x-x-x-xEx-x-x-x-xEx--------------------X-----------x----xS-x---------------
----------------X-------XxXX-----------------x-X-X-Xx-x------------------------E---------E---------E-------------------------------------x-x-xx--x--------------
-----------E----X-----XxXXXX-X---------------x-x-x-x---x---------------------------------------------------------------------X--------x------x------------------
----------<>----X-----XxXXXX-----------------E-------x------------------------------------------------------------------------------x--x-------x----------------
----------[]---?X---X-XXXXXX------------------------------------------------------------------------------------------------------------------------------------
----------[]----X---XXXXXXXX<--------------------------------------------------------------------------------------------------------x-------S------------------
->--------[]X-X-X-X-XXXXXXXX[E----------------------------------------------------------------------------------------------------------------------------------
<>XXXXXXXXXXX-X-X-XXXXXXXXXX[>----------------------------------------------------------------------------------------------------------------------------------
[]XXXXXXXXXXXXXXXXXXXXXXXXXX]]----------------------------------------------------------------------------------------------------------------------------------