-------------------------------------------------X[X-X-----------]]-----xx-x--x--]]--X-XXXXXXXX----]>--E-[[[[----]]----[[---X------------[<----[[X-X-X-XxXxXxXxX
-------------------------------------------------X[X-X-----------]]------X-X-XxX-X]X-X-XXXXXXXX----XEX-X-X<X<X-X-X>X-X-X[------------X---X-X-X-X[X-X-X-X-X-X-X-X
--------------------------------------------------[X-X-----------[]---x--X-X-X-XxX>X-X-X-XXXXXXX---X-X-X-X-X-X-X-XEX-X-X<X------X-X--X-X---X-X-X[X-X-XxX-X-X-X-X
--------------------------------------------------[X-X-----------[>--------x-x--x[x----X-XXXXXX----[-------]-]---[---E---]-----------------]----[X-X-X-X-X-X-X-X
--------------------------------------------------[]-------------[-----------x---[x-S--X-X-X-X-----<-------]-]---[-------]----------------->----[]-------x-x-x-x
--------------------------------------------------[]-------------[-----x-------x-[--x----X-X-X------------->->---<-------]----------------------<]-----x--------
-----oo-------------------------------------E-----<]------X------[--x----------x-<--x----X-X-X-------------E-E----------->-------X--------------x]--------------
----------------------------x-x------------->------]------x------<---x-----------x--x-S----X-X-----------------S---------E-----------------------]x-------------
------------------<---------x---x--------?--]------]----x-x------------------------xx-x-S--------------------------------------------------------]x-x-----------
------------------[-------x--------------E--]---x-x]x-x-----x----------------------x----x-S-?-?-S-S-S-S-S-S-S-S-S-S-S-S-S-S-S-S-S-S-S------------>-----------E--
--------------X-X-[-------x-------x---------]------>x----X--x---S-S--X--------------------x-x-x-x-x-x-x-x-x-x-x-x-x-x-x-x-x-x-x-x-x-x--E---------x--------------
--------?---------[E----x---Ex-x----x-x-x-x<]------E-----x----x-x-x------------------S-S---------------------------------------------------------x---X----------
-------------X-X--X>X-X-X-XxXX------X-X-X-X[X------x-------x-------------------------x-x-S---------------------------------------------------------x-x----------
------------------X]X-X-X-XxXX---x--X-X-X-X[X----x-x---x---x---------------------------x-x-S-?-?-S-S-S-S-S-S-S-S-S-S-S-S-S-S-S-S-S-S-S---------------x----------
------------------X]X-X-XxX-XX----X-X-X-X-X[---------x-------x---S-S---------------------x-x-x-x-x-x-x-x-x-x-x-x-x-x-x-x-x-x-x-x-x-x-x--------------------------
X---XXX-----------X]X-XxXxX-XX----XxExXxXxX[---------x-------x-x-x-x--------------------------------------------------------------------------------------------