----------------------------------------------------------------------------------------------------------------------------------------------------------------
----------------------------------------------------------------------------------------------------------------------------------------------------------------
----------------------------------------------------------------------------------------------------------------------------------------------------------------
----------------------------------------------------SSS---------------------------------------------------------------------------------------------------------
------------------------------------------------------[---------------------------------------------------------------------------------------------------------
------------------------------------------------------[>--------------------------------------------------------------------------------------------------------
------------------------------------------------------[]--------------------------------------------------------------------------------------------------------
---------------xxxE-----------------------------------<S-------------------?-------------------------------------SSQSSS?SSS-------------------------------------
------------xxxx--x---------------------------------------------------------------------------------------------------------------------oooo--------------------
-----------xxXXX---x------xxx-----------------------------------------------------------------------------------------------------------------------------------
-----xxxxxxx--------xxxxxxx--xS--------------------------------------------------------xx-----------------------------------------------------------------------
----xxXXXXXX--------XXXXEXX---x------------------------x----------------Q--Q-------QQ-xx-xxxxxxxxxx--------------SSSSSSSSSS-----------------------------------x-
---xxXXX------------------X----x---------------------xxxx----------------------------xx--XXXXXXXXX-x-------------------------xxxx----------------------------xx-
-xxxXXX-------------------X-----xxxxxxxxxxxxxxxxxxxxxx---x--------------------------xx--------------xxxxxxxx------------xxxxxx<>-x--------------------------xxX-
XXXXXXX----------ooo------X-----XXXXXXXXXXXXXXXXXXXXXX----xxxxxxxxxxxxxxxxxxxxxxxxxxx----------------x-x--X-xxxxxxxxxxxxx---x-[]--xxxxxxxxxxxxxxxxxxxxxxxxxxxXXx
XXXXXXX----------XXX------X-----XXXXXXXXXXXXXXXXXXXXXX----XX<>XXXXXXXXXXXXXXXXXXXXXXX--XX------------X-X--XXXXXXXXXXXXXXX-X-XXXXXXXXXXXXXXXXXXXXXXXXXXXXXXXXXXXX