-------XXXXXXXXXXXXXXXXXXXXXXXXXXXXXXXXXXXXXXXXXXXXXXXX---XXXXXXXXXXXXXXX----------------------------------------XX---------------------------------------------
--------------XXXXXXXXxxxxxxxxxxxxxxxxxxxxxxxxxxxxxxxxx-----E-[]---xxxxxx-----------XXXXXXXX---------------------XX-XXX-----------------------------------------
---------------XXXXXXX----------------------------------------[]--x-----xx-----------xxxxxxx---------------------[]---------------------------------------------
---------------EXXXXXX-------------------E--------------------<>-x-------xxXXXXXXXX-x------xx--------------------[]---------------------------------------------
-----------------XXXXX-----------------------?QQQX--------x----xx-?-------xxxxxxxxxx--------xx-------------------[]----------------------XXXXXX--XXXXXXXX--XXXX-
------------------XXXX---------------------------X------XXxx--x------------------------------xx-XXXX-----XXXX----[]----------------------xxxxxx--xxxxxxxx--xxxx-
--o-o-------------xEXX---------------------------------E---xxx--------------------------------xxxxxx------xxx----[]---------------------x-----xxx-------xxx---xx
-----------------xxxXX-----------------------------------------------------------------------------xxxxxxx--xx---[]-----------------xxxx------------------------
----------------x--xxX-------------------------S------------------Q------------------------------------------xx--[]------------XX--------------oo--------oo-----
---------------x----xx----------------------------------------------------------------------------------------xx-<>------------xx-------oo----------------------
--------------x------x-----------------------------------------------------------------------------------------xxxE-----------x-xx------------------------------
--XXX-------xx---------------------------------------------------------------------------------------------------xx-----x----x-?-xx-----------------------------
------------------------------------------------------------------------------------------------------------------xx----xx--x-----xx----------------------------
-------------------------------------------------------------------------------------------------------------------xx--x-xxx------------------------------------
--------------------------------------------------------------------------------------------------------------------xxx-----------------------------------------
----------------------------------------------------------------------------------------------------------------------------------------------------------------