----------------------------------------------------------------------------------------------------------------------------------------------------------------
------xxx-------------------------------------------------------------------------------------------------------------------------------------------------------
x----xx--x----------------------------------------------------------x----S-?-S-S-S-S-S-S-S-S-S-S-S-S------------------------------------------------------------
----xx----x------------------------------------------------------xxxx--------S-S-S-S-S-S-S-S-------[-------------------------x-x-x------------------------------
---xx------------------------------------------------------------XXXX-----S-SSSSSSSSSSSSSSSSS-S-S-S[S------------------------x-----x-x-x------------------------
-xxx-------------------------------------------------------------XXXX-------SSSSSSSSSSSSSSSS-------[]----------------------x-Xx-x-xX-X-X------------------------
-XXX---------------------------SSSS-----------xxx---xxxxxx-------XXXX-xxxx-xSxS-S-S-S-S-S-S--------[]----------x---x-x-----xx-------x-x-xx-------------E--------
----------------xx---------------------------xx----xx?SSS-x------XXXXxxXX---S-S-S-S-S-S-S-S--------[]--------x---x-----x-x--x--X----X-X-X--------------S-S------
---------------xx-x-------------------------xx-----x-------x-----XXXXxXXX-x-x--x-------x-x-x-------[]--------xx--Xx-x-x--xx----------------x--------------------
--------------xx---x-----------------------xx----xxx-------Ex----XXXXXXXX-----x----x-x--->->-x-----[]--x-x-x--x-x-x-----xXx---------------x-----------SES-------
-------------xx-----x-------------X------xxx--o---xE------<>-xo--XXXXXXXX--------x-x-Xx-x]x]x------<]--x-X-Xx---X-X------X-------------------x-x---S-S-S-S---X--
-----------xxx-------x------SSSSSSX-----xx<>------<>---E--[]--x--XXXXXXXX-------xE-XxXx-<]<]---x----]x--x-x-x------S-S--X------E------------xX-X--X-E------E-X--
------------x---------x----------------xx-[]------[]--<>--[]---x-XXXXXXXX---------xXXXX-[][]--x--x-x>xx-X-X-X------S-S--X-X---->--------------x-xxXS?SSSSS-S-X--
-----------<>----------xxxx-------xxxxxx--[]------[]--[]--[]----xXXXXXXXX--X-X-X-XEXXXX-[X[X-X-X-X-X-Xx------------SSS---------]--------------X-x--x-x-x-xEx-x-x
-------XXX-[]-----------xE-xxxxxxxx---x---[]------[]--[]--[]-----XXXXXXXXX-X-X-XEXXXXXX-[X[X-X-XxXxXxX-----------X-SSS--------<]-----------------XSXSXSXSXSXSX-X
-----------XXXXXXXXXXXX-XXXXXXXXXXX--X-XXXXXXXXXXXXXXXXXXXXXXXXXXXXXXXXXXXXX--XXEXXXXXXXXXXXXXEXXXXXXX-----------X-XSS--------[[------------------xXxXxXxXxXxXxX