----------------------------------------------------------------------------------------------------------------------------------------------------------------
----------------------------------------------------------------------------------------------------------------------------------------------------------------
xx--------------------------------------------------------------------------------------------------------------------------------------------------------------
--xxx-----------------------------------------------------------------------------------------------------------------------------------------------------------
--SSS-----------------------------------------------------------------------------------------------------------------------------------------------------------
--SSSxxxxxxxxxxxxxxxxxxxxx--------------------------------------------------------------------------------------------------------------------------------------
--SSSSSSSSSSSSSSSSSSSSSSX-x---------------------------------------------------------------------------------------------------------E---E--------------------xx-
--SSSS------------------X--x---E--------------------------------------------------------------------------------------------------SSSSSSS-------------------xx-x
------------------------X---x---------------------------------XXX------------------------------------------------------------------------------------------xx---
---------E-----E---E----X--E-x-------S-------------------------------------------xxxx--------------------------------------------E---------------xxxxxxxxxxx----
----E---<>----<>--<>---?X-<>--x------------------------------------------------xxx---xx------------------------xxxx----------------------------xxx----x---<>----
---<>---[]----[]--[]----X-[]---x----xxx-----QQQQ?--------------------------X--xx<>-----xx------------------QQ-xx-X-x-----------S?S----xxQ-----xx<>---SS---[]----
---[]---[]----[]--[]----X-[]----x--xxS-x-------------------------------------xx-[]----<>-x-------------------xx--XX-x----------------xxXx----xx-[]--------[]----
---[]---[]----[]--[]----X-[]-E---xxx-S--xxxxxxxxxxxxxxx----------------x----xx--[]----[]--x-----------------xx---XXX-x--------------xx-X-x--xx--[]--------[]----
---[]---XXXXXXXXXXXXXXXXXXXXXXXXXXXXXXXXXXXXXXXXXXXE-E-xxxxxx-----------xxxxx---[]----[]---xxxxxxxxxxxxxxxxxx----XXXX-xxxxxxxxxxxxxxx--X--xxx---[]--------[]----
XXXXXXXXXXXXXXXXXXXXXXXXXXXXXXXXXXXXXXXXXXXXXXXXXXXXXXXXXXXX------XXXXXXXXXXXXXXXXXXXXXXXXXXXXXXXXXXXXXXXXXXX--XXXXXXXXXXXXXXXXXXXXXXXXXXXXXXXXXXXXXXXXXXXXXXXXX