-----------------------------------------------------------------------------------------------------------------XX---------------------------------------------
-----------------------------------------------------------------------------------------------------------------[]---------------------------------------------
xx---------------------------------------------------------------------------------------------------------------<>---------------------------------------------
--x--------------------------------------------------------------SS-----------------------------------------------E---------------------------------------------
---x-------xxxxx-------------------------------------------------------------------------------------------------------------------------ooo--------------------
----xxxxxxxx----xxxxxxxxxxxxxx-----------------------------------------------------------------------------------------------------------XXXX------------------x
----SSSSSSSS----SSSSSSSSSSSSX-x--------------------------------SS-------------------------------------------------------------xxxxxxxx------------------------xx
----------------------------X------------------EXX-------------xx------------------------------------------------------------x----XXX-x----------------------xx-
----------------------------X---------------EEEXXX---------------x----------------------------------------------------------x----------x--------------------xx--
----------------------------X----------------XXXXX----------------xx-------------------------------------------------------x-X----------x-----------------xxx---
--------------S------------?X----E----------XXXXXX-----------<>---S-x-QQ------------?----------<>--------------E---------xx--------------x---------------xxXXXXX
------------------------E---X--------------XXXXXXX-----------[]------x--QQ?QQ----------ESSS----[]-----SSS------x--------x-------------XX--xxxxxxx-------xx------
-----------------------<>---X-------------XXXXXXXX-----------[]-------x------------------------[]-------------x-----x--x-----------------XXXXXXX-x-----xx-------
-----------------------[]---X------------XXXXXXXXX-----x-----[]--------x-----------------------[]----------xxx------xxx---------------------------xxxxxx--------
-EXXXXXXXXXXX----------XXXXXXXXXXX---XXXXXXXXXXXXX------xxxxx[]XXXXXXXX-xxxxxxxxxxxxxxxxxxxxxxx[]----xxxxxxx-------------------------------------XXXXXXXXX------
XXXXXXXXXXXXX----------XXXXXXXXXXX---XXXXXXXXXXXXXXXXXXXXXXXXXXXXXXXXXXXXXXXXXXXXXXXXXXXXXXXXXXXXXXXXXXXXXXX----------------------------------------------------