----------------------------------------------------------------------------------------------------------------------------------------------------------------
----------------------------------------------------------------------------------------------------------------------------------------------------------------
----------------------------------------------------------------------------------------------------------------------------------------------------------------
xx---------------------o---------------------------------------------------------------XXXX-----------------------------------SS--------------------------------
--x--------------------XXXX-------------------------------------------------------------[]------------------------------------[]--------------------------------
---x-xx---------------------------------------------------------------------------------[]------------------------------------[]--------------------------------
----x--x-------------oo----XX-----------------------------------------------------------[]------------------------------------<>--------------------------------
----E---x---------xx--------------------------------------------------------------------[]----------------------------------------------------------------------
---<>----x-------xx-xxx----------S------------------------------------------------------[]-------------------------------------E--------------------------------
---[]-----x-----xx?----x----------------------------------------------------------------[]------xxxx----------xxxx----------xxxx------------------------------?-
---[]------xxxxxx-------xxxxxx-----------------------o----------------------xxx-QQQQQQ--<>-----xx<>-x--------xx<>-x--------xx<>-x-------------------------------
---[]-----SSSSSS?------XXX----xx----X--------------------------------------xxX-x--------------xx-[]--x------xx-[]--x------xx-[]--x------------------------------
---[]------------------------<>-xxx---------------------------------------xx-X--x---E--------xx--[]---x----xx--[]---x----xx--[]---x---xxx----------------------x
---[]-----------S------------[]--X-x--x---------------xxxxxxxxxxxxxxxxxxxxx--X---xxxxxxxxxxxxx---[]----xxxxx---[]----xxxxx---[]----xxxxE-xxxxxxxxxxxxxxxxxxxxxxx
---[]------------------------XXX-X--xx-xxxxxxxxxxxxxxxxEXXXXXXXXXEEXEXXXXXXXXXXXXXXXXXXXXXXXXXXXXXXXXXXXXXXXXXXXXXXXXXXXXXXXXXXXXXXXXX<>XXXXXXXXXXXXXEXXXXXXXXXX
XXXXXXXXX--XXXXXXX-----------XXX-X-----XXXXXXXXXXXXXXXXXXXXXXXXXXXXXXXXXXXXXXXXXXXXXXXXXXXXXXXXXXXXXXXXXXXXXXXXXXXXXXXXXXXXXXXXXXXXXXX[]XXXXXXXXXXXXXXXXXXXXXXXX