---------------------------------------------------------------------------------------XXXXXXXXXXXXXXXXXXXX--------------X-X-----]X-XEX-X-X-XXXXXXX-------------
--------------------------------------------------------------------------------------X-X-X-X-XxXxXxXxXxXxX----------------x----X>X-X-X-X-X-XxXXXX----XX-X-X-X-X
x---------------xx--------------------------------------------------------------------X-X-X-XxX-X-X-X-X-X-Xx--------------Xx----[x----------xxXXXX----Xx-x-x-x-x
---------------xx------------------------x-x-x-----x--------------------------------------B---x-x-x-x-x-x-xx-X-X-E-X-X---x---x--<x----------x-XxXX---xX-X-X-X-X-
---------xxxxxxx---x---------------------x-----x-x---x---------------------------X--------bx-----------S-Sx--x-x-E-x-x----x-xx-x---x----------xxXx----x-xoxox-x-
-xxxxxxxxx----x---x--------------------x-Xx-x--X-XxEx------------------------------------xB-x---------------x-X-XxX-Xx-x----x---x-xx----------x-Xx-x-----o-o----
-XXXXXXXXX---XX------x-----------------xx-----x-x-x----x-------------E------------X-------x-----------S-S-S-x-x-x---x---x-----x---x--x----------x---x-----o-o---
--------------------xE-E-------------x--x--X--X-X-X---x--------------------------------x------------------------x-x---x-------------x-------------x-------o-o---
-----------ooooooo----x------------x-xx------------------x-----------x-x---X-X-X--------x--------------S-S-------Q-?----------------x---------------------------
-----------ooooooo-----x---------x-X-XxX----------------x------------x-----x-x-x-----x--------------------------------------------------------------------------
-----------------E---------------xx-x----------------------x-x-x---x--x--xX-X-X-------x---------------S-S-S----------S------------------------------------------
----------------<>-------x---x-x--x-E-X----E--------------x------x-xx---x-x-x-x----x----------------------------------------------------------------------------
-----------E----[]------x--x---xx---------->---------X-X-X-Ex-x-xX-Xx---x--------x--x-------------------------------S-------------------------------------------
----------<>----[]---------XxExXxX---------]----------------x-----x---------------------------------------------------------------------------------------------
----------[]----[]--------x-x-------------<]--------X-X-E-X-X-----X-------------x-x-----------------------------------------------------------------------------
----------[]----[]--------X-X-E-E-X-------[[--------------------------------------------------------------------------------------------------------------------