--------------------XXXXXXXXXXXXXXXXXXXXXXXXXXXXXXXX--XX--XXXXXXXXXXXXXXXXX-----XXXXXXXXXXXX-XXXXXXXXXXXXXXXXXXXXXX-----------XXXXXXXXXXXXXXXXXXX<>XXXXXXXXX--XX
---------------------xxxxxxxxxxxx--[]----[]--E-[]--x--SS---xxxxxxxxxxxxxxxX-----XXXXXXXXXXXXXXX----oooSSSS--------------------xxxxxxxxxxxxxxxxxxxxxxxxxxxxxx--xx
x-------------------x-----------xx-[]----[]----<>-xxx-SS--x--------------xx-----xxXXXXXXXXXXXXXSSSS---SSSS-------------------x-----------------------------xxx-x
------------XXXXXX-x-------------xx<>----[]----xxx--xxSS-x---------------Exx---x-xxXXXXXXXXXXXXSSSS---SSSS------------------x-----------------------------------
---------XX--xxxxxx---------------xxx----<>---x------xxxx----SSS--SSS------xxxx---xxXXXXXXXXX--SSSSS??SSSS--QQ--QQQ--------x-------------------Q----------------
------------x----XXXX---------------xx---xx--x---------------SoS--SoS--------------xxXXXXXXXX-xxxxxx?-xxxx--xx--xxx-------x-------------------------------------
-----------x-------------------------xx-x-xxx----------------S-SSSS-S---------------xxxxxxxxxx-----xxx---xxx-xxx--xx-----x------XXX-XXX-XXX---------------------
----------x---------------------------xx---------------------------------------------------------------------------xx---x--------o---o---o----------------------
---------x-----------------------------------------------------oooo--------------------------S--SSSSSSSSSS--QQ------xxxx------------------------------XXXXXXXXXX
--------x---------------------------------------------------------------------------------------SSSSSSSSSS----------------------------------XX------------------
------------XXXX----------------------------------------------------------------------S---------SSSSSSSSSS-----------------------------------o------------------
----XX------ooo-----------------SSSSSSSSSSSSSSSSSSSSSSSSSSSSSSSSSSSSSSSSSSSSSSSSSSSSSSS-SSSS--SSSSSSSSSSSSSSSSSSSSS---------------------------------------------
--------------------------------------------------------------------------------------SS------------------------------------------------------------------------
----------------------------------------------------------------------------------------------------------------------------------------------------------------
----------------------------------------------------------------------------------------------------------------------------------------------------------------
----------------------------------------------------------------------------------------------------------------------------------------------------------------