----------------------------------------------------------------------------------------------------------------------------------------------------------------
----------------------------------------------------------------------------------------------------------------------------------------------------------------
xx---x----------------------------------------------------------------------------------------------------------------------------------------------------------
--xxx-x---------------------------------------------------------------------------------------------------------------------------------------------------------
--SSS-----------------------------------------------------------------------------------------------------------------------------------------------------------
--SSS--x------------------------------o--------------------------------------------------------------------------------XXXX-------------------------------------
--SSS---x----------------------------XX--------------xx------oo-------------------------------------------------------------------------------------------------
--SSS----xx-----------------------------------------xx-x----------------------------------------S---------------------------------------------------------------
----------xxxxxx--XX--o---o---o---o----------------xx---x----------------------------E--------------------------------------------------------------------------
----------------x----XXX-XXX-XXX-XXX---------xxxxxxx-----x--------------------------<>--------------------------------------------------------------------------
----E------------x-------------------------xxx----<>------x-------------------------[]-----------------------------oo---------------------------------------xxxx
---<>----X--------x-----------------------xx<>----[]----X--x------------------------XX--------QQQQ----------------xxxx----------------------QQ----xx----xxxxx-XX
---[]---EX---------x----------------------x-[]----[]----X---x---------------------------------------B------------xx---x-------------------------xxx-x--xxXX<>-XX
---[]---XX----------x--------------------xx-[]----[]----XX---x----B------------xxx------------------b---------B-xx-----------------------------xx<>--xxxXXX[]-XX
---[]--XXX-----------xxxxxxxxxxxxxxxxxxxxx--[]----[]----XX---Exxxxxxxxxxxxxxxxxx--xxxxxxxxxxxxxxxxxxxxxxxxxxxxxxx------------E---xxxxxxxxxxxxxxx-[]XXXXXXXX[]-XX
XXXXXXXXXX-----------XXXXXXXXXXXXXXXXXXXXXXXXXXXXXXXXXXXXXXXXXXXXXXXXXXXXXXXXXXX--XXXXXXXXXXXXXXXXXXXXXXXXXXXXXXX------XXXXXXXXXXXXXXXXXXXXXXXXXXXXXXXXXXX-XXXXX