----------------------------------------------------------------------------------------------------------------------------------------------------------------
----------------------------------------------------------------------------------------------------------------------------------------------------------------
x----------------------------------------------------------------------------------------------------------------xx---------------------------------------------
--------xxx-----xxx------------------------------------------------------------------------------------------------x--------------------------------------------
-------xx--x---xx--x------------------------------------------------------------------------------------------------x-------------------------------------------
-xx---xx----x-xx----x------------------------------------------------------------------------------------------------XXXX---------------------------------------
---x-xx------xx------------------------------------------------------------------------------------E------------------------------------------------------------
----xx-------XX------------------------------------------------------------------------------------S----------------------------------------Q-------------------
----XX---------------x----------------------------------------E------------------------oooo---------------------------------------------------------------------
----------------------x--------------------------------------<>------------------------------------?-------------------------------------------------xxxx-------
-----o-----------------xS------------------------------------[]-X-------------------------------------------xxx-------------xxxx-?-----------------xxx---xxxxxxx
-----o--XX--------------x------------------------------------[]---------------------xxx-----------xxx--xxxxxx--x-----------xx<>-x---------S?SQS---xx<>---XXXXXXX
---------------------S---x-----------------------------------[]--------------------xxX-x---------xxX--xxXXXXX---x----<>---xx-[]--x---------------xx-[]----------
---------------------S----xxxxxxxxxxxxxxxxxxxxxxxxxxxxxxxxxxx[]------x------------xx-X--x-----B-xx-X-xx--------------[]--xx--[]---x-------------xx--[]----------
---------------------S----XXXXXXXXXXXXXXXXXXXXXXXXXXXXXXXXXXXXX-------xxxxxxxxxxxxx--X---xxxxxxxx--X-x---------------[]--x---[]----xxxxxxxxxxxxxx---[]----------
---------------------S----XXXXXXXXXXXXXXXXXXXXXXXXXXXXXXXXXXXXX---XXXXXXXXXXXXXXXXXXXXXXXXXXXXXXXXXXXX-------------XXXXXXXXXXXXXXXX<>XXXXXXXXXXXXXXXXX----------