----------------------------------------------------------------------------------------------------------------------------------------------------------------
-------------------------------------------------------------------------------------------x--------------------------------------------------------------------
-----------------------------------------------------------------------------------x-----x----------------------------------------------------------------------
-----------------------------------------------------------------------------------------xx-x-------------------------------------------------------------------
--------------------------------------------------xx---------------------------------x-x--x----------------------X---------X------------------------------------
---------------------------o---------------------xx-x-------------------------------x--xx------------------------x---------x------------------------------------
------------------------------------------------xx---x---------------------------------Xx-------------------------Xx-------x-x-x---------S----------------------
-------------------------SSS--------------E-xxxxx-----x---------------------SS--------x------------------E-----x-oxx-----x-----x-x------------------------------
-------------------------------------------xxXSSS------x------------------------------X------------------x------x-x--x----x-x-x-S----x--S-S---------------------
----------------------xxxxxxxxx-----------xxXXX---------x-----oo-------------------------------------x-x-x-x-x--o---xx-x-------ExE-x---x-----------------------o
-----------o--------xxx---x----x--------xxxXXXS----------xxxxx------------------------------------------------x-----x---x---------xXx-xX-x-------------------o--
-------------------xx<>---S-----xx-----xx<>XXXX-----------XXX-x------------------------------------x--x-x-x-x---------x-----------EXx--Xx---------------------o-
------------------xx-[]--------<>-x---xx-[]XXXX-SSS-------XXX--x------------------E--------------x--x------------------------------XX-XX---x-----x---x----------
-------xxx-xxx---xx--[]--------[]--x-xx-X[]XXXX-----------XXX---x--xxxxx---xxx------------------x----------------------------------XX-XX--xE-x-x-x-x-E-x-x-x-x-x
---xxxxx--x---xxxx---[]----E---[]---xx-XX[]XXXX-----------XXX----xxx--X-xxxx--xxxx--------------x-x--------------------------------XX-XXXX-X-X-X-XxXxXxX-X-X-X-X
XXXXXXXX--X--XXXXXXXXXXXXXXXXXXXXXXXXXXXXXXXXXXXX---XXXXXXXX---XXXXX--XXXXXX--XXXX----------------------------------------------------XXXX-XxXxXxX--xX-XxXxXxXxX