----------------------------------------------------------------------------------------------------------------------------------------------------------------
----------------------------------------------------------------------------------------------------------------------------------------x-----------------------
x-------------------------------------------------------------------------------x-x-x---------------x-x---------------------------------x-----------------------
--------------------------------------------------------------------------------S-S-S-x-----S-S-----x-S-----------------------------x-x-------------------------
---------------------------------------------------xx--------------------------x-x-x-x------------x--x--------------------------------xx------------------------
--------------------------------------------------xx---------------------------S-S-S----x----S-S--xx-S----------------------o------x-xEx------------------------
------------------------------------------S-------xX-----------------------------------x----S-?-x--x---------------------------------->-------------------------
-------------------------------------E-----------xx----X--E-------------------------------x--?--xxX------------------------o----------]-------------------------
-------------------------------------------------x----XX---------------------------------x---?x--x-----------------------------------<]-------------------------
------------------------------X-E-----------xxxxxx---XXX--------------------X---------------x-xx-X-X----------------E----------------[]-----X-------------------
------------------------------XSSSS-------xxx---<>---XXX----------X-X---------X---------X-XxS-Sx----------------Q-Q-Q---------?------[]-----X---x-x-x-----------
-ooo-------------------------------------xx<>---[]---XXX----------------------X-<---X-X------x----------X-X-X-X----------------------[]---X-X---x-<---------E---
------xx------------------xxx----S------xx-[]---[]---XXX---------X-X-X------X-X-[---X-X--X---S-S---------------Q-Q-Q-Q---------------[]---XXX-x--x[x--x----->---
---xxx--x---B----------xxxx--xxxxxxxxxxxx--[]---[]---XXX------------------X-XXX-[---XXX------------------X-X-X-----------------------[X-X-XXX-xx--[>-x--x-x-x-x-
-xxx-----xxxxxxxxxxxxxxxXXX--XXXXXXXXXXXXX-XX--XXX---XXX------------------X-XXX-X>--XX------X-X-------X-X-X-X-X-X-<-<-----X-X--------[X-XXXXX-Xx--X]X-X-X-X<X-X-
XXXX-----XXXXXXXXXXXXXXXXXX--XXXXXXXXXXXXX-XX--XXX---XXXXXX-------------XXXXXX--X]--XX------X-X-------X-X-X-X-X--->->-----X---------XXXXXXXXXx--X-X]X-XxXxXxXxXx