-XXXXXXXXX-XXXXXXXXXXXXXXXXXXX---XXXSSS-S-----X------------------XXXXXXXXXXXXXXXXXXXXXXXXXXXXXXXXXXXXXXXXXXXXXXXXXXXXXXXXXXXXXXXXXXXXXXXXXXXXXXXXXXXXXXXXXXXXXXX
------xxxx--xxxxxxxxxxxxxxXXXX------SSS-S-----x--------XXXXXXX---XXXXXXXXXXXXXXXXXXXXXXXXXXXXXXXXXXXXXXXXXXXXXXXXXXXXXXXXXXXXXXXXXXXXXXXXXXXXXXXXXXXXXXXXXXX----
---------xxx--------<>---xxXXXX-----SSS-S----xxx--------xxxxxx----xxxxxx--X---xxxxxxxxxxxxxxxxxxxxxxxxxx--X---xxxxx---[]----xxxx--X---xxx-[]-X---xxxXXXXXXXX----
---------------------E----xxXXX-----SSS-S---x--xx------x-----xxxxx-----xx-X--x-------------------------xx-X--x----xx--[]---x---xx-X--x--xx<>-X--x--xxXXXXXXX---x
---------------------------xxX-------------x----xx----x-----------------xxX-x---------------------------xxX-x------xx-[]--x-----xxX-x----xxE---x----xxXXXXXX--x-
----------------------------xx------------x------xx--x-------------------xxx-----------------------------xxx--------xx<>-x-------xxx------xxxxx------xxXXXXX-x-X
-----------------------------xx--XXX-----x--------xxx----------------------------------------------------------------xxxx-----------------------------xxXXXXx--[
------------------------------xx-xxx----x-------------------------------------------------------------------------------E------------------------------xxXXX---<
-------------------------------xx--xxxxx----------------------------------------------------------------------------------------------------------------xxXX----
----------------------------------------------------------------E------------------------------------------------------<>--------------------------------xxx----
-----------------------------------------------------------------------------------------------------------------------[]----------------------------------x----
-----------------------------------------------------------------------------------------------------------------------[]---------------------------------------
-----------------------------------------------------------------------------------------------------------------------SS---------------------------------------
----------------------------------------------------------------------------------------------------------------------------------------------------------------
----------------------------------------------------------------------------------------------------------------------------------------------------------------
----------------------------------------------------------------------------------------------------------------------------------------------------------------