----------------------------------------------------------------------------------------------------------------------------------------------------------------
----------------------------------------------------------------------------------------------------------------------------------------------------------------
x---------------------------------------------------------------------------------------------------------------------------------------------------------------
----------------------------------------------------------------------------------------------------------------------------------------------------------------
----------------------------------------------------------------------------------------------------------------------------------------------------------------
-----------------------------------------------------------------------------------------------------------------------------------------------------x----------
-------------------------------------------------------------------------------------------------------ooo-----------------------------------------x------------
-x------?Q----------------------------------------------------------------SS------------E-x------------ooo---------XXX----xx-----------------------xx-xx--------
--x---------------------------xxxx---------------------------------E---------------------xx------------------------------xx-x--------x--------------x----x------
---x-------------------------xxXX-x-------------------------------<>--------------------xxX-xxx--------xxxx--------xxx--xx---xxx---x--------------------x-------
----x--QQ-------------------xxXXX--x------------------------------[]---SSS------------xxxXXxx--x------xx---xxxxxxxxx--xxx----<>-xx-xx--x-------------------x-Q-Q
-----x---------------------xxXXXX---x---------------xxx-----------XX-----------------xx<>XXXX---x---Exx---XXXXXXXXXX-XXXX----[]-----x-x-------------o-----x-----
--XX--x-------------------xxXXXXX----xxxx----------xxX-x----------------------------xx-[]XXXX----xxxxx----X------------------[]--<x----X-x---x---------------xQ-
-------xxxxx---xxxx------xxXXXXXX--------x--------xx-XX-x-----------------xxxx-----xx-X[]XXXX----XXXXX----X------------------[]--[x---XXx--x----------------x--x
------XXXX--xxxx---xxxxxxxXXXXXXX---------xxxxxxxxx--XXX-xxxxxxxxxxxxxxxxxx---xxxxxx-XX[]XXXX----X---X----X------------------[]--[>---XX-X-Xx-xx---X-X-X-X-X-X-X
------X-----XXXX---XXXXXXXXXXXXX--XXXXXXXXXXXXXXXXXXXXXXXXXXXXXXXXXXXXXXXXX-X-XXXXXXXXXXXXXXX----X---X----X------------------XXXXX]]--XXXXxXxX----EX-X-X-X-X-XxX