----------------------------------------------------------------------------------------------------------------------------------------------------------------
----------------------------------------------------------------------------------------------------------------------------------------------------------------
x---------------------------------------------------------------------------------------------------------------------------------------------------------------
-x-----xx-------------------------------------------------------------------------------------------------------------------------------------------------------
--x---xx--------------------------------------------------------------------------------------------------------------------------------------------------------
---x-xx--------------------------------------------------------------------------------------------------------------------------o------------------------------
----xx---------------------------------------------------------------------------------------------------------------------------------------E------E-----------
----XX------------------------S?SSS--------------------SSS---SSS--------SS-------------XX-----------------------------?--------SSS-----------S----SSSSSSSSSSSS--
----------------------------------------------------------------------------------------------------------------------------------------------------------------
----------------------------------------------------------------------------------------------------------------------------xxxxxxxxx--------?------------------
----------X--------------------------------------------SSS----------------------------------------------------------------xxx---x----x---------------------xxxxx
------------------------------SSSSS-------------------------------------SSSSS--------------------------------------------xx<>---S-----xx----xxx-----------xx--xX
------------------------xxxx---------xxxx-------------------------xxxx----------------------------E---------------E-----xx-[]--------<>-x--xxX-x---E-----xx-----
-----------------------xx<>-x---xxxxxx<>-x-----------xxxxx-------xx<>-x-------B----------------------------------<>----xx--[]--------[]--xxx-X--x-------xx------
---------------xxxxxxxxx-[]-Exxxx---x-[]--xxxxxxxxxxxx----xxxxxxxx-[]-Exxxxxxxxxxxxxxxxxxxxxxxxxxxxxxxxxxxxxxxxxxxxxxxxx---[]----E---[]---x--X---xxxxxxxx-------
------------XXXXXXXXXXXXXXXXXXXXX-X-XXXXXXXXXXXXXXXXXX----XXXXXXXXXXXXXXXXXXXXXXXXXXXXXXXXXXXXXXXXXXXXXXXXXXXXXXXXXXXXXXXXXXXXXXXXXXXXXXXXXXXXX-XXXXXXXXX-------