----------------------------------------------------------------------------------------------------------------------------------------------------------------
----------------------------------------------------------------------------------------------------------------------------------------------------------------
x---------------------------------------------------------------------------------------------------------------------------------------------------------------
-x--------------------------------------------------------------------------------------------------------------------------------------------------------------
--x---xxx-------------------------------------------------------------------------------------------------------------------------------------------------------
---xxxx--x------------------------------------------------------------------------------------------------------------------------------------------------------
---XXXX---x-----------------------------------------------------------------------------------------------E------E----------------------------------------------
-----------x-------SSSSS---------------SSSS--------SSSSS----------------------------------------------SSSSSSSSSSSSSSS--------?----------------------------------
----------oox---------------------------------------------------------------------------------------------------------------------------------------------------
-------------x----------------------------------------------------<>-------------------------------------------------------------------------------------xxxxxxx
--------------x----------------------------xxxx-------------------[]---------------------------------------------E---------------<>--------------------xxx--x---
---------------x-QQQQ--QQQ------------S---xx<>-x-QQQQ--QQQ-------QQQQQQQQQQ-----------------------------xxx------QQ?QQQQ?QQ--Q---[]-------------------xxXX--X---
----------------x------------------------xx-[]--x------------xxx--------------B--E--------xxxx---------xxX-x---------------------[]------------------xxXXX--X---
-----------------x----------------------xx--[]---x----------xxB-x-xxxxxxxxx---b----------xx<>-x-------xx-X--x--------------------[]--------xxx------xxXXXX--X---
---X--------------xxxxxxxxxxxxxxxxxxxxxxx---[]----xxxxxxxxxxx-b--xx--------xxxxxxxxxxxxxxx-[]--xxxxxxxx--X---xxxxxxxxxxxxxxxxxxxx[]----xxxxx--xxxxxxxXXXXX--X---
----------XXXXXXXXXXXXXXXXXXXXXXXXXXXXXXXXXXXXXXXXXXXXXXXXXXXXXXXXX-X-X-X-XXXXXXXXXXXXXXXXXXXXXXXXXXXXXXXXXXXXXXXXXXXXXXXXXXXXXXXXXXXXXXXXXX--XXXXXXXXXXXX--X---