----------------------------------------------------------------------------------------------------------------------------------------------------------------
----------------------------------------------------------------------------------------------------------------------------------------------------------------
----------------------------------------------------------------------------------------------------------------------------------------------------------------
----------------------------------------------------------------------------------------------------------------------------------------------------------------
----------------------------------------------------------------------------------------------------------------------------------------------------------------
------------------------------------------------------------------------------------------------------------------------------------------ooo-------------------
-----------------------------------------------------xxxxxxxxxx---------------------------------------------------------------------------XXX-------------------
-----------------------------------------------------xSSSSSSSS-x---------SSSS?SSS--------------------------S------------E---------------------------------------
-----------------------------------------------------x----------x-----------------------------------------------------------------------------------------------
-----------------------------------------------------x-----------x-------------------------xxxxx----------------------------------------------------------------
------o--------------------------<>-----------------xx------------x-------E--------------xxx--S-x---------------xxxxxx-------xx-------------------------Q-------
---------------------------------[]----------------xxX----S----X---x----SSSSSSSS--------xx<>-----xx------------xxXSSS-x-----xx-xxxxxxxx------------xxx----------
---------------------------------[]---------------xx-X------E--X----xx-----------------xx-[]----<>-x----------xx-X-----x---xx--XXXXXXX-x----------xxX-x---------
---------------------xxx---------[]----x--xxx----xx--X---------X---<>-x---------------xx--[]----[]--x--------xx--X------xxxx---X--------xxxxxxxxxxx-X--x--------
---xxxxxxxxxxxxxxxxxxx--xxxxxxxxx[]-----xxx-ExxxxxE--X---------X---[]--xxxxxxxxxxxxxxxx---[]----[]--Exxxxxxxxx--EX------XXXX---X--------XXXXXXXXXXE-X---xxxxxxxx
XXXXXXXXXXXXXXXXXXXXXX--XXXXXXXXXXXXXXXXXXX--XXXXXXXXXXXXXXXXXXXXXXXXXXXXXXXXXXXXXXXXXXXXXXXXXXXXXXXXXXXXXXXXXXXXXXXXX---------X--------------------XXXXXXXXXXXX