----------------------------------------------------------------------------------------------------------------------------------------------------------------
-----------------------------------------------------------------------------------------xxx--------------------------------------------------------------------
x---------------------------------------------------------------------------------------xx--x-------------------------------------------------------------------
---------------------------------------------------------------------------------------xx-----------------------------------------------------------------------
--------------------------------------------------------------------------------------xx-----------------------xx--------------SSSSSSSSSSSS---------------------
------xxx--------------------------o-------------------------------------------xxxxxxxx-------o-o--------------X-x-XXXX-----------------------------------------
--xxxxx--x------------------------------------------X-------------------------xx?QQQQQQ------xo-o--XXX---------X--x---------------------------------------------
-xxXXXX---x----------------------SSS---------------XX------------------------xx---------------x----------------X------------------------------------------------
-xXXXXX----x--------------------------------------XXX-----------------------xx-----------------x---------------X------------------------------------------------
-XXXXXX-----x-----------------xxxxxxxxx----------XXXX-----------------xxxxxxx-------------------xx-------------X------------------------------------------------
-XXXXXX------x--------------xxx---x----x--------xXXXX----------------xx--QQQ?---S--------------XX-x-----------xX-------------------------xxxxx------------xxxx-?
-XXXXXX-------x------------xx<>---S-----xx-----xxXXXX-----xxx--------x-----------------------------xxxx------xxX---------------QQQ-----xxx--?-x----------xx<>-x-
-XXXXXX-------------------xx-[]--------<>-x---xxXXXXX---xxx--xxx-----------------------------------XXX-x----xxXX---<>----------------xxxXX-----x--------xx-[]--x
-XXXXXX--------xxx-------xx--[]--------[]--x-xxXXXXXX--xx<>--<>-x----------------EE---------------------x--xxXXX---[]--------------xxxXXXX------x------xx--[]---
-XXXXXX-----------xxxxxxxx---[]----E---[]---xxXXXXXXXxxx-[]--[]--xxxx---XXXXXXXXXXXX---------------------xxxXXXX---[]--xxxxxxxxxxxxxXXXXXX-------xxxxxxx-E-[]---
XXXXXXXXXXXXXXX-X-XXXXXXXXXXXXXXXXXXXXXXXXXXXXXXXXXXXXXXXXXXXXXXXXXXX---XXXXXXXXXXXX---------------------XXXXXXXXXXXXXXXXXXXXXXXXXXXXXXXXXXXXXXXXXXXXXXXXXXXXXXX