----------------------------------------------------------------------------------------------------------------------------------------------------------------
----------------------------------------------------------------------------------------------------------------------------------------------------------------
------------------------x---------------------------------------------------------------------------------------------------------------------------------------
x-----x-----------------x---------------------------------------------------------------------------x-----------------------------------------------------------
-x----------------------x---------------------------------------------------------x---------------x-------------------------------------------------------------
--xxxx----------------x---------------------------------------------------------x---x---x---x-----xx--x---------------------------------------------------------
--SSSS----------------xx--x-------S-S-----------------------------------------x-Xx-x-------x------Sx-x--x---------------x-x---S-S-------------------------------
----------------------xx-x---------E------------------------------------------xxXx----xx--x---x--x--------------------x-----------------------------------------
----------------------xS----x------Q------------------o---------------------x-XxXX---x---x---x--xx-Q---x--x-----------xx-x--x--S------------------------------x-
--------------------x-S----x------------------------------------------------xxX-XX-------------x-x-------x--x-x-x-x-x--x---x--x-x-x---Q----->-----------------xx
--------------------xx--------x---S-S---------Q-Q---S-S-S---x-------------x-XxXXXX--------S------xS-----------X-X-X-Xx--------X-X-----------]---------------x--x
-------o------------xx-------x-------------------------E--x-X-x-----------xxX-XXXX---------------x---------x-x-x-x-x-x-------x-x-x--x------<]-------------x-<x--
--------x-x-x-x---x-------------x--Q------B--Q-Q-----S-SE-xxXx----------x-XxXXXXXX---------------S-----------X-X-X-X-X-------X-X-X-x-------[]-------------xx[x--
------X---x-----x-xx-----------xE-x-x-x-x-x-x-x-x-x-x-x-x--xX---x-x-x-x-xxXXXXXXXX-------------------------------------------X--------x-x-x[]-----x-x-x-x--x[>--
XXXXXXXx-xXxXx--X-XxX-XEX-X-X-X-X-X-X-X-X-X-XEX-X-X-X-X-Xx--X-XxX-X-X-X-XxXXXXXXXXX-X-X-X-X-X-X-X-X-X-X-X-X-X----------------XX-----XxX-X-X[X-X-X-X-X-X-XxX-X]X-
XXXXXX--X---X-XxXxX-X-X-X-X-X-X-XxXxXxXxXxXxXxXxXxXxXxXxXx--X-X-XxXxXxXxXXXXXXXXXXX-X-X-X-X-X-X-X-XEX-X-X-X-----------------XXX-----X-XxXxX[X-X-XxXxXxXxXxX-X]X-