--------------------------------------------------------------------------------------------------------------------------------[XXXXXXXXXXXXXXXXXXXXXXXXXX----X
--------------------------------------------------------------------------------------------------------------------------------[]---[]-----[]-E--[]------------
xx------------------------------------------------------------------------------------------------------------------------------[]---[]-----[]----[]------------
--xxxxxx-xxxxxxxxxxxxxx---------------------------------------------------------------------------------------------------------<>---<>-----<>----[]------------
--SSSSS-xSSSSSSSSSSSSSS----------------------------------------------------------------xxxxx-----------------------------XXX-----E----E------E--SS[]SS-----?SSS-
--SSSS--S--------------xxxxxxxxxxxxxxxxxxxxxxxxxxxxxxxxxxxxxxxxxxxxxxxxxxxxxxxxxxxxxxxxx----x----------------------------xxx-------S--------------[]--------[]--
--SSSS-S---------------SSSSSSSSSSSSSSSSSSSSSSSSSSSSSSSSSSSSSSSSSSSSSSSSSSSSSSSSSSSSSSSSS-----x------------------------xxx--xx---------------------[]--------[]--
--SSSS-S----E---------------------------------------------------------------------------------x-----------------------------xx--------------------<>--------<>--
-----------<>----------------------------------------------------------------------------------x-----------------------------xxx-------------------E---------E--
-----------[]--------------E---E---E---E---E---E---E-----E-----E---------E-----E---E------------x---------------------------------------------------------------
----E------[]-S-----------<>--<>--<>--<>--<>--<>--<>----<>----<>--------<>----<>--<>------S------x--------------------------------------------------------------
---<>-SS---[]-------------[]--[]--[]--[]--[]--[]--[]----[]----[]--------[]----[]--[]--------------x-----------------------------SSSSSSSSSSSSSSSSSSSSSSSSSSSSSSSS
---[]------[]---o------X--[]--[]--[]--[]--[]--[]--[]----[]----[]--------[]----[]--[]---------------x----------------------------xxxxxxxxxxxxxxxxxxxxxxxxxxxxxxxx
---[]------[]---------XX--[]--[]--[]--[]--[]--[]--[]----[]----[]--------[]----[]--[]----------------x--------------xxx------------------------------------------
---[]------[]-------E-XXXXXXXXXXXXXXXXXXXXXXXXXXXXXXXXXXXXXXXXXXXXXXXXXXXXXXXXXXXXXXXXXXX------------xxxxxxxxxxxxxxx--------------------------------------------
XXXXXXXXXXXXXXXXX-XXXXXXXXXXXXXXXXXXXXXXXXXXXXXXXXXXXXXXXXXXXXXXXXXXXXXXXXXXXXXXXXXXXXXXX---XXXXXXXXXXXXXXXXXXXXXXXX--------------------------------------------