----------------------------------------------------------------------------------------------------------------------------------------------------------------
----------------------------------------------------------------------------------------------------------------------------------------------------------------
xx--------------------------------------------------------------------------------------------------------------------------------------------------------------
--xxx-------------------------------------------------------xx--------------------------------------------------------------------------------------------------
--SSS------------------------------------------------------xx-x-------------------------------------------------------------------------------------------------
--SSS------------------------------------------------------E---x------------------------------------------------------------------------------------------------
--SSS----------------------------------------------------xx-----xxxx-------xxxx-------------------------------------------------xxxx---------xx------oo---------
--SSS---------------------------------------------------xx------XXX-x-----xx---x-------xxxE------------------------------------xxXX-x-------xx-x----------------
-------------------------------------------------------xx------------x---xx-----x---xxxx--x-----------------------------------xxXXX--xxxx--xx---x---------------
------------------------------------------------------xx--------o-o---xxxx-------x-xxXXX---xxxxx-----------------------------xxXXXX------xxx-----x--------------
----E-----------------------------------------------xxx---------o-o-XXXXXX--------xx--------xXX-x----------E----------------xxXXXXX-------<>------x-------------
---<>---------------------xx-----------------S-----xx<>---------------------------XX--------XXX--x------------B------------xxXXXXXX-------[]----X--x------------
---[]-------------------xxx-x---------------------xx-[]-------------------------------------XXX---x---xxxxx---b-----------xxXXXXXXX-------[]----X---x-----------
---[]------------------xx<>--xxxxx---------------xx--[]-------------------------------------XXX----xxxxE---xxxxxxxxxxxxxxxxXXXXXXXX-------[]----XX---x----------
---[]----xxxxxxxxxxxxxxx-[]XXXXEE-xxxxxxxxxxxxxxxx---[]----X-----------------------------oooXXXXXXXXXX<>---XXXXXXXXXXXXXXXXXXXXXXXX--E----[]----XX---Exxxxxxxxxx
XXXXXXXXXXXXXXXXXXXXXXXXXXXXXXXXXXXXXXXXXXXXXXXXXXXXXXXXXXXX-----------------------------XXXXXXXXXXXXX[]---X---XXXXXXXXXXXXXXXXXXXXXXXXXXXXXXXXXXXXXXXXXXXXXXXXX