----------------------------------------------------------------------------------------------------------------------------------------------------------------
----------------------------------------------------------------------------------------------------------------------------------------------------------------
x---------------------------------------------------------------------------------------------------------------------------------------------------------------
----------------------------------------------------------------------------------------------------------------------------------------------------------------
---xxxxxx-------------------------------------------------------------------------------------------------------------------------------------------------------
-xxx-----x-----------------------------------------------------------------------------------------------------------------------------------------------xxx----
-XXX------x----------------------SSSS--------------E------E-E---E-----------------------------------?--------------------------------------------------xxx--x---
-----------x---------------------------------------S----SSSSSSSSSSSSSS--------------------------------------------------------------------------------xxXX---x--
------------x----------x-----------------------------------------------------E----------------------E------------------------------------------------xx-XX----x-
------------------------x--------------------------?------------------------<>--o---------------xxxxx-----xx----------------------------------------xxXXXX-----x
-------------xxx---------x----------X---------------------------------------[]-o---------------xxX---x---xx-x-xxx----------------------------------xx-XXXX------
------------SSS-x---------x---SSSSSSX-------------xxx---------xxx---SSSSS---XX----------------xx-X----x-xx---xx--x------xxxx----------------------xxXXXXXX------
-----------------x---------x---------------------xxX-x---E---xxX-x-------------xx------------xx--X-----xx----<>---x----xx<>-x----------------E---xxXXXXXXX------
------------------xxx-------x-------xxxxx-----B-xx-X--x-----xx-X--x--------------xxxxxxxxxxxxx--EX----XXX----[]----x--xx-[]--x---------xxxxx----xxXXXXXXXX------
---------------------xx------xxxxxxxx----xxxxxxxx--X---xxxxxx--X---xxxxxxxxxxxx--XXXXXXXXXXXXXXXXX-----------[]-----xxx--[]---xxxxxxxxxx----xxxxxXXXXXXXXX------
------------XXXX----XXXXXX--XXXXXXXXX---XXXXXXXXXXXXXXXXXXXXXXXXXXXXXXXXXXXXXXX---XXXXXXXXXXXXXXXX-----------[]---XXXXXXXXXXXXXXXXXXXXXX---XXXXXXXXXXXXXXXXXXXXX