----------X--XXXXXXXXXXXXXXXXXXXX--XXXXXXXXXXXXXXXXXXXXXXXXXXX-XXXXXXXXXXXXXXXXXXXXXXXXXXXXXXXXXXXXXXXXXXXXXXXXXXX---XXXXXXXXXXXXXXXXXXXXXXXXXXXXXXXXXXXXXXXXXX-
----------X--xxxxxxxxxxxxxxxxxxxx--xxxxxxxxE--X---------X------xExxxxxxxxxxxxxxxxxxxxxx---X---------X---XXXX-xxxxx----xxxxxxxxxxxxE-xxxxxxxxx-[]--xxxxXXXXXXXXX-
----------X-x-------------------xxx-------xx--X---------X-----xxx---------------------xx--X---------X---XXX-x----xxxxx-----------xxx--------xx<>-x---xxXXXXXXXX-
-----xxxxxxx-------------------------------xx-X------E--X----x----E-----?QQ------------xx-X------E--X---XX-x---------------------------------xxxx-----xxXXXXXXX-
x---xx----------------SSSSS-----------------xxX----S----X---x---------------------------xxX----S----X---X-x--------------------------------------------xxXXXXXX-
-x-xx----------------------------------------xx------------x-----------------------------xx------------xxx----------------------------------------------xxXXXXX-
--xx------------------------------------------x-----------x-------------------------------x-----------x--------------------------------------------------xxXXXX-
--XX------S-----------------------------------x----------x--------------------------------x----------x----------------------------------------------------xxXXX-
----------------------SSQSSSSSSSSSS-----------xSSSSSSSS-x----------------------------?----xSSSSSSSS-x------------------------------------------------------xxXX-
-----------------------------E----------------xxxxxxxxxx----------------------------------xxxxxxxxxx--------------------------------------------------------xxx-
--------------------------------------------------------------------------------------------------------------------------------------------------------------xx
---------------------------------------------------------------------------------------------------------------------------------------------------------------x
----------------------------------------------------------------------------------------------------------------------------------------------------------------
----------------------------------------------------------------------------------------------------------------------------------------------------------------
----------------------------------------------------------------------------------------------------------------------------------------------------------------
----------------------------------------------------------------------------------------------------------------------------------------------------------------