----------------------XXXXX--XXXXXXXXXX--XXXXXXXXXXXXX-X-XXXXXXXX-------------------------------------------------------------------XXXXXXXXXXXXXXXXXXXXXX--XX--
----------------------xxxxx--xxxxxxxxxx--xxxxxxxxxxxxx---xXXXXX------XXXXXXXXXXX---------------------------------------------------------XXXXXX-----xxxxxx--xx--
---------------------x----xxx---------xxx------------xxxxxxXXXX-------xxxxxxxxx----------------------------------------------------------XXXXXX-----------xx-xxx
----------------------------------------------------------xxXXX------x--------xx---------------------------------------------------------XXXXXX-----------------
x-----------------------------------------SSSSSSSSSSSSSS---xxXX----xx----------xx--------------------------------------------------------XXXXXX-----------------
------------------------------------------------------------xxXSS-x-------------xxXXXXXX---XXXEX---o-o-XXXXXXXX--------------------------XXXXXX-----------------
-------------------------------------------------------------xxxxx---------------xxxxx-------------o-o---xxxxx---------------------------XEXXXX-----------------
-------------------------------------------------------------------------------------xx-----------------x----xx--------------------------X-EXXX-----------------
--------------------XX--------------------SSQSSS?SSS?SSS---------E--------------------xx-----------XXX-x------xx-------------------------X--EXX-----------XXXXXX
---------------------------------------------------------------------------------------xxXXX---?---xxxx--------xxXXXX---XXXXXX----ooo----X----------------------
--X-------------------------------------------------------------------------------------xxxx---x--x-------------xxxxx---xxxxxx--------x--X----------------------
-------------------------------------------------------------------------------------------xxxxxxx------------------xx-x-----xx-------xx-x----------------------
---------------------------------------------------------------------------------------------------------------------xx-------xx-------xx-----------------------
-------------------------------------------------------------------------------------------------------------------------------x--------------------------------
------E--E------------------------------------------------------------------------------------------------------------------------------------------------------
----XXXXXXXXX---------------------------------------------------------------------------------------------------------------------------------------------------