----------------------------------------------------------X-X--XXXXXXXXXXXXXX----------X-X-----------------------------------------X-X-------XXXXX-X-E-[X-X-X]X-
----------------------------------------------------------X-----X-XxXxXxXxXxX----------------------X-X-----------------------------x-x-------X---x-x-x-[X-X-X]--
x---------------------------------------------------------------X-x-X-X-X-X-Xx----------X-----------------------------------------X-X-Xx-X-X-X-xX-X-Xx-<]---[]--
-x----------------------------------------------------------------x-x-x-x-x-xx-X-X-X-X--o-----------X-X--------------------------x--x-xx-x-x-x--x-x-x--x]---[]--
--x------------------------------------------------x---X-----------------S-Sx--x-x-x-x-----X-X------------------------------------x---x-X-X-X------S--x->x--[>--
---x---------------------------------------------x---x---x--------------------x-X-X-X-Xx-x-x-----------------------------------x--E-----x-xEx-x-------x-x-?x[x--
----xxxx---------o-----x-x-----------------------xx-x--xX---------------S-S-S-x-x-x-x-x---XxX-X--------X------------------------x-----------------------x-x-<x--
----XXX-x--------o-----x---x-E-----------------x--x-----x--E---------------------X-X-Xx-x-x--x-------------------------------x----------------------------x-x--x
---------x--xxxx--o--x--x-x------------------x-xx-----x------------------S-S-----E-o--------xx-X-X---xXx-----------------x-x--x-------------------------------xx
----o-o---xxx---xxox-xx------x-------------x-X-XxX--------------------------------X-X-------x--x-x----xx---------------x-x------------------------------------x-
----o-o-XXXXX----x----x-----x--------------xx-x-------------------------S-S-S-----o-o--------ox-XxEx--xx---------------x->x-x-----------------------------------
----------------XXx-x----------x-------x-x--x-X-E-X-------------------------------------------x-x---x---Qx-x---------x--x]--------------------------------------
--------------------x----X----x--x-x-x---xx-------------------------------------------------o-----x-----x----x-x-----xx-<]--------------------------------------
--------------------X------------X-X-XxExXxX------------------------------------------------------------x-x-xX---x-x--x-[]--------------------------------------
--------------------X-----X-----x-x-x-x----------------------------------------------------------------------XxX-X-XxX-X[X--------------------------------------
--------------------XX----------X-X-X-X-E-E-X-----------------------------------------------------------------XXxXxXxX-X[X--------------------------------------