------------------------------------------------------------------XXX[]XXXXXXX---XXXXXXXXXXXXX------------------------------------------------------------------
----------------------------------------------------xxx-----------XXX<>XXXXXXX------[]------[]------------------------------------------------------------------
x--------------------------------------------------xx--x----------xxxxE-xxxx[]------[]------[]------------------------------------------------------------------
--------------xxxxxxxxxxxxxxxxxxx-------xxxx------xx----x-----xxxx---xxx----[]------[]------[]------S-----------------------------------------------------------
------SSSS---xxSSSSSSSSSSSSSSSSSS------xx--xxx---xx------x---xx-------------[]------<>------<>------------------------------------------------------------------
-x----------xx------------------------xx------xxxx--------x-xx--------------[]-------E-------E------------------------------------------------------------------
--x----?---xx------------------------xx-------XXXX---------xx---------------<>--------------------XXXX------------------S---------------------------------------
---x--S??-xx-------------------------x---------------------XX----------------E--------------------XXX---------------------------xxx-----------------------------
----x----xxXXX-----------------------X------------------------------------E--------SSSS----------------------------------------xx-------------------------------
-----x--xx----------------------------------------------------------------?--------SSSS-----------------------------------xxx-xx--------------------------------
------xxx--------------------------------------------------------------------------SSSS---------x-----------------------xxx--xx--------------------------Q------
--XXX-SSSS-------------------------X------------------------------------------SSS--SSSSSSSSSSSxx-x---------------------xx<>--<>-----------------------Q-E-------
-------------------------E-----E---X------------------------------------------xxx--xxxxxxxxxxx----xx--------xxxxxxx---xx-[]--[]-----------B-------------E-------
------------------------<>----<>---X----XXX-------------------------------------xxx--------------XX-xxxxxxxxxE-----xxxx--[]--[]--------x--b--------------------x
----------------------E-[]----[]---X-----------------XXX-----------------------------------------XXXXXXXXXXX<>-----XXXXX-XX--[]---------xxxxxxxxxxxxxxxxxxxxxxxx
------XXXX------XXXXXXXXXX----XXXXXX-------------------------------------------------------------XXXXXXXXXXX[]-----XXXXX-XX--XX-XXXXXXXXXXXXXXXXXXXXXXXXXXXXXXXX