-------------[]-------------------X-X-X-X-XxXxXxXxXxXxX--XX-XxXxX-----------------------------------------------------------------------------------------------
-------------[]-------------------X-X-X-X-X-X-X-XbX-X-Xx-XX-X-X-Xx---------------------------------x-----x-x-x--------------------------------------------------
x------------<]--------------------------x--x-x-xBx-x-xx-X-x--x-xx---------x-x-x---------------x-x-------xx-----------------------------------------------------
-------------x>x---X-X--------------------xQ-Q--------x--x--x---x--x-x-----x-------------x-----x-----x-x--x-x--x------------------------------------------------
-------xxxxxx-xx---x-x-----------------x----------------x---------x----x-x--x-x--x-x-x-x---x---Qx-x-x--xx-----x-------------------------------------------------
------xx------x--x--Xx------------------x-Q-Q-----------x-x-------x-x-x-?xx-----xX-X-X-XxEx--xx--------Xx--------x----------------------------------------------
-----xxX--------x---x--x-X-X-X-------x-----------------------------------Xx-------x-x-x-x----xx-------x---------x-----------------------------------------------
----xx----------x-x---xx-x-x-x--------x---------------------------------x-------X-X-X-X-X---xXx-------X------------x--------------------------------------------
-xxxx----X------------xE--X-X-Xx---x------------------------------------X-----------------------------------------x--------------------------------------x------
---x--------------------x-x-x-xx----x---------------------------------------------------------X--------------X-------x-----------------------------------x------
--XX--------------------------x--x----------------------------------------------------------------------------------x--E---------------------x-x-x-----x-Xx-----
--XXX---------------------------x-x-------------------------------------------------------------------------X----------x-----------x-------x-X-X-X-x---xxX<--x-x
---------E----------------------x----------------------------------------------------------X-X------------------------x--x-x-x-x-x---x-x-x-xx-x-xXx--x-XxX[--x->
--------<>-------------------------------------------------------------------------------------------------------------X-X-X-X-X-Xx-xX-X-X-Xx-X-XX---xxXXX[x--x]
--------[]--------------------------------------------------------------------------------X-X---------------------------x-x-x-x-x-x---x-x-x------X--xXxXXX[XxX<X
--------[]--------------------------------------------------------------------------------------------------------------X-X-X-X-X-X-X-X-X-X-----------XXXXXXxX[X