------------------------------XXXXXXXXXXXX--XXXXXXXXXXXXXXXXXXXXXXXXXXXXXXXXXXXX[]-XXXXXXXXXXXXXXXXXXXXXX-------------XXXXXXXXXXXXXXXXXXXXXXXXXXXXXXXXX---------
------------------------------XXEXXXXXXXXX--[]-XXXXXXXXXXXXXXXXXXXXXXXXXXXXXXXXX<>-XXXXXXXXXXXXXXXXXXXXXX-------------xxxxxxxxxxxxxxxxxxxxxxxxxxxxXXXXX---------
-----------xx-----------------xxxxxxxxxx[]--[]----------B---xxxxxxxxxxxxxxxxxxxxxE-xxxxxxxxxxxxxxxxxx--EX------------x---------------------------xxXXXX---------
----------xx-x-----------xxxxx----------[]--<>----------b--x---E---E------------xxx-----------------xx--X----XX-----x-----------------------------xxXXX---------
-x-------xx---x---xxx---xx--------------[]---E----------B-x------------------------------------------xx-X----XXX---x----------------<>-------------xxXXX--------
--xxxxxxxx-----xxxx--x--xQ--------------[]--------------xx------SSSSSSSSSSSSSSS-<>--------------------xxX----xxx--x------------------E--------------xxX---------
---x---XXX-----XXXXE--xxx---------------<>-------------x------------------------[]---------------------xxxxxx-Exxx----XXX----------------------------xx---------
--XX-------------------x-----------------E------------x-------------------------[]-------------------------------XXXX--o------------------------------xx--------
-----------------------XX-------------E--------------x--------------------------[]---------------------------------------------------------------------xx-------
--------------------------------------?-------------x---------QQQ?QQQQQQQQ?QQQ?QQQQ---------------------------------------------------------------------xxXXXXXX
-------XXX-----------------------------------------x-----------------------------------------------------------------------------------------------------xxxxxxx
------------------------------------------------xxx-------------------------------------------------------------------------------------------------------------
----------------------------------------------------------------------------------------------------------------------------------------------------------------
--------------------XXXX----------------------------------------------------------------------------------------------------------------------------------------
----------------------------------------------------------------------------------------------------------------------------------------------------------------
----------------------------------------------------------------------------------------------------------------------------------------------------------------