----------------------------------------------------------------------------------------------------------------------------------------------------------------
---------------------------------------------------------------------------------------------------xxxx---------------------------------------------------------
x-------------------------------------------------------------------------------------------------xx---x--------------------------------------------------------
-x-----------------------------------------------------------------------------------------------xx-----x-------------------------------------------------------
--x------------------------------------------------------------------------------oo-----xxx-----xx-------x------------------------------------------------------
-----------------------------------------------------------------------------------xxxxxx---xxxxx------E--xxxxxxxxxxxxxxxxxxxxxxxxxx----------------------------
----------------------------------------------------------------------Eooo--------xxXXXXX--xx--XX---------SSSSSSSSSSSSSSSSSSSSSSSSX-x--------------------------x
---------------------------------------------------------X--EX--------XXXXX------xx--------x--------------------------------------X--x---E--------------------xx
---------------------------------------------------------X---X------------------xx------------------------------------------------X---x----------------------xx-
---------------E--------Q?-----XXXXX----------X-EE-----X-X---X-------------xxxxxx----------------------------------E-----E---E----X--E-x------------------xxxx--
-----E----XXX-<>---------------xxxxx----------XSSSSSSSSX-XSS?X-----xxxxxxxxx---XXXXX------------------------------<>----<>--<>---?X-<>--x----------------xxXEXXX
--------------[]--------------x----xx-----------------------------xxXXXXXXXX--------------------------------------[]----[]--[]----X-[]---x--------------xx------
--------------[]---------xxxxx------xx----xxx--------------------xx-----------------------------------------------[]----[]--[]----X-[]----x---------xxxxx-------
---E----------[]---xxxxxxx-----------xxxxxx--xxxxxxxxxxxxxxxxxxxxx-----------o------------------------------------[]----[]--[]----X-[]-E---xxxxxxxxxx--x--------
--<>XX--------XXXXXxXXXXXX--------------XXX--XXXXXXXXXXXXXXXXXXXXX----------XXX-----------------------XXXXXXXXXXXXXXXXXXXXXXXXXXXXXXXXXXXXXXXXXXXXXXXEEXEXX-----
XX[]XX--------XXXXXXXXXXXX--------------XXX--XXXXXXXXXXXXXXXXXXXXX------------------------------------XXXXXXXXXXXXXXXXXXXXXXXXXXXXXXXXXXXXX---------------------