----------------------------------------------------------------------------------------------------------------------------------------------------------------
----------------------------------------------------------------------------------------------------------------------------------------------------------------
x---------------------------------------------------------------------------------------------------------------------------------------------------------------
----------------------------------------------------------------------------------------------------------------------------------------------------------------
----------------------------------------------------------------------------------------------------------------------------------------------------------------
--o-o------------------------------------------------------------------------------x---------------------------------------------------x------------------------
-xo-o-------------------------------------------------------------------------------x--------------------------------------------------x-X-----------------Q----
--x----------------------------------SS----------------------------------------------x-----------------------------------------------x--x-----------------------
---x----------------------------------------------------------------------------------xx-------------------------------------------x-xx-X-X---------------------
----xx---------------------------------------------------------xxxxxx----oooo--xxx------x-----------------E------------------E--------x-X-----------------------
---XX-x----------Q-------------------------------------------xxx--x--x---oooo-xx--x------x----xxxx------------------------?SoS------x-X-X--------------x-x-?----
-------x--------------------------------------oo------------xxXX--X---x------xx-----E-----x--xx---xxxxxxxxxxxx----------------------x-X-X-----------Ex-<--------
--------x-------------------------------E---------xxxxxx---xxXXX--X----xxxxxxx-------------xxx----XXXXXXXXXXX-x-----------E-S-Sx-x--X-X-X------------xx[x--x----
---------x---------------------------------------xx<>---x-xxXXXX--X----XXXXXXX--------------x---------------X--xxxx-------Ex-x-x----X-X-Xx-x-x-x-x-x--x[>-x--x-x
----------xxxxxxxxxxxxxxxxxxxxxxxxxxxxxxxxxxxxxxxx-[]----xxXXXXX--X----X------------------XXX---------------X-X-x--xxxxxxx-X-XEXx---X-X-XX-X-X-X-X-XxX-X]X-X-X-X
----------XXXXXXXXXXXXXXXXXXXXXXXXXXXXXXXXXXXXXXXXXXXXXXXXXXXXXX--X----X------------------------------------X-X-X-XXXXXXXXxXxXxX--xXXXXXXXxXxXxXxXxXxX-X]X-XxXxX