----------------------------------------------------------------------------------------------------------------------------------------------------------------
----------------------------------------------------------------------------------------------------------------------------------------------------------------
x---------------------------------------------------------------------------------------------------------------------------------------------------------------
----------------------------------------------------------------SS--------------------------------------------------------------------SS-------------XXXX-------
-xx-------x-----------------------------------------------------[]--------------------------------------------------------------------[]--------------[]--------
---x----xxx-----------------------------------------------------[]--------------------------------------------------------------------[]--------------[]--------
----x--xxXSx----------------------------------------------------<>--------------------------------------------------------------------<>--------------[]--------
-----x-xEX--x--------------------------------------E-----------------------------------------------------xx---xx--------------------------------------[]--------
------xXXX---x---------------------------------------------------E--------------------------------------xx-xxxx-x----------------------E--------------[]--------
-------XXXS---x------------------------------S----------------xxxx-------------------------------------xx--XXXX--x------------------xxxx--------------[]------xx
x------XXX-----x-----------------xxxxx-----------------------xx<>-x-QQQQQQ?QQQQQ?QQQQQQQ?Q-------xxxxxxx----------x----------------xx<>-x-QQQQQQQQ?Q--<>-----xxX
------XXXX------x---------------xxE---x-----xxx-------------xx-[]--x----------------------------xxE---x------------x--------------xx-[]--x------------------xx-X
----EXXXXX-------x--------x----xx<>-X--x---xxS-x-----------xx--[]---x--------------------------xx<>-X-X---------XX--xx-----------xx--[]---x----------------xx--X
----XXXXXX--------xxxxxxxx-xxxxx-[]-X---xxxx-S--xxxxxxxxxxxx---[]----xxxxxxxxxxxxxxxxxxxxxxxxxxx-[]-X-X-------------X-xxxxxxxxxxxx---[]----xxxxxxxxxxxxxxxxx--EX
---XXXXXXXXXXXXXXXXXXXXXXXXXXXXXXXXXXXXXX<>XXXXXXXXXXXXXXXXXXXXXXXXXXXXXXXEEXXXXEEXXXXXEXXXXXXXXXXXXXXX-------------XXXXXXXXXXXXXXXXXXXXXXXXXXXXXEXEXXXXXXXXXXXX
XXXXXXXXXXXXXXXXXXXXXXXXXXXXXXXXXXXXXXXXX[]XXXXXXXXXXXXXXXXXXXXXXXXXXXXXXXXXXXXXXXXXXXXXXXXXXXXXXXXXXXX-------------XXXXXXXXXXXXXXXXXXXXXXXXXXXXXXXXXXXXXXXXXXXX