----------------------------------------------------------------------------------------------------------------------------------------------------------------
--------------------------------------------------------------------------------------------------------------------------------------------x-x-----------------
x-----------------------------------X-X-------------------------------------------------------------------------------------------x-x-x-x-x-----x-x-------------
-x----------------------------------[-------------------S-S---------------------------------------------------------------------x-x-S-?-?-Sx-x-xS-S-------------
--x-x------------------------------X[X----------------------------------------------------------------------------------------x-x-Sx-x-x-x-x----SxS-x-x-x-x-x-x-
---x--------------------------------[]-------------------S----------------------------------------------S-S-------------------S-Sx-S-?-?-S-S----SSS-S-S-S-S-S-S-
------x-----------------------------[]---------------------------------------------------------------------------------------x-x-S--------------SSSx-x-x-x-x-x-x
-----x------------------------------[]-----------------------------------------------------------------S-S------------------xx-S-----------------S-S-S-S-S-S-S-S
--------x---------------------------[]--------x-x-x-x-------x-x---------o-o-------------------------------------------------xx-------------------S-S------------
-------x----------------?-Q-?-Q-Q---<]------x-x---x---x---x-x-----------o-o-------------------------------X---------------x--x------X-X-----------E---<---<---<-
----------x------E-------------------]----x-X-Xx--Xx-xX-x-x->x--x-------Eo-o------x-x---------------S-S-S-X-------------x-<x-S----X-X-X----------->---[E--[E--[E
---------x--x-x----------Q-Q-Q-QEQ--->----xxXxX--x-----xSx-x]--x--x-x-x-xoxox-x-x-x---------x-x-x-----------------------xx[x------XXXXXX----------]---[>--[>--[>
--<--------xX---x-x-x-x-x-x-x-x-x-x-x-x-x-XxXXX--X---X--Sx-<]-----X-X-X-X-X-X-X-X-Xx--x-----x->->-x--S-S-Sx-x-x-------x--x[>----X-XXXXXX---------<]---[]--[]--[]
--[---------XxX-X-X-X-X-X-X-E-X-X-X-X-X-XxXXXX-E--------SS-[X----x-x-x-x-x-x-x-x-xX--x--x-x--x]x]x--x-x-x-x-----x-x-x-xx--[]--E-XXXXXXXX---------[]-X-X]X-X]X-X]
-X[>--------XXXxXxXxXxXxXxXxXxXxXxXxXxXxXxXXXX----------XS-[X----X-X-X-X-X-X-X-X-XX-----X-XxX<X<X-X-X-X-X-Xx-x--X-X-X-XxX-X]X-X-XXXXXXXXX---X-X-X[X-X-X]X-X]X-X]
--]]--------XXXXXXXXXXXXXXXXXEXXXXXXXXXXXXXXXX----------XSXX----XX--------------------XxXxXxX[X[X-XxXxXxXx----XxXxXxXxX-X-X]X-XXXXXXXXXX----X-X-X[X-XXXXXXXXXXXX