---XX--XXXXXXXXX--X------XXXXXXXXXXXXXXXXXXXXXXXXXXXXXXXXXXXXXXXXXXXXXXXXXXXX--XXXXXXXXXXXXXXXXXXXXXXXXXXXXXXXXXXXX--XXXXXXXXXXXX--XXXXXXXXXXXXXXXXXXXXXXXXXXXXX
---xx--X-xxxxxxx--x-------xxxxxxxxx--[]---xxxxxxxxxx--X---xxxxxxxEE-xxxxxxxxx--X---xxxxxxxxxxxxxxxxxxxxxxxxxxxxxxxx--EE-xxxxxxxxx--xxxxxx---[]-----[]---xxxxxxxx
xxx-xxxxx-------xxxx-----x--------xx-[]--x-------B-xx-X--x------xxxx--------xx-X--x-------------------------------xxxxxx--------xxx-----xx--[]-----[]--x--------
-------------------xx---x----------xx<>-x-----------xxX-x--------------------xxX-x---------------------------E---------------------------xx-[]-----<>-x---------
--------------------xxxx------------xxxx---SSXSS-----xxx----------------------xxx-------------E-------------------------------------------xx<>-----xxx----------
---------------------------------------------b---------------------------------------------------------------------------------------------xxx----x---ooo----SSS
---------------------------------------------B-----------------------------------------------------------------------------------------------xxxxx--------------
--------------------------------------------------------oooo--------------------------------------------------------------------------------E-------------------
---------------------SSSSSS------?------------------------------------------------------------------------------------------------------------------------------
----------------------------------------------------------------------------------------------------------------------------------------------------------------
----------------------------------------------------------------------------------------------------------------------------------------------------------------
Q-------------------------S-------------------------------------------------------------------------------------------------------------------------------------
----------------------------------------------------------------------------------------------------------------------------------------------------------------
----------------------------------------------------------------------------------------------------------------------------------------------------------------
----------------------------------------------------------------------------------------------------------------------------------------------------------------
----------------------------------------------------------------------------------------------------------------------------------------------------------------