----------------------------------------------------------------------------------------------------------------------------------------------------------------
----------------------------------------------------------------------------------------------------------------------------------------------------------------
x---------------------------------------------------------------------------------------------------------------------------------------------------------------
-x--------------------------------------------------------S-----------------------------------------------------------------------------------------------------
--x-------------------------------------------------------------------------------------------------------------------------------------------------------------
---x------------------------------------------------------------------------------------------------------------------------------------------------------------
----xSSS------------------------------------------------XXXX--------------------------------------------------------------------------E-------------------------
-----x--xxxxxxxxxxx------------SSSSSS--------------XXX--XXX--------------------------------------SSSSSS---------------------------SSSSSSSSSS-------XX-----------
------xxxXXXXXXXX--x------------------------------------------------------------------------o-------------------------------------------------------------------
-------xXXXXXXXX----x-----------------------xxx--xxxxx-------------------------------------XXX------------------------------------------------------------------
-------XXXX----------x----------E--E-----xxxx--xxx----x----------xxxxxxx--------------------------E-------------------------------------------------------------
------XXXXX-----------x--------SSSSSS---xxXXX--XXX-----x--------xxXXXXX-x---------------S--------SSSSSS-xxx-------E-----------------xxx---SSSSS-----------------
-----XXXXXX------------x---------------xxXXXXE----------xx-----xxXXX-----------------------------------xxX-x-----<>-----xxxx-------xxX-x------------------------
----XXXXXX----<>--------x---------xxxxxxXXXXX----------XX-xxxxxxXXX---------------xxx-----------------xx-X--x----------xx<>-x-----xx-X--x-------------xxx-------
----XXXXXX----[]---------xxxxxxxxxx---xXXXXX-----------XXXXXXXXXXXX------xxxxxxxxxxE-xxxxxxxxxxxxxxxxxx--X---xxxxxxxxxxx-[]--xxxxxx--X---xxxxxxxxxxxxxx--xxxxxxx
----XXXXXX----[]---------XXXXXXXXXX-X-XXXXXX-----------XXXXXXXXXXXX----XXXXXXXXXXXXXXXXXXXXXXXXXXXXXXXXXXXXXXXXXXXXXXXXXXXXXXXXXXXXXXXXXXXXXXXXXXXXXXXX--XXXXXXX