----------------------------------------------------------------------------------------------------------------------------------------------------------------
----------------------------------------------------------------------------------------------------------------------------------------------------------------
xxx-------------------------------------------------------------------------------------------------------------------------------------------------------------
----------------------------------------------------------------------------------------------------------------------------------------------------------------
---x------------------------------------------------------------------------------------------------------------------------------------------------------------
----x-----------------------------------------------------------------------------------------------------------------------------------------------------------
----X--------------------------------E---------------------E----------------------------------------------------------------------------------------------------
-----------------------Q-----------SSSSSS---------------SSSSSSS-------------------------------------------------------------------------------------------------
-------------------------------------------------------------------------------------------------------------------------------------------------------E--------
-------------------------------------------------------E--------------------------------------------------xx----------------------------------------------------
-----x-------------------------------E---------------------E----------xxxx-?---------------------xxxx----xx-x-------------------------E---------------ox------S-
------xx----------xxxx-?-------------QQ?QQ-----------S?S---QQ?QQ-----xx<>-x---------------------xxXX-x---x---xxx-------------------------------------xx-x-------
-----<>-x--------xx<>-x---------------------------------------------xx-[]--x-------------------xxXXX--x------<>-x----------------------xxxx---------xx---x------
-----[]--x------xx-[]--x----------------------xxx------------------xx--[]---x----------xxxxxx-xxXXXXX--x-----[]--x--------------xxx---xx<>-x-------xx-----xxxxxx
---X-[]---xxxxxxx--[]---xxxxxxxxxxxxxxxxxxxxxxx--xxxxxxxxxxxxxxxxxxx---[]----xxxxxxxxxxx--EE-xxXXXXXX---x----[]---xxxxxxxxxxxxxxxE-xxxx-[]--xxxxxxxx------XXXXXX
XXXXXXXXXXXXXXXXXXXXXXXXXXXXXXXXXXXXXXXXXXXXXXX--XXXXXXXXXXXXXXXXXXXXXXXXXXXX<>XXXXXXXXX--XXXXXXXXXXXXXXXXX--[]XXXXXXXXXXXXXXXXXXXXXXXXXXXXXXXXXXXXX------------