----------------------------------------------------------------------------------------------------------------------------------------------------------------
----------------------------------------------------------------------------------------------------------------------------------------------------------------
----------------------------------------------------------------------------------------------------------------------------------------------------------------
------------------------------------------------xx--------------------------------------------------------------------------------------------------------------
-----------------------------------------------xx-x-----------------------------------?-------------------------------------------------------------------------
-----------------------------------------------x--X------------------------------------------------------------------------------------------x------------------
----------------E---E-----------------------------X----------------------------------------------------------oo-------------------------------x-----------------
-----------SSQQSSSSSSSSSSS------------------------X-------E-------------------------XXX---------------o------------XXX-----------------xxx-----x----------------
---------------------------------------------xx---X-------------------------------------------------X---xxxxx------------------xxxxxxxxx--x-----x---------------
--------------------------------------------xx----X---xxxxx------------------xxxxxxxxxxxxxxxxxxxxxxxxxxxx----x-----xxx--------xxXXXXXXXX---x-----x--------------
-------------------------------------------xx-----X--xxXSS-x----------------xx-XXXXXXXXXXXXXXXXXXXXXXXXXX-----xxxxxx--xxx----xx-------------x-----x-------------
-----------SSSS---xxx---SSSSS------------xxx------X-xxXX----xE-------------xx---------------------------------XXXXXX-XXX-x--xx---------------------x-----------Q
-----------------xxX-x------------------xx<>------Xxx-XX-----x------------xx----------------------------------------------xxx-----------------------x-----------
----------------xx-X--x--------xxxxx--Exx-[]------Xx--XX------xxxxxxxxxxxxx----------------------------------------------XXXXX--------------X--------x----------
---xxxxxxxxxxxxxx--X---xxxxxxxxx----xxxx--[]--E---X---XX-----XXXXXXXXXXXXXX-----------------------------------------------------------------X---------xxxxxxxxxx
XXXXXXXXXXXXXXXXXXXXXXXXXXXXXXXX---XXXXXXXXXXXXXXXXXXXXXXX----------------------------------------------------------------------------------XXXXXXXXXXXXXXXXXXXX