----------------------------XXXXXXXXXXXXXXXXXXXXXXXXXXXXXXXXXXXX<>XXXXXXXXXXX---XXXXX-XXXXXX-X------------------XXXXXXXXXXXXXXXXXXXXXXXXX----XXXXXXXXXXXXXXXXXXX
----------------------------XXXXXXEXXXXXXXX---------------[]---------------------------------X------------------------------------------X------------------[]--[
------------------------------E---XXXXXXXXX---------------[]---------------------------------X------------------------------------------X------------------[]--[
-----------------------------------XXXXXXXX---------------<>------------------XX?-----------------------------------E----------------E--X------------E-----[]--<
-----------------------XX----<>-----XXXXXXX--------------------------------------------XXX-------------------------------SSS----E--S----X------------------<>---
-----------------------------[]------XXXXXX-------------------?--------o---------------[]-------------------------------------------------------------------E---
-----------------------------[]-------XXXXX--------------------------------------------<>-----------E-----------------------------------------------------------
-----------------------------[]--------XXXX---------------------------------------------------------------------------------------------------------------------
-----------------------------[]---------XXX--------------------------------------XXXX-----------------XX-----------------------SSSSSSSS------SSSSSS-----------?S
----------------------oo-----XX----------XX--------------------------------------oooo----------------------E-----------------------------------o----------------
------------------------------------------XXXXXXXXXXXXXXXXE-----------------------------------------------------------------------------------------------------
-----------XXXXXXXXX-------------------------------------oX>----------------------------------------------XXX---------------------------------------------------
----------------------------------------------------------------------------------------------------------XX----------------------------------------------------
----------------------------------------------------------------------------------------------------------------------------------------------------------------
----------------------------------------------------------------------------------------------------------------------------------------------------------------
XXXXXXXX--------------------------------------------------------------------------------------------------------------------------------------------------------