------------------------------------------------------------------------------------XXXXXXXX-XXXXXXXX----XXXXXXXXXXXXXXXXXXXXXXXXXXXXXXXXXXXXXXXXXXXXXXXXXXXXXXX
------------------------------------------------------------------------------------------[]------------------------[]------------------------[][]--------------
------------------------------------------------------------------------------------------[]------------------------[]------------------------<>[]--------------
----------------------------------------------------------------------------XXXXXX--------[]------------------------<>---------------E---------E<>--------------
---------------------------------------?--------------------------------XXX-------------?-[]----------------------------?----------Q-E--------------------------
---------------------------------------------------------------------------------XXXX-----<>------------------------------------------Q-------------------------
----------------------------------------------------------------------------------------------------------------------------------------------------------------
--E--S----------------------------------------------------------------------------------------------------------------------------------------------------------
-<>--------------------------------------SS----------------------------------------------------------SSSSSS-------------Q---------------------------XX----------
-[]-------------------------------------------X-----------------------------------------------------------------------------------------------------------------
-[]----------------------------------SS------XX-----------------------------XXXX--------------------------------------------------------------------------------
SXXS----------------------------------------XXX-------------<>------X-------ooo---------------------------S-----------------------------------------------------
-----------E----------------------B--------XXXX------<>-----[]-----XXX------------------------------------------------------------------------------------------
-----<>---------------------------b-------XXXXX------[]-----[]----XXXX------------------------------------------------------------------------------------------
-----[]----------------------------------XXXXXX------[]-----[]---XXXX-------------------------------------------------------------------------------------------
XXXXXXXXX-X-XXXXXXXXXXXXXXXXXXXXXXXXXXXX-XXXXXXXXXXXXXXXXXXXXXXXXXXXX-------------------------------------------------------------------------------------------