------------------------XXXXXXXXXXXXXXXXXXX-X-------------------------------------------------------------------------------------------------------------------
----------------------------------------------------------------------------------------------------------------------------------------------------------------
----------------------------------------------------------------------------------------------------------------------------------------------------------------
----------------------------------------------------------------------------------------------------------------------------------------------------------------
--------------------------------------------------------------------?-------------------------------------------------------------------------------------------
----------------------------------------------------------------------------------------------------------------------------------------------------------------
----------------o------------------------------------------------------------------------------------------------------------------E-------E-------------------E
----------------oo-----XXX------------------------------------------XX------------------------------------Q-----------------------SQS--SSSSSS--SSQSSS?SSS--SSSSS
-----------------o----------------------------------------------------------------------------------------------------------------------------------------------
-------------------------------------------------------XX---------------------------------E---------------------------------------------------------------------
-----------------XXXX--------------------------XXXXX------------------------------------------X-----------------------------------------E-------------------E---
----------------------------------------------------------------------------------------------X--X------S?SQS-----------S---------SQS--SSSSSS--SSSSSSSSSS--SSSSS
-----------E-------------------------------------------------------------------XXXXXXXXXXXXXX-X--XX-------------------E-------<>--------------------------------
-----------X----------------------------------------------------<>--------------------------X-X--XXX--------------------------[]--------------------------------
-----------X----------------------------------------------------[]--------XXXX--------------X-X--XXXX-------------------------[]E-------------------------------
XXXXXXXXX--X----------------------------------------------------[]--------------------------X-X--XXXXXXXXXXXXXXXXXXXXXXXX--XX-XXXXXXXXXXXXXXXXXXXXXXXXXXXXXXXXXX