----------------------------------------------------------------------------------------------------------------------------------------------------------------
----------------------------------------------------------------------------------------------------------------------------------------------------------------
----------------------------------------------------------------------------------------------------------------------------------------------------------------
----------------------------------------------------------------------------------------------------------------------------------------------------------------
---------------SSSSSSSSSSSSSSSSSSSSSSSSSSSSSSSSSSSSSSS?SSSSSSSSSSSSSSSSSSSSSSSSSSS?SSSSSSSSSSSSSSSSSSSSSSSSSSSSSSS----------------------------------------------
---------------------SS--SS------SSSS------------------------------------------------------------------------SSSSS----------------------------------------------
---------------------SS--SS--E---SSSS------------------------------------------------------------------------SSSSS----------------------------------------------
-------------------SS--------SS------------------oooooo------------------------------------------------------SSSSS--------------------E--S----------------------
-------------------SS--------SS------------------------------------------------------------------------------SSSSS-------------------<>-------------------------
-------------------SS--------SS------------------SSSSSS------------------------------------------------------SSSSS-------------------[]-------------------------
-------------------SS----o??-SS---E----------E---SSSSSS-----------------------XXXXX-----E-----E-----E--------SSSSS-------------------[]-------------------------
-------------------SSSS--SS--SS--SSSS-------<>--------S----------------------XXXXXX----<>----<>----<>----<>-----SS------------------SXXS------------------Q-----
---------------------SS---------EE-------XX-[]--------------------<>--------XXXXXXX----[]----[]----[]----[]-----SS----------------------------------------------
-----------B---------SS-----------------XXX-[]--------------------[]-------XXXXXXXX----[]----[]----[]----[]-----SS-------B---------------<>---------------------
--------------------------------------E-XXX-[]--------------X-----[]-----XXXXXXXXXX----[]----[]----[]----[]------------------------------[]---E-----X-----------
XXXXXXXXXXXXXXXXXXXXXXXXXXXXXXXXXXXXXXXXXX--XX--XXXXXXXXXXXXX-----XX-----XXXXXXXXXX--XXXX--XXXX--XXXX--XXXXXXXXXXXXXXXXXXXXXXXXXXXXXXXXXXXXXX--XXXXXXXXXXXXXXXXX