-----------------------------------------------------XXXXXXXXXXXXXXXXXXXXXXXXXX[]XXXXXXXXXXXXX----XXXXXXXXXXXXXXXXXXXXXXXXXXXXXXXXX--XXXXXXXXXXEXXXXXEXXXXXXXXXX
-----------------------------------------------------XXXXXXXXXXXXXXXXXXXXXXXXXX<>XXXXXXXXXXXXX----XXXXXXXXXXXXXXXXXEEXXEEXXEEXXXXXX---X-X-X-X-X-X-X-X-X-X-X-X-X]
--------------------------------------------------------------B----------[]-----E------------X-----[]XX[]-----------------------------X-X-X-X-X-E-X-X-E-X-X-X-X]
-------------------------------------------------------------------------[]------------------------[]XX[]----------------------E------------------------------[]
---------------------------------S----------oo---------------------------[]------------------------[]XX[]------------------------------Q-Q-Q-Q-?-Q-Q-?-?-Q----[>
--------------------------------------------------------------SSSS-------<>------------------------<>XX[]--------QQ?QQQ?QQQ?QQQQQ-----------------------------[-
------------------------------------XXXXX--XXXX----------------SSS--------E--------------------------XX[]-------------------------------Q-Q-Q-Q-Q-Q-Q-Q-Q-----<-
------------------------------SSSS------------------------------SS-----------------------------------XX[]-------------------------------------------------------
-----------------------------------------------------------------S--------------------E---------------X[>-------------------------------------------------------
------------------XXXXXXX-----------------------------------------SSSSSSSSSSS--------------------------<---------------------------<>---------------------------
------------------------------------------------------E----------------------------------------------------------------------------[]---------------------------
-------------<>----------------------------E---------------------------------------------------------------------------------------[]---------------------------
-------------[]---------------------------<>--------------------------------------------------------------------------------------XX]---------------------------
-------------[]---------------------------[]----------------------------------------------------------------------------------------S---------------------------
----------E--[]--------------------------X[]XXXXX---------------------------------------------------------------------------------------------------------------
XXXXXXXXXXXXXXXX----------------XX------------------------------------------------------------------------------------------------------------------------------