-------------------------------------------------------------------------------------------------------------------------------XXX-XXXXXXXXXXXXXXXXXXXXXXXXXXXXX
---------------------------------------------------------------------------------------------------------------------------------------------------------[]-----
---------------------------------------------------------------------------------------------------------------------------------------------------------<>-----
----------------------------------------------------------------------------------------------------------------------------------------------------------E-----
---------------------------------------------------------------------------------------------------------------------------X------------------------------------
---------------------------------------------------------------------------------------------------------------------------XX-----------------------------------
-------------------------------------------------------------------SSSSSSSSS----------------S-------------E--------X--------------------------------------------
------------------------------------------------------------------S-------------------------------------SSSS------XX-----------oo-------------------------------
-------------------------------------XXX-------------------------SS----------------------------------------------XXXXX------------------------------------------
----------------------------------------------------------------SSS------E-------E------------------------------EXXX--------------------------------------------
---------------------------------------------E---------XX------SSSS-----<>----------?QQ------------------------XXXXX--------------------------------------------
------------E----X------------------------------------XXX---------------[]-------------------<>-----XX--SSS---XXXXXX--------------------------------SSSSSSSSSSSS
-----------<>---XX-----------E-----------------------XXXX---------------[]-------------------[]----XXX-------XXXXXXX-E------------------------------------------
-X---------[]--XXX---<>-----------------------------XXXXX------B--------[]-------------------[]---XXXXX----XXXXXXXXX<>------------------------------------------
-X-E-E-----[]-XXXX---[]----------------------XXXXXXXXXXXXXXXXXXXXXXXXXXXXXXXXXXXXXXXXXXXXXXX-XX--XXXXXX---XXXXXXXXXX[]------------------------------------------
XXXXXXXX---XXXXXXXXXXXXXX-X-X-XXXX-----------XXXXXXXXXXXXXXXXXXXXXXXXXXXXXXXXXXXXXXXXXXXXXXX-XX--XXXXXXXXXXXXXXXXXXX[]------------------------------------------