-----------------X---XXXXXXXXXXXXXXXXXXXXXXXX--------------------------------------------------------------------------------------------------------[]---------
-----------------X----------XXXXXXXXXX-----XX--------------------------------------------------------------------------------------------------------[]---------
-----------------X-----------XXXXXXXXX-----XX--------------------------------------------------------------------------------------------------------<>---------
------------------------------XXXXXXXX-----XXXXXXXXX------------------------------------------------------------------------------------------------------------
-------------------------------XXXXXXX-----------------------------------------------------------------------------------------------oo-------------------------
--------------------------------XXXXXX----------------------------------------------------XXX-------------------------------------------------------------------
---------------------------------XXXXX--------------------------------------------------------------------------------------------------XXX---------------------
------XX--------------------------XXXX------------------------------------XXX---------------------E-----------------------oooo----------------------------------
-----------------------------------XXX--------------------XXX-------------XXX---------------------------------------------o--o---------------------------E------
--------------------------------------------------------------------------XXX-----------------XX----------------------------------------------------------------
------------XXX--------------------------------------------------------XX-XXX------------------------------------------------XXXXXXXXXXX----------------------X-
----------E-----------------------------------------------------------XXX-XXX-----------------------XXX---XX-----E----------------------------X-----------------
---------------------------------------------------------------------XXXX-XXX-----------------------------XX---------XXXXX--------------------X-----------------
--------------------------------------------------------------------XXXXX-XXX-----------------------------XX----------------------------------X-----------------
-------------------------------------------------------------------XXXXXX-XXX--------------------ooo------XX-----XXX--------------------------X-----------------
XXXX-------------------------------------------------------XXXXXXXXXXXXX--XXXXXXXXXXXXX----------XXX---XXXXX----------------------------------X-----------------