-------------------------------------------------------------------XXXXXXXXXXXXXXXXXXXXXXXXXXXXXXXXXXXXXXXXXXXX---------XXXXXXXXXXXXXXX-XX-XXXXXX---XXXXXXXXXXXX
---------------------------------------------------------------------b------------XXXXXXXXXXXXXXXXEXXXXXXXXXXXE----------------E---------------XXX--------------
---------------------------------------------------------------------B-------------XXXXXXX-----------------------------------------------------XXX--------------
------------------------------------------------------------------------------------XXXXXX----------------b--------XXXXX?----------------------XXX--------------
----------------------------------------------o--------------------------------------XXXXX---?------------B------------------------------------XXX-------QQS--SS
----------------------------------------------o---------------------------------------XXXX----------------------------------------------------------------------
---------------E------------Eooo-----------------XXXXXXXXXXE---------------------------XXX---------------------------------------------------------oo-----------
-----------SSSSSSSS---------XXXXX------------XX-----------------------------------------XX----------------------------------------------------------------------
-----------------------------------------------------------------------------------------X-------------------------------XXXXXX--------------------------SQS--SS
-------------------------------------------------------------------------------------------------------------------------ooooo----------------------------E-----
----o--------------------------------XXXXXX---------------------------------------------------------------------------------------------------------------------
---------QQQQ--QQ?QQQQQQ--XXXXXXXX------------------------------------------------------------------------------------------------------------------------------
----------------------------------------------------------------------------------------------------------------------------------------------------------------
-----------------------------------o------------------------XXXX------------------------------------------------------------------------------------------------
----------------------------------XXX---------------------------------------------------------------------------------------------------------------------------
XXXXXXXXXXXXXXXXXXXXXXXXXX--------------------------------------------------------------------------------------------------------------------------------------