-----------------------------------------------XX-------X-----------------------------------XXXXXXXXXXXXXXXXXXXXXXXXXXXXXXXXXXXXXX-------------------XXXXXXXXXXX
--------------------------------------------------------X-----------------------------------------------------E-E----------------------XXX----------------------
--------------------------------------------------------X-------------------------------------------------------------------------------o-----------------------
-----------------------------------------------------------XX----------------------------XXX?----------E--------------------------------------------------------
----------------------------------------------------------------SSS--[]SSSSSSSSSSSSSSS------------------------------------XXX-------XXX-------------------------
-----------------------------------------------?---------------------[]SSSSSSSSSSSSSSS------------------------------------[]--------------XXX------------------o
---------------------------------------------------------------------[]SSSSSSSSSSSSSSS------------------------------------[]------------------------------------
--------------XXX----SS---------XXX---------------------S------------[]SSSSSSSSSSSSSSS------------------------------------<>------------------------------------
-------------XXXX--------------XXXX----------------------------------[]SSSSSSSSSSSSSSS-------XoXX--------------------------E------------------------------------
------------XXXXX-------------EXXXX---------oo-----------------------[]SSSSSSSSSSSSSSS-------ooooo--------------------------------------------------------------
-----------XXXXXX------------XXXXXX---------oo------------------------]SSSSSSSSSSSSSSS-----------------------------------------------------------XX-------------
----------XXXXXXX---SSS-----XXXXXXX-----------------------------------]SSSSSSSSSSSSSSS--------------------------------------------------------------------------
---------XXXXXXXX----------XXXXXXXX-----------------------------SSSSSSSSSSSSSSSSSSSSSS--------------------------------------------------------------------------
--------XXXXXXXXX---------XXXXXXXXX-----------------------------SSSSSSSSSSSSSSSSSSSSSS--------------------------------------------------------------------------
-------XXXXXXXXXX--------XXXXXXXXXX----E------------------------SSSSSSSSSSSSSSSSSSSSSS--------------------------------------------------------------------------
XXXXXXXXXXXXXXXXXXXXXXXXXXXXXXXXXXXXXXXXXX----------XX----------XXXXXXXXXXXXXXXXXXXXXX--------------------------------------------------------------------------