--------------------------------------------XXX-----------------------------------------------------------------------------------------------------------------
--------------------------------------------ooo-----------------------------------------------------------------------------------------------------------------
----------------------------------------------------------------------------------------------------------------------------------------------------------------
-----------------------------------------------------------------------------------------------------------------------------------------XXXX-------------------
-----------------------------------------------XX-----------------------------------------------------------------------------------------[]--------------------
---------------------XX-------------------------------------------------------------------------------------------------------------------[]--------------------
----------------------------------------XXX-----------------------------------------------------------------------------------------------[]--------------------
-------------XX----------XXX---------------------------------------------------------------------SSSSS------------------------------------[]----<>--------------
------------XXX------------------------------E----XX-------------------------------------------E------------------------------------------[]----[]--------------
-----------XXXX----------------XXXXXXX----------------------------------------------------------------------------------------------------[]----[]--------------
----------XXXXX-----------------------------------------------------------------o---o-------------------------------------QQQQ?QQQ?QQQ?Q--<Q---S[]----?QQ-------
---------XXXXXX-------------------------------------------------<>-----------------------------<>---XXX--SSS------------------------------------[]--------------
-E------XXXXXXX---------------------------------------X---------[]-----------------------------[]---X-------------------------E-----------------[]--------------
-------XXXXXXXX---------------------------------------X---------[]--B--------------------------[]------------------------X----------------------[]--------------
------XXXXXXXXX---------------------------------------X---------[]-----------------------------[]-----------------------XXXXXXXXXXEEXXXEXXXXXXXXXXXXXXXXXXXXX---
XXXXXXXXXXXXXXX---------------------------------------XXXXXXXXXXXXXXXXXXXXXXXXXXXXXXXXXXXXXXXXXXX----XX--XXXXXXXXXXXXXXXXXXXXXXXXXXXXXXXXXXXXXXXXXXXXXXXXXXXXX--