------------------------------------------------------------------------------XXXXXXXX-----------------------------X-----------XX-------------------------------
------------------------------------------------------------------------------XXXXXXXX-----------------------------XXXXXXX--------------------------------------
------------------------------------------------------------------------------[]--------------------------------------------------------------------------XXXXXX
------------------------------------------------------------------------------<>--------------------------------------------------------------------------------
----SSSS-----------------------------------------------------------------------------------------------------------------------------------------------XX-------
-------------------------------------------------------------------------------------------------------------------------------?--------------------------------
----------------------------------------------------------------------------------------------------------XXXXX-------------------------------------------------
-SSS-----------?SS--------------------------------oooo------------------XXX----------------E-----------------E--------------------------------------------------
--------------------------------------------------oooo-----------------------------------------------XXXE------------------------------------------XX-----------
-S--------------------------------------------------------------------------------------E----------------------XXXX---------oo----------------------------------
S-S----------E--------------------------------------XXXXXXX-----------------------------------------------------------------oo----------------------------------
---S--------<>------S--------------------B------------------------XXX--------------------------XXXXX------------------------------------------------------------
-------E----[]--B------------------------b-----XXX--------------------------------------------------------------------------------------------------------------
------<>----[]--b------------<>----------B----------------------------------------------------------------------------------------------------------------------
------[]----[]---------------[]--------------------------------------------------------------------------------------------------------XXXXXXXXXX---------------
XXXXXXXXXXXXXXXXXXXXXXXXXXXXXXXXXXXXXXXXXXXXXX---------------------------------------------X--------------------------------------------------------------------