---------------------------XXXXXX----[]-------------------------------------------------------------------------------------------------------------------------
---------------------------XXXXXX----[]-------------------------------------------------------------------------------------------------------------------------
---------------------------XXXXXX----<>-------------------------------------------------------------------------------------------------------------------------
----------XXXXX-------------XXXXXX------------------------------------------------------------------------------------------------------------------------------
-----------------XXXXXXX-----XXXXX-----------------------------------------------------------------------SSSSSSSSSSSSSSSSSSSSSSSSSSSSSSSSSSSSSSSSSSSSSSSSSSSSSSS
------------------------------XXXX---------------------------------------------------------------------------SS--SSSSSS--SSSS-----------------------------------
-------------------------------XXXXXXXX----ooo---------------------------------------------------------------SS--SSSSSS--SSSS-----------------------------------
--------------------------------XXXXXXXX---ooo-------------------------------------------E-----------------SS--------SS-----------------------------------------
--------------ooo-------X---------------------------------------------------------------SSSS---------------SS--------SS-----------------------------------------
----------------------------SSS----------------------------------------------------------------------------SS--------SS-----------------------------------------
-----XX-----------------------------------------------------------------------------X-E--E-----------------SS----ooooSS---E-------------------------------------
----XXX---------------------------------------XXXX----------------------------------XS?SSSSS---X-----------SSSS--SSSSSS--SSSS----XXX------------<>---------QQQ--
---XXXX---------------------------------------X---------------------------------------------EE-X-------------SS---------EE---------------SS-----[]--<>----------
--XXXXX---------------------------------------X-------------------------------------SSSSSSSSSSSX-------------SS--------------------------SS-----[]--[]----------
-XXXXXX---------------------------------------X--------E--------EEE----------------------------------------------------------------------SS-----[]--[]----------
XXXXXX----------------------------------------X----XXXXXXXXXXXXXXXXXXXXXXXXXXXXXXXXXXXXXXXXXXXXXXXXXXXXXXXXXXXXXXXXXXXXXXXXXX---------X--XX--XXXXXXXXXXXXXXXXXXX