-------------------------------------------------------------------------------------------------------------------------------------X--[]-----X--XXXXXXXXXXXXXX
----------------------------------------------------------------------------------------------------------------------------------------[]--------XXXXXXXXXXXXXX
----------------------------------------------------------------------------------------------------------------------------------------[]--------oooooooooooooo
----------------------------------------------------------------------------------------------------------------------------------------<>--------oooooooooooooo
---------------------------------------------SSSSSSSSSSSSSSSSSSSSSSSSSSSSSSSSSSSSSSSSSSSSSSSSSSSSSSSSSSSSSSSSSSSSSSSSSSSSSS--------------E----------------------
------------------------------------------------------------------------------------------------------------------------------------------XXX-------------------
----------------SSS---------------------------------------------------------------------------------------------------------------------------------------------
----------------------------------------------------------------------------------------------------------------------------------------------------------------
-------------------------------------------------o---o---------------------------------o-------------------------------------------------------X----------------
----------------X------------------------------------------------------------------------------------------------------E----------------------------------------
----------------XEE---X--------------E----------S---S---------------------------------S-------------------------------<>----------------------------------------
----------------XSSSSSX-----SSS-----<>------------------XXXXXXXXXXXXXXXX--XX--XX--XX------XXXXXXXXXXXXXXXX------------[]------XXXX------------------------------
-------X-----------------------------------XSSXX--XX--XXXXXXXXXXXXXXXXXXXXXXXXXXXXXXXX--XXXXXXXXXXXXXXXXXXXX----------[]--XXX---------------------SSSSSSSSSSSSSS
-------X------------------------B---------XXXXXX--XX--XXXXXXXXXXXXXXXXXXXXXXXXXXXXXXXX--XXXXXXXXXXXXXXXXXXXX----------[]--XXX-----------------------------------
-------X---------------------------------XXXXXXXE-XXE-XXXXXXXXXXXXXXXXXXXXXXXXXXXXXXXXE-XXXXXXXXXXXXXXXXXXXX--X-------[]--XXX-----------------------------------
XXXXXXXXXXXXXXXXXXXXXXXXXXXXXXXXXXXXXXXXXXXXXXXXXXXXXXXXXXXXXXXXXXXXXXXXXXXXXXXXXXXXXXXXXXXXXXXXXXXXXXXXXXXXXXX-------XX--XX------------------------------------