--------------------------X---X---------------------------------------------------XXXXXXXXXXXXXXXXXXXXXXXXXXXXXXXXXXXXXXXXXXXX----------------------------------
--------------------------XXXXX---------------------------------------------------------------------------------------------------------------------------------
----------------------------------------------------------------------------------------------------------------------------------------------------------------
----------------------------------------------------------------------------X-----------------------------------------------------------------------------------
--------------------XXX-----------------------------------------------------------------------------------------------------------------------------------------
----------------------E---E--------------XXX--------------------------------------------------------------------------------------------------------------------
--XXXXXXXXXE----------------------------------------------------XXXXXXX-oo--------XXX-XXX-XXX-XXX-XXX-XXX-XXX-XXX-XXX-XXX---------------------------------------
---------------E---------------------E----------------------------------XXX----XX--o---o---o---o---o---o---o---o---o---o------XXXX------------SSSSS-------------
------------------------------------------------------------------------------------------------------------------------------o---------------------------------
--------------------------------------------------------------------------------------------------------------------------XXX----------------------------------E
-------------------------------------------------------------?-------------------------------------------------------------o------------------------<>------X--X
-----------------------------------------------XXXEXX--X--------------------X-----------------------------------------------------------------------[]--------XX
----------------------------------------------------X--XX-------------------------------------------------------------------------------------------[]-------XXX
------------XX-------------------XXX----------------X--XXX------------------------------------------------------------------------------------------[]------XXXX
----------------------------------------------------X--XXXX-XX--------------------------------------------------------------------------------------[]-----XXXXX
X---------------------------------------------------X--XXXXXXX----------------------------------------------------------------------X-X--XXXXX--XXXXXXXXXXXXXXXX