----------------------------------------------------------------------------------------------------------XXXXXX-------------------XX---------------------------
----------------------------------------------------------------------------------------------------------XXXXXX------------------------------------------------
----------------------------------------------------------------------------------------------------------[]-X-X------------------------------------------------
----------------------------------------------------------------------------------------------------------<>-X-X------------------------------------------------
-----------------------------------------------------------------------------------------------------------E----------------------------------------------------
-----------------------------------------------------------------------------------------------------------------------------------?----------------------------
-----------------------XX----------------------------------------------?------------------------------------------------------------------------------------XX--
-------E---------------[]----------------------------------------------E-----------XX------------------------------------------------------------------oo-------
------<>---------------[]-------------------------------------------------E-------XXX--------------------------------------------------------------------------E
------[]---------------[]--------------------------E----------ooo--------<>-------XXX-------------------------------------------oo------------------------------
------XXX--------------<>SSSSSS-------------------------------ooo--------[]-----<>XXX--------------------------------XXX--------oo----------------------XXX-----
-----------------------------------------------oo------------------------[]-----[]XXXS------------------------------E----------------------------XXX------------
------------------------E-----------<>---------oo------------------------[]-----[]XXX------------------------------<>----------------------------XX-------------
---------<><>-------------E---------[]-----------------------------------[]-----[]XXX------------------------------[]------------------XXXXXXXX-----------------
---------[][]-----XXXXXXX<>XXXXXXXXXXXXXXXXXXXXXXXXXXXXXXXXXXXXXXXXEXXXXXXXXXXXXXXXXX------------------------------[]------------------------XX-----------------
XXXXXXXXXXXXXXXXXXXXXXXXX[]XXXXXXXXXXXXXXXXXXXXXXXXXXXXXXXXXXXXXXXXXXXXXXXXXXXXXXXXXXXX----------------------------[]------------------------XX-----------------