-----------------------------------------------------------------------[]------XXXXXXXXXXXXXXXXXXXXX[]XXXXXXXXXXXXXXXXXXXXXXXXXXX-------------------------------
-----------------------------------------------------------------------<>-----XX---XXXXXXXXXXXXXXXXX<>XXXXXXXXXXXXXXXXEEXEXXXXXXX-------------------------------
------------------------------------------------------------------------------------X----[]----------E----------------------------------------------------------
-----------------------------------------------------------------------------------------[]--------E------------------------------------------------------------
-----------------------------------------------------------------------------------------[]---------------------------------------------XXXXXX----XX------------
-------------------------------------------------------------------------------------QQ?-[]-------<>SSSSSSX-XSSSSSSX------------E---------------------XXXXXXXXX-
-------------------------------------------------------------X----------oooooo-----------<>-------[]------X-X------X--------------------------------------------
----Q-Q---------------------------------------------XXXX------------E-----------------------------[]--------X---------------------------------------------------
--------------------------------------------------------------------------------------------------[]--------X---------------------------------XXoo-------XXX----
----------------------------------------------------------------X---------------------------------XX------------------------------------------------------------
--------------------------------------------o-----------XX------------------------------------------------------------------------------------------------------
----Q-Q----------------------------------------------------------------------------------------------------------------------------------------------------?----
----------------------------------------------------------------------------------------------------------------------------------------------------------------
----------------------------------------------------------------------------------------------------------------------------------------------------------------
----------------------------------------------------------------------------------------------------------------------------------------------------------------
XXXXXXXXXXXXXXXXXXXXXXXXXX---------XX-XXXXX---XXXXX-------------------------------------------------------------------------------------------------------------