----------------------------------------------------------------------------------------------------------------------------------------------------------------
----------------------------------------------------------------------------------------------------------------------------------------------------------------
----------------------------------------------------------------------------------------------------------------------------------------------------------------
----------------------------------------------------------------------------------------------------------------------------------------------------------------
----------------------------------------------------------------------------------------------------------------------------------------------------------------
----------------------------------------------------------------------------------------------------------------------------------------------------------------
-------------------------------------------------------------------------------------------------------------------------------------------------XS----------XX-
-------------------------E-----------------------------------------------------------------------------------------?SS--------------------------EX--------------
------------------------<>---------------------------------------------------------------------------------------------------------------------XXX--------------
------------------------[]--------------------------------------------------------------------------------------------------------------------XXXXX-------------
------------------------XXX----------------------------------ooo-----------<>------------------------------------E---------------------------XXXXXX-------<>----
-------------------------------------------------ooo---------------------?-[]-----------------------------------<>---ES----QQQQQQ-----------XXXXXXX-------[]----
------------<>--------------------------------------------------------<>---[]------?QQQ-------------------------[]--<>---------------------XXXXXXXX-------[]----
------------[]-------------<><>-----------------------------------B---[]---[]-----------------------<>----------[]--[]--B--E--------------XXXXXXXXX-------[]----
------------[]-------------[][]-----------------------------------b---[]---[]-----------------------[]----------[]--[]-------------------XXXXXXXXXXXXXXXXXXX----
XXXXXXXXXXXXXXXXXXXXXXXXXXXXXXXXXXXXXXXXXXXXXXXXXXXX---XXXXXXXXXXXXXXXXXXXXXXXXXXXXXXXXXXXXX--XXXXXXXXXXXXXXXXXXXXXXXXXXXXXXXXXXXXXXXXXXXXXXXXXXXXXXXXXXXXXX----