-----------XXXXXXXXXXXXXXXXXXXXXXXXXXXXXXXXXXXXXXXXXXXXXXXXXXXXXXXXXXXXXXXXXXXXXXXXXXXXXXXXXXXXXXXXXXXXXXXXXXXXXXXXXXX<>XXXXXXXXXXXXXXXXXXXXX-------------X--XXX
-----------X------------XXXXXXXXX------------------------------------------------E---XXXXX-------------[]---[][][]--------------------[]------------------X--X--
-----------X-------------XXXXXXXX--------b--------------------------------------------XXXX-------------[]---<>[][]--------------------[]------------------X-----
----------------<>-------EXXXXXXX------?-B----------<>---------------------------------XXX--XX---------<>----E<>[]--------------------[]-------XXXXXXXXXXXX-----
-----------------E--SS-----XXXXXX-----------b--------E--S?S--?SSSSSSSSSSSSSSSSSSSSSSSS--XX--XX------------------<>--------------------<>------------------------
----------------------------XXXXX-----------B--------------------------------------------X--XX----------------------?-------------------------------------------
-----------------------------XXXX-------------------------E---------------------------------XX------------------------------------------------------------------
------------------------------XXX-----------------------------------------------------------XX------------------------------------------------------------------
---------------------S---------XX--------------------------SSSSSSSSSSSSSSSSSSSSSSSSSSSS-----XX------------------------------------------------------------------
-------------------------------------------------------------oooooooooooooooooooooo--E--------------------------------------------------------------------------
----------------------------------------------------------------------------------------------------------------------------------------------------------------
----------------------------------------------------------------------------------------------------------------------------------------------------------------
----------------------------------------------------------------------------------------------------------------------------------------------------------------
----------------------------------------------------------------------------------------------------------------------------------------------------------------
----------------------------------------------------------------------------------------------------------------------------------------------------------------
X-----X---------------------------------------------------------------------------------------------------------------------------------------------------------