--------------------------------------------------------------------------X-------------------------------------------------------------------------------XXXXXX
-----------------------------------XXXXXXXX---------------------------XXXXX-------------------------------------XXXXXXXXXXXX------------------------------XXXXXX
---------------------------------------------------------------------------------------------------------------------------------------------------------------[
----------------------------------------XXX--------------------------------------------------------------------------------------------------------------------[
-----------------------------------------------------------------------------------------------------------------------------------------------------XX--------[
-------------------------------------------XXXXXXXX--o-o-XXEXXXXXXEXXXX--------------------------------------XXXX---------------------XX---o-o-XXXX-----------S[
-----------------------------------------------------o-o-----------------------------------------------------------------------------------o-o-----------------[
--?---------------------------------o---------------------------------------E----------------------------------------------------------------------------------[
-----------------E-----------------------------------XXX-----------------------------------------------------------------------------------XXX-----------------<
----------------<>----------------------------------------------XXXXX-----------------------------------XXXXXXX----------------XXXXX-o-o------------------------
----------------[]-------------E-------------------------------------------------------------------------------------------------------o------------------------
----------------XX------------------------------------------------------------------------E---------------------------------------------------------------------
------------------------------------------------------------------------------------------E--------E------------------------------------------------------------
-------------------B------------------------------------------------------------X-------------------------------------------------------------------------------
----------------------XXXXXXXXXX------------------------------------------------XX------------------------------------------------------------------------------
XXXXXXXXXXX--X-XXXXXXXXXXXXXXXXX------------------------------------------------XXX-XXXXXXXXXXXXXXXXXX----------------------------------------------------------