----------------------------X-------------[]--------------------------------------------------------------------------------------------------------------------
----------------------------XXXXXXXXXXX---[]--------------------------------------------------------------------------------------------------------------------
------------------------------------------<>--------------------------------------------------------------------------------------------------------------------
----------------------------------------------------------------------------------------------------------------------------------------------------------------
------------------------------------------------------------------------------------------------------------------------------------------------------------o---
----------------------------E--------------------------------------------------------o----------------------------------------------------------------------o---
----------------------------------------------------------------------------------------------------------------------------------------------------------------
--------------------------------------------------------------------------------S--SSS-------------------------------------------------------------XXX-----XX---
----------------------------------------------------------------------------------------------------------------------------------------------------------------
----------------------------------------------------------------------------------------------------------------------------------------------------------------
---------?-----------E------------------------------------------------------------------------------------------------------------------------------------------
-----<>-------------<>--------------------------<>---------------QQQQ?---------SS---S------------------------------------------------------------XXX-XXXX-------
-----[]-----------------------------------------[]--XXXXXXXXXXXXX------------------------------------E----------------------------------------------------------
-----[]-----------------------------------------[]--------------------------------------------------------------------------------------------------------------
--E--[]-----------------------------------------[]-------------------B---------------E--------------------E-----------------------------------------------------
XXXXXXXXXXX<>XXXXXXXXXXXX-----------------------XXXXXXXXXXXXXXXXXXX-XXXXXXXXXXXXXXXXXXXXX--XXXXXXXX-X-XXXXXXXXXXXXXXXXXXXXXXXXXXXXXXXXXXXXXXXXXX----------------