-----------------------------------------------------------------XXXXXXXXXXXXXXXXXXXXXXXXXXXXXXXXXXXXXXXXXXXXXXXXXXXXX----------XXXXXXXXX-----------X-----------
-----------------------------------------------------------------XXXXXXXXXXXXXXXXXXXXXXXXXXX-XXXXXXXXXXXXXXXXXXXXXXXXX------------------------------------------
-----------------------------------------------------------------X-------------------------------------------[]--[]--X------------------------------------------
-----------------------------------------------------------------X-------------------------------B-----------[]--[]-----XX----------------XXXXXXXX--------------
-----------------------------------------------------------------E-------------------------------------------[]--[]-----XXX--------<>----------------------<----
------------------------------------------------------------------------------------------------------------S[]--<>-----------------E----------------------[----
-------------------------------------------------------------------------------------------------------------[]--EE----------------------------------------[----
-----------S------SSSSS?SSS----------------------------------------------------------------------------------[]----------------------------------------------]--
---------------------------------------------------XXXXX------------------------------E----------------------<>----------------X-----------------------------]--
------------------------------------------------------------------------------------------------------------------------------------------------------------->--
------------S------E------X----------------------oo------------------------------------------------------------------------------------------------X------------
---------QQ-------SSSSSSSSX-------------------------------------------------------------------------------------------------------------------------------------
--------------<>------------------------------------------------------------------------------------------------------------------------------------------------
--------------[]------------------------------------------------------------------------------------------------------------------------------------------------
--------------[]-----------------------------------------------------------------------------------------------------------------------------------X-X----------
XXXXXXXXXXXXXXXXXXXXXXXXXXXXXXXXXXXXXXXXXXXXXXXX----------------------------------------------------------------------------------------------------------------