-------------------------------------------------------------------------------XXXXXXXXXXXXXXXXXXXXXXXXXXXXXXXXXX-----------------------------------------------
----------------------------------------------------------------------------------------------------------------------------------------------------------------
----------------------------------------------------------------------------------------------------------------------------------------------------------------
----------------------------------------------------------------------------------------------------------------------------------------------------------------
----------------------------------------------------------------------------------------------------------------------------------------------------------------
-------------------------------------------------------------------------------------------------------------SSSS-----------------------------------------------
-----------------------------------------------------------------------------------------------------------------------oo------E--------------------------------
-----------------------------------------------SSQSS--------------------------------------------------------------------------<>--------------------------------
-----------------------------------------------------------------------------------------------------------------E------------[]--------------------------------
------------------------------------------------------------------------------------------------------------------------------QQ--------------------------------
----------------------------------------------------------------------------------------------------------------------------------------------------------------
-----------------------------------------------SSSSSSS------------------------------------------------------------------XX-------------------------------oo-----
-------E-------------------------------------------------------------------------------------------------------------------------------------------------oo-----
----------------------------------------------------------------------------------------------------------------------------------------------------------------
------------------------------------------------------------------------XXX---------------------------------------------------XXXXXXXEXXXXXXXEEXEXEXEXXXXXXXXXXX
XXXXXXXXXXXXXXXXXXXXXXXXXXXXXXXXXXXXXXXXXXXXXXXXXXXXXXXXXXXXXXXXXXXXXX--------------------------------------------------------XXXXXXXXXXXXXXXXXXXXXXXXXXXXXXXXXX