----------------------------------------------------------------------------------------------------------------------------------------------------------------
----------------------------------------------------------------------------------------------------------------------------------------------------------------
----------------------------------------------------------------------------------------------------------------------------------------------------------------
---------------------------------XXX----------------------------------------------------------------------------------------------------------------------------
---------------SSSSSSSSS----------------------------------------------------------------------------------------------------------------------------------------
----------------------------------------------------------------------------------------------------------------------------------------------------------------
--------------------------XXX------XXXXXXXXX--------------------------------XXXE-------------------------------------------------------------------oo-----------
---------------QQ-----------------------------------------------------------------------------------------------------------------------------------------------
----------------------------------------------------------------------------------------------------------------------------------------------------------------
----------------------------------------------------------------------------------------------------------------------------------------------------------------
----------------------------------------------------------------------------------------------------------------------------------------------------------------
-------B-------QQ--QQQQQ----------------------------------------------------------------XXXXX----------------------QQ-------------------------------------------
-------b------------------------------------------------------------------------------------------------?-B-------------------------------<>--------------------
-------B------------------------------------------------------------------------XXX-----------------------b-------------------------------[]--------------------
-----------------------------------------------------XXEEXEXXXXXX-XXXXXXX---------X-----------------------------------------E-------------[]---E-E-E------------
XXXXXXXXXXXXXXXXXXXXXXXX-----------------------------XXXXXXXXXXXXXXXXXXXXX--------X---------XXXXXXX-XXXXXXXXXXXXXXXXX--XXXX--XXXXXXXXXXXXXXXXXXXXXXXXXXXXXXXXXXX