--------------------------------------------------------------------------------------------------------XXX--XXXXXXXXXXXXXXXXXXXXXXXXXX-------------------------
---------------------------XXX-------------------------------------------------------------------------------XXX--E------[]--[]---------------------------------
-------------------------------------------------------------------------------------------------------------XXX---------[]--[]---------------------------------
-------------------------------------------------------------------------------------------------------------XX----------[]--<>--E------------------------------
-------------------------------------------------------------------------------------------------------------XX----------<>---E---------------------------------
------------------------XX------------------------------------------------------------------------------------------------E-------------------------------------
-----------------------------------------------------------o----------SSSS--------------------------------------------------------------------------------------
-------------SSSSSS------------------XXX----------S-----XX-------------[]---------------------------------------------------------------------------------------
-----------------------------------------------------------------------[]--------------------------------------SSS----------?SSS--------------------------------
-----------------------------------------------------------------------[]----------------S----------------------------------------------------------------------
-----------------------------------------------------------------------[]---------------------------------------------------------------------------------------
---------<>-----SSS------------------------------SS--------------------<>-----------------------E---------------------------------------------------------------
------E<>[]----------X--------------------------------------------<>---------------------S-----<>-X-X-----------------------------------------------------------
-----<>[][]----------X--------------------------------------------[]----E----------------S-----[]-X-X-------------------------------------XX--------------------
-----[][][]----------X--------------------------------------------[]XXXXXXXXXXXXXXXXX<>XXXXXXXXXXXXXX-------------------------------------XXXXXXXXXXXEEXEXXXXXXX
XXXXXXXXXXXXXXXXXXXXXX------------------XXXXXXXXXXXXXXXXX--XXXXXXXXXXXXXXXXXXXXXXXXXX[]XXXXXXXXXXXXXX-------------------------------------XXXXXXXXXXXXXXXXXXXXXX