-----------------------------------------------------------XXXXXXXXXXXXXXXXXXXXXXXXXXXXXXXXXXXXXXXXX-XX-XXXXXXXXXXXXXXXX------XX--XXXXXXXXXXXXXXXXXXXXXXXXXXXXXX
-------------------------------------------------------------------------------------------------[]----------[]------XXXXX------------------------------X-EE----
----------------------------------------------------------------B--------------------------------[]----------[]-------XXXXXX----------------------------X-------
----------------------------------------------------------------b-----------E--------------------[]----------<>----------XXXXX----------------------------------
--------------SSSSSSSSSSSSSSSSSSSSSSSSSSSSSSS-------------------B---------------------------S?S--<>-------------------------XXXX--SSS----SSSSSS--------------SQS
------------------------------------------------------------------------------------------------------------------------------------------E---------------------
-------------------------------------------------------------------------------------------------------------------------------------o--------------------------
-----------SSS-------------------------------------XXX----------------------------------------------------------------------------------------------------------
--------------------------------------------------------------------------------------------SQS------------------------------SS----------SSSS----------------SQS
-----------S---------E---E---E---E----------------------------------------------------------------------------------------------------------------------------E-
----------S-S-------<>--<>--<>--<>------------------------------------------------------------------------------------------------------------------------------
<>-----------S------[]--[]--[]--[]--XX--<>------XXX-------------------------------------------------------------------------------------------------------------
[]--------------E---[]--[]--[]--[]------[]--XXX-----------------------------------------------------------------------------------------------------------------
[]------------------[]--[]--[]--[]------[]--XXX-----------------------------------------------------------------------------------------------------------------
[]---------------X--[]--[]--[]--[]------[]--XXX-----------------------------------------------------------------------------------------------------------------
XXXXXX----XXXXXXXX--XX--XX--XX--XX------XX--XX------------------------------------------------------------------------------------------------------------------