----------------------------------------------------------------------------------------------------------------------XXXXXXXXX-XXXXXXXXXXXXXXXXXXX-------------
--------------------------------------------------------------------------------------------------------------------------------------BEE-------X---------------
--------------------------------------------------------------------------------------------------------------------------------------b---------X---------------
-------------------------------------------------------------------------------------------------------------------XXX?---------------B---------X---------------
------------------------------------------------------------------------------------------------------------------------------------------------XXXXX-----------
-------------------------------------------------------------------------------------------------------------------------------------------------------------S--
----------------------------------------------------------E-------EXS-------------------------------------------------------------------------------------------
-------------------------------------------------------XSSSS-----XXX----------------------------------------------------------------------------------XXXX------
-------------------------------------------------------X--------XXXX---------------------------------------------------XXXXXXXX------------------SSS------------
-------------------------------------------------------X-------XXXXXS--------------------------------------------------oooooooo---------------------------------
---------------------<>----------------------<>-------EX------XXXXXX--------------------------------------------------------------------------------------------
-------------<>------[]----------------------[]--------XSSS--XXXXXXX--------------------------------------------------------------------------------------------
-------------[]------[]----------------------[]-------------XXXXXXXX------------------B-------------------------------------------------------------------------
-------------[]------[]----------------------[]------------XXXXXXXXX--------------------------------------------------------------------------------------------
----------E--[]------[]----------------------[]-----------XXXXXXXXXXXXXXXXXXXXXXXXXXXXXXXXXXXXXXXXXXXXX-XXXXXXXXXX----------------------------------------------
XXXXXXXXXXXXXXXXXXXXXXXXXXXXXXXXXXXXXXXXXXXXXXX-XXXXXXXXXXXXXXXXXXXXXXXXXXXXXXXXXXXXXXXXXXXXXXXXXXXXXXXXXXXXXXXXXX----------------------------------------------