----------------XXXXXXXXXXXXXX-X---------------------X---XXXXXXXXXXXXXXXXXXXXXXXXXXXXXXXXXXXXXXXXXXXX------------X----X-----------------------------------------
----------------XXXXXXXXXXXX---X---------------------X-------------------------[]E---------------[]--------------X----X---XXXX----------------------------------
------------------E----[]XXX---X---------------------X-------------------------<>----------------<>--------------X----X-----------------------------------------
-----------------------[]XXX----------------?--------------------------------------------------------------------X----E--------------XXXX----------------XX-----
-----------------<>----[]XXXS-------------------------------------o-------<>-------------------------------------X----------------------------------------------
-----------------[]----<>XXX---------------------------------------oo------E----------------------------------------------------XXX---------XXXXXXXXXXX---------
------------E----[]------XXX---------XX----S--------------------------------------------------------------------------------------------------------------------
-----------------[]------XXX-------------------------------------------------------------------------------------------------------------o--o-----------------XX
-----------------[]-------XX-------------------------------------------------------------------------------------------------------------oooo----XXX------------
------------X----XX----------------------------------------------------------------------------------XXXXXXXXXX-----------XXXX----------------------------------
--------XX------------------------------XXXXXX------------------------------------------------------------------------------------------------------------------
---------------------------------------------------------------------------------------------------------------------------------------------------?------------
----------------------------------------------------------------------------------------------------------------------------------------------------------------
----------------------------------------------------------------------------------------------------------------------------------------------------------------
---E------------------------------------------------------------------------------------------------------------------------------------------------------------
XXXXXX----------------------------------------------------------------------------------------------------------------------------------------------------------