------------------------------------XXXXX<>XXXXXXXXXXXXXXXXXXXXXXX-------------------------------------X----------X-------X---XXXXXXXXXXXXX---------------------
-------------------------------------------------------------------------------------------------------X----------XXXXXXXXX-------------------------------------
----------------------------------------------------E---------------------------------------------XXXXXX--------------------------------------------------------
----------------------------------------------------------------------------------------------------------XX----------------------------------------------------
------------SSSSSSSSSSSSSS--------------------XQQ-QQX-------------XXX--XXX--------------------------------XXX---------------------------------------------------
------------SSSS------------------------------XE-E--X----------------------------------o-o-XXXX-------------------E--------------------------------Q------------
------------SSSS------------------------------X-----X----------------------------------o-o---------------------------------------------------oo----------------S
------------SSSS-------------------XX---------X-----X-----------------------------------------------------------------------E-----------------------------------
----------------------------------------------XQQ?QQX----------------oo----------------XXX-------------------------------------------------------XX-------------
------------------------------------------------------------------------------XXXXXX----------------------------------------------------------------------------
--------------E------------------------------------------------------------------------------------------------------------------------------------------XXXEXXX
-E-----------<>-------<>-------XX-------------------------------------------------------------------------------------------------------------------------------
-------------[]-------[]----------------------------------------------------XXX---------------------------------------------------------------------------------
-------------[]-------[]----------------------------------------------------------------------------------------------------------------------XXXX--------------
-------------[]-------[]----------------------------------------------------------------------------------------------------------------------------------------
XXXXXXXXXXXXXXXXXXXXXXXX--XXXX----------------------------------------------------------------------------------------------------------------------------------