--------------------------XX-XXX<>XXXXX-------------------[]----------------------------X--------------XXXXXXX--XX--X----------------------------------XXXXXXXXX
--------------------------[]------------------------------[]-------------XXXXXXXXXXXXXXXX--------------------------------------------------------------------[]-
--------------------------[]------------------------------[]-------------------------------------------------------------------------------------------------[]-
--------------------------[]------------------------------<>-------------------------------------------------------------------------------------------------[]-
--------------------XX----<>-----------------------XXXX--------------------------------------XXXXXX--XX------------------------------------------------------<>-
----XXXXX---------------------?--------------XXXX----------------------------------------------------------------------XXXX-------------------------------------
-----------------------------------------------------------------------------------------------------------------------o---------------XXX------XXX-------------
--------------------------------------------------------------------------o---------------E---------------------------------------------------------------------
-------------o----------------------------XXX------------------------------------------------------oo--XXXXXXXXXXXXXX-------------------------------------------
--------X---XXX---------------------------------------------------------------------------------------------------------SS------E-------------------------------
-----------------------------------------------------------------------------------------------------------------------------XXXXXXXX---------------------------
----------------------------------------------------------------------------------------------------------------------------------------------------------------
----------------------------------------------------------------------------------------------------------------------------------------------------------------
------------XXXX---------------------------------------------------<>---------------------------------------------------------------------o---------------------
-------------------------------------------------------------------[]---------------------------------------------------------------------X---------------------
XXX----------------------------------------------------------------[]-------------------------------------------------------------------------------------------