-------------------------------------------------------XXXXXXXXXXXXXXXXXXXXXXXXXXXXXXXXXXXXXXXXXXXXXXXXXXXXXXXXXXXXXXXXXXXXXXXXX-------XXXX---------------------
-------------------------------------------X--------------------BEE-------[]-E-----------------------------------[]---XXXXXXXXX--------[]-----------------------
-------------------------------------------o--------------------b---------<>-------------------------b-----------[]----XXXXXXXX---XXX--<>-----------------------
----------------------------------------------------------------B------------------------------------B-----------[]-----XXXXXXX---------E-----------------------
-------------------------------------------------------------------QQQ-------------------------------------------<>------XXXXXX---------------------------------
-----------------------------------------------o-o-XXX-------------------------------------Q--Q---------------------------XXXXX---------------------------------
--oooo-----------------XXXXX-------------------o-o------------------------------------------------------------------S-------------------------------------------
-XXXXX----E-----------------------------------------------------------------------------------------------------------------------------------------------------
-----------------------------------------------XXX--------------------------------------------------------------------------------------------------------------
----------------------------------XXXXXXXXX--------------------------------------------------------------------------SSS-------------------------XXX------------
--------------------------XX--------------------------------------------------------------------------------------------SS--------------------------------------
--------------------------------------------------------------------------------------------------------------------------SS????SSSSSSSSS-----------------------
----------------------------------------------------------------------------------------------------------------------------------------------------------------
------------------X---------------------------------------------------------------------------------------------------------------------------------------------
-------------XX---X-----------------------------------------------------------------------------------------------------------------------------------oXXXXXXXXX
XXXXXX-XX----X----X---------------------------------------------------------------------------------------------------------------------------------------------