----------------------------------------------XXXXX---------XXXXXXXXXXXXXXXXXXXXXXX--XXX--XXXXXXXXXXXXXXXXX]]--------]]------XXXX-------------------------------
------------------------------------------------------------XXXXXXXXXXXXXXXXXXXXXXX--XXX--XXXXXXXXXXXEXXXXX]]--------]]-----X-XXX-----X-X-E-X-X-X-X-X-X-X-X-X-X-
--------------------------------------------------------------E---------------------------SSSSSSSSS-------->X-X-X-X-X>X-X-X-X-XXXS-S--X-X-X-X?XQX-X-X-X-X-X-X-X-
----------------------------------------------------------------------------oo------------SSSSSSSSS---------X-X-X-X-X---X-X-X-X-------X-X-X-X-X-X-X-X-X-X-X-X-X-
-------------------------------------------------------------<>-------------oo------------SSSSSSSSS-------<---------[-------X-X-X-----X-E-X-X-X-X-X-X-X-X-X-X-X-
----------------------------------------------------oo-------[]---------------------------SSSSSSSSS-------[---------[-------X-X-X-----------------------B-------
-------------------------------------------------------------[]-------------------------------------------[---------[---------X-X-----------------------b-------
-----------?Q---------------oooo-------------XX-------XXX----[]-------------------------------------------[---------[---------X-X-----------------------B-------
----------------------------o--o-----------------------------[]--------------------<>---------------------[---------<-----------S-------------Q-----------------
-------------------------------------------------------------XX--------------------[]-----QQQQQQ----------[S----------------------------------------------------
-ooo-----E---------------------XXXXXXXXXXXX----------------------------------------[]---------E-----------[-----------------------------------------------------
----o---<>--S----------------------------------------------------------------------[]---------------------[-----------------------------------------------------
--------[]----------XXXXXXXX-----------------------------------------------------SSSSSSSSSSSSSSSSSSSSSSSSSS-----------------------------------------------------
--------[]---------XXX------------------------------------------------------------------------------------------------------------------------------------------
--------[]--------XXXX------------------------------------------------------------------------------------------------------------------------------------------
XXXXXXXXXXXXXXXXXXXXXX------------------------------------------------------------------------------------------------------------------------------------------