------------------------E---------------------------------------------------------------X-X-X-------------------------------------------------------------------
------------------------X---------------------------------------------------------------------------------------------------------------------------------------
---------------------Q-------------------------------------o-o------------------------X-----X-------------------------------------------------------------------
---------------------]-------------------------------------X-X------------------------X-X-X-X--------------------------------------------------------------X-X--
---------------------]-----------------------------------------------------------------------------------S------------------------------------------------------
--------------------->---------------------------o-----o--------------------------------------------------------------------------------------------------------
-------------------QQ-?-------------------------------------o----------------X-X---------------------------------------------------------------------------o-o--
--------------------[---------------------------------------X-X-----------------------E---------------------------------------------------------------------X-X-
--------------------[--------------------------------------------X-X-------o----------------------------SES----------------------------------o-o-o-o------------
--------------------<------------------------X-Xo--X-Xo--X-----------------------------------------------S-S-S---------X-X-------------------o-o-o-o------------
---ooo-------------------------------------X-X-------------X-X-X--------------X-X----------------X--------------------------------------------------------o-----
------------QQQQ?----------------------E---X-----------------------------------------------------X------X-----o----------------------------X-E-X-X-E-X-X--------
---------B-------------------------X-X->-X-X--------------------X-X---------o--------------------X-X----X-E--------------------------X-X-X-X--o-o-o-o--X--------
---------b-------------------------X-X-]-X-XX-X---X-X---X----------X-X-X------------------------XX-X---XXXSXSX-X-X-X----X----X-X-X-X-X-X-X-X--o-o-o-o--X--------
---------BEE--XXXX-----------------X-X-[-X-XXX--------------X-X-X----X-X-X----------------------XX-X-X-X-X-X-X-X-X-X-X---------X-X-X-X-X-X-X--------------------
XXXXXXXXXXXXXXXXXX----------------XX-X-<-XXXXX--------------------------------------------------XXXX---------------------------------X-X-XXXX-X-X-X-X-X---------