----------------------------------------------------------------------------------------------------------------------------------------------------------------
----------------------------------------------------------------------------------------------------------------------------------------------------------------
----------------------------------------------------------------------------------------------------------------------------------------------------------------
-----------------------------------------------------------------------------------------------------------------------------------XXXXXXXXXXXXX----------------
---------------------------SSSSSSSSSSSSSSSSSSSSSSSSSSSSSSSSSSSSSSSSSSSSSSSSSSSSSSSSSSSSSSSSSSSSSSSS-------------------------------------------------------------
---------------------------SSSS-----------------------------------------------------------------------------XXXXXEXX--------------------------------------------
---------------------------SSSS----------------------------------------------------------------------XXX---------------------E----------------------------------
---------------------------SSSS---------------------------------------------------------------------------------------------------------------------------------
-----------------------------------------------------------------------------------o-----------------------------------S----------------------------------------
----------------------oo---------------------E-----------E------------------------------------------------------------------------------------------------------
----------------------------o---------------<>----------<>------------------------S-----------------------------------------------------------------------------
------------------XXX------S?SS-------------[]---XXX----[]--------------------------------XX-----XXX-----------------------------------------------------------X
-----------------XXXX------SSS---------XXX--[]----------[]---XXX--<>----------XXXX--XX--XXXXXX--EXXX-XXX------------------------------------------X------------X
----------------XXXXX------SS-----<>--------[]----------[]--------[]--------XXXXXX--XXXXXXXXXX-XXXXX-------------------X--------------------------X-------B----X
---------------XXXXXX--------E-EE-[]--------[]----------[]--------[]--E-E-E-XXXXXXE-XXXXXXXXXXXXXXXX-------------------X------XXXX----------------X------------X
XXXXXXXXXXXXXXXXXXXX---XXXXXX-XXXXXX--------XX----------XX--------XXXXXXXXXXXXXXXXXXXXXXXXXXXXXXXXX--------------------X------XXXX----------------XXXXXXXXXXXXXX