----------------------------------------------------------------------------------------------------------------------------------------XXXXXXXXX---------------
------------------------------------------------------------------------------------------------------------------------------------------------X---------------
----------------------------------------------------------------------------------------------------------------------------------------------------------------
----------------------------------------------------------------------------------------------------------------------------------------------------------------
---------------------------------------XX------------------------------------------------------SSSSSSSSSSSSSSSSSSSSSSSSSSSSSSSSSSSS-----------------------------
----------------------------------------------------------------------------------------------------------------------------------------------------------------
--------------------SSSSSSSSSS----------------------------------------------------------------------------------------------------------------------------------
------------------------------------------------------------------------------SSSSS?SSSQSSS--------------------------------------------XX-----------------------
------------------------------------oooo----------------------------------------------------------------------------------------------------------------------XX
-------------------------E----------oooo----------------------------------------------------------------------------------------------------------------XX------
------------------------<>----------------------------------------------X------E----------------------------------S---------------------------------------------
------------------------[]--------------------------X--X------------QQQQX-----SSSSSSSSSSSSS---------------------E----E---E-------XX-----------------------------
------------------------[]--------------------------X--XX--------------------------------------------E---------<>---<>--<>--------------------------------------
------------------------[]--------------------------X--XXX------------------------------------------<>---------[]---[]--[]--------------------------------------
----------------X-XXXXXXXXXXXXX---------------------X--XXXX-------EE--------------------------------[]---------[]---[]--[]--X-----------------------------------
XXXXXXXXXXXXXXXXXXXXXXXXXXXXXXX---------------------X--XXXXXXX----XXXXXXXXXXXXXXXXXXXXXXXXXXXXXXXXXXXXXXXXXXXXXXXXXXXXXXXXXXX-----------------------------------