----------------------------------------------------------------------------------------------XXXXXXXXX--------------------------------------------X------X--XXX
---------------------------------------------------------------------------------------------------------------------------------------------------X------X-----
---------------------------------------------------------------------------------------------------------------------------------------------------X------X-----
---------------------------------------------------------------------------------------------------------------------------------------------------X------------
-----------------------------------------------------------------------------XXXXXXXXX-----------SSSSS-----------------------------------------XX--XXXX---------
-------------------------------------------------------------------------------------------------------------------------------XXXEXX---------------------------
--------------------SSS------------------------------------------------X----------------------------------E-------XXX-------------oo----------------------------
------------------------------------------------SSSSSS----------------XX--------------------------------------------------------------XX------------------S-----
---------------------------------------------------------------------XXXXX----------------------------------XXX---------------------------------ooo-------------
--------------------X-----------------------------------------------XXXX-----------------oooooo------------------------------XXX----------------ooo-------------
--------------------XEE-----------------------SS-------------------XXXXX----------------------------------------------------------------XXXX--------------------
--<>----------------XSSSSS----------------------------------------XXXXXX-----------------------------------------------XXX--------------------------------------
--[]---------------------------------------E---------------------XXXXXXX-E--------------------------------------------------------------------------------------
--[]---------------------------------------X--------------------XXXXXXXX<>--------------------------------------------------------------------------------------
--[]---------------------------------------X-------------------XXXXXXXXX[]--------------<>----------------------------------------------------------------------
XXXXXXXXXXXXXXXXXXXXXXXXXXXXXXXXXXXXXXXXX--X--XXX-----XXXXXXXXXXXXXXXXXX[]--------------[]----------------------------------------------------------------------