----------------------------------------------------------------------------------------------------------------------------------------------------------------
----------------------------------------------------------------------------------------------------------------------------------------------------------------
----------------------------------------------------------------------------------------------------------------------------------------------------------------
-----------------------------------------------SSSSSSSSSSSSSSSSSSSSSSSSSSSSSSSSSSSSSSSSSSSSSSSSSSSSSSSSSSSSSSSSSSSSSSSS-----------------------------------------
-----------------------------------------------------------------------------------------------------------------------SSSSSSSSSSSSSSSSSSSSSSSSSSSSSSSSSSSSSSSSS
-----------------------------------------------------------------------------------------------------------------------------------------------------SSSSSSSSSSS
--------------ooo------------------------------------------------------------------------------------------------------------------------------------SSSSSSSSSSS
-------------XXXXX--------------------------X--------------------------------------------------------------------------------------------------------SSSSSSSSSSS
----------------------------------------------------------------------------------------------------------------------------------------------------------------
-----------------------------------------------------------------------------------------------------------------------E-----------------------E----------------
------------------------------------------------------<>--<>--<>--<>--<>--<>--<>--<>--<>--<>--<>--<>--<>--<>--<>--<>--<>-------------------E--<>---------------?
-----------------------?QQQQ--------------------------[]--[]--[]--[]--[]--[]--[]--[]--[]--[]--[]--[]--[]--[]--[]--[]--[]------------------<>--[]-------SSSSSSSS?
-----------------------------------------------oooo---[]--[]--[]--[]--[]--[]--[]--[]--[]--[]--[]--[]--[]--[]--[]--[]--[]----<>---------XX-[]--[]-------SSSSSSS--
-----------------------B-------------<>--------oooo---[]--[]--[]--[]--[]--[]--[]--[]--[]--[]--[]--[]--[]--[]--[]--[]--[]----[]--------XXX-[]--[]-------SSSSSSS--
------------------E----b-E-----------[]--------XXXX---[]--[]--[]--[]--[]--[]--[]--[]--[]--[]--[]--[]--[]--[]--[]--[]--[]----[]------E-XXX-[]--[]--------------oo
XXXXXXXXXXXXXXXXXXXXXXXXXXXXXXXXX----[]-----X--XXXX---[]--[]--[]--[]--[]--[]--X]--[]--[]--[]--[]--[]--[]--[]--[]--[]--[]----XXXXXXXXXXXX--XX--XX--X---XXXXXXXXXX