----------------------------------------------------------------------------------------------------------------------------------------------------------------
----------------------------------------------------------------------------------------------------------------------------------------------------------------
----------------------------------------------------------------------------------------------------------------------------------------------------------------
----------------------------------------------------------------------------------------------------------------------------------------------------------------
----------------------------------------------------------------------------------------------------------------------------------------------------------------
---------------Q---XX-------------------------------------------------------------------------------------------------------------------------------------------
---------oo---------------------------------------------------------E---------------------------E-E-E-E-E-E---E-------------------------------------------------
----SSS-------------------E---XXX----------------------------SSQSSSSSS-----XX---------E--SSSSSSSSSSSSSSSSSSSS--------------------------?--------SQQS------------
-------------XX--------------XXXX--------------ooo------------------------XXX--------<>-------------------------------------------------------------------------
----------------------------XXXXX----------------------------------------XXXX--------[]-------------------------------------------------------------------------
---------------------------XXXXXX-----------------------------------E---XXXXX--------[]-------------------------------------------------------------------------
--XXXXXX-----------------<>XXXXXX-----------<>---------------SSSSS?SS--XXXXXX--------XXS-------------------------------S?S-------------S---XXX---SS---------<>--
--XX---------------------[]XXXXXX------X----[]------------------------XXXXXXX-------------E----------------------------------------<>------XX---------------[]--
--XX------XXXX----------X[]XXXXXX------X----[]-----------------------XXXXXXXX------------<>----------------------------------------[]---X-------------------[]--
--XX--------------------X[]XXXXXX------X----[]----------------------XXXXXXXXX------------[]------------------------------------E---[]E--X-------------------[]--
XXXXXX------------------XXXXXXXXXXXXXXXXXXXXXXXXXXXXXXXXXXXXXXXXXXXXXXXXXXXXXXXXXXXXXXXXXXXXXXXXXXXXXXXXXXXXXXXXXXXXXXXXXXXXXXXXXXXXXXXXX-------XXXXXXXXXXXXXXXX