----------------------------------------------------------------------------------------------------------------------------------------------------------------
----------------------------------------------------------------------------------------------------------------------------------------------------------------
----------------------------------------------------------------------------------------------------------------------------------------------------------------
--------------------------------SSSSSSSSSSSSSSSSSSSSSSSSSSSSSSSSSSSSSSSSSSSSSSSSSSSSSSSSSSSSSSSSSSSSSSSSSSSSSSSSSSSSSSSSSSSSSSSSSSSSSSSSSSSSSSSSSSSSSSSSSSSSSSSS
---------------------------X------------------------------SSSSSSSSSSSSSSSSSSSSSSSSSSSSSSSSSSSSSSSSSSSSSSSSSSSSSSSSSSSSSSSSSSSSSSSSSSSSSSSSSSSSSSSSSSSSSSSSSSSSSS
----------------------------------------------------------SSSSSSSSSSSSSSSSSSSSSSSSSSSSSSSSSSSSSSSSSSSSSSSSSSSSSSSSSSSSSSSSSSSSSSSSSSSSSSSSSSSSSSSSSSSSSSSSSSSSSS
----------------------------------------------------------SSSSSSSSSSSSSSSSSSSSSSSSSSSSSSSSSSSSSSSSSSSSSSSSSSSSSSSSSSSSSSSSSSSSSSSSSSSSSSSSSSSSSSSSSSSSSSSSSSSSSS
------------ooo----XX-------------SSSSSSS-----------------------------------------------------------------------------------------------------------------------
------------o---------------------SSSSSSS--SSSSS----------------------------------------------------------------------------------------------------------------
-----------------E----------------SSSSSSS--SSSSS----------------------------------------------------------------------------------------------------------------
---------------------------------?SSSSSSS--SSSSS?SS?S?????SSSSSSSSSS?----SSS?----SSSSSSSSSSSSSSSSSSS?----SSSSSSS?------SSS?----SSSSS?----SSSSSSSSSSSSSSSSSSSSS?-
---------------------------------------------------SSSSSSS------------------------------------------------------------------------------------------------------
---------XXX--XX-----------X-------------<>--------SSSSSSS------------<>------<>----------------------<>----------<><>------<>--------<>------------------------
-----------------------------------------[]---------------------------[]------[]----------------------[]----------[][]------[]--------[]------------------------
--------------------------------XXXXXXXXXXXXXXXXXXXX-XXXXXXXXXXXXXXXXXXXXXXXXXXXXXXXXXXXXXXXXXXXXXXXXXXXXXXXXXXXXXXXXXXXXXXXXXXXXXXXXXXXXXXXXXXXXXXXXXXXXXXXXXXX
XXXXXXXXX-----------------------XXXXXXXXXXXXXXXXXXXX-XXXXXXXXXXXXXXXXXXXXXXXXXXXXXXXXXXXXXXXXXXXXXXXXXXXXXXXXXXXXXXXXXXXXXXXXXXXXXXXXXXXXXXXXXXXXXXXXXXXXXXXXXXX