----------------------[]-----------------------------------------------------------XXXXXXXXXXXXXXXXXX------------------------------XXXX-------------------------
----------------------[]-----------------------------------------------------------[]-------------------------------------------------X-------------------------
----------------------[]-----------------------------------------------------------[]-------------------------------------------------X-------------------------
----------------------<>-----------------------------------------------------------[]-------------------------------------------------X-------------------------
-----------------------E-----------------------------------------------------------<>---------------------------------------------------------------------------
------------------------XXXX-----------------------------------------------------------------------S-------SSS--------------------------------------------------
---------------X-----------------XX------------------------------------------------------------------------------------X---XX-----------------------------------
------------XXXX---------------------------------------------------------XXX---XX---------------------------------------------------------XXXX------------------
------------XXXXXX-----------------------------------------------------------------------------------------QQ?-----------ooooooo--------------------------------
------------XXXX---------------------------------------------------------------------------------------------------------ooooooo--------------------------------
---------XX-XXXX----------------------------------------------------------------------------------------------------<>---------E--------------------------------
--------XXX-XXXX--------------<>-----------------------------------XXXXXX--XXX--------------------------------------[]--------<>-------------------QQQQQ--------
-------XXXX-XXXX-E------------[]------------------------------------------------------------------------------------[]---E----[]--------------------------------
------XXXXX-XXXX<>------------[]--------------------------XXXEXXXX--------------------------------------------------[]--<>----[]----------------B--E-----------<
-----XXXXXX-XXXX[]------------XX--------------------------X--------------------------------------------------------XXX--[]----[]-------------------------------[
XXXXXXXXXX--XXXX[]------------XX-----------XXXXXXXXXXXXXX-X--------------------------------------------------------XXX--[]----[]--------------XXXXXXXXXXXXXXXXXX