---------------------------------------------------------------------------XXXXXXXXXXXXX--XXXXXXXXXXXXXXXXXXXXXXXXX--------------------XXXXXXXXXXXXXXXXXXXXXXXXX
------------------------------------------------------------------------------------------XXXXXXXXXXXXEEXEXEXEXEXXX------------------------[]-------------------
-------------------------------------------------------------------------------------------[]----------------------------------------------[]-------------------
------------------------------------------------S------------------------------------------[]-------------------------------------?--------[]-------------------
---------------------------------------XXX-------------------------------------------------[]----------------------------------------------<>---QQQ-------------
-------------------------------------------------------------------------------------------<>-------------------------------------------------------------------
------------------E---------------------------XXXX----------SSSS-----------------------------------------------------XXXXXXXX----S------------------------------
-----SSSSSSSS---SSSSSSSS----------------------XXX------------[]-------------------------------------------------------------------------------------------------
-----------------------------XXXXX---------------------------[]----------------------------------------------------------------------------------QQ-------------
-------------------------------------------------------------[]-------------------------------------------------------------------------------------------------
------E--E-----------------oo--------------------------------[]----------------------------------------------------------------XXXXX----------------------------
-SS--SSSSSSSSS-----------------------------------------------<>-------------------------------------------------------------------------------------------------
-----------------E----------------------------------------------------------------------------------------------------------------------------------------------
---------------------------------------------XX------E--------E---------X---------------------------------------------------------------------------------------
---------------------------------------------XXXXXXX<>XXXXXXXXXXXXXXXXXXX--------------------------------------------XXXXXXXX-----------------------------------
XXXXXXXXXXXXXXXXXXXXXXX-X--------------------XXXXXXX[]XXXXXXXXXXXXXXXXXXX---------------------------------------------------------------------------------------