---------------------------------------------------------------------------------------------X-X-X-X-XXXXXXXXXXXXXX--X-XXX-----X-X-X-X-X-X-------XXXXXXXXXXXXXXX
-----------------------------------------------------------------------------------------------X-X-XEXXXXXXXXXXXXXXX---XXX-----X-X-X-X-X-X---------XXXXXXXXXXXXX
------------------------------------------------------------------------------------------------------XXXXXXXXXXXXXX----X---------------------------XXXXXXXXXXXX
--------------------------------------------------------------------------------------X-X-------------XXXXXXXXXXXXXX----X-X-X---------S-------------XXXXXXXXXXXX
------------------------------------------------SSSSSSSSSS--SSSSSSSSSSSSSSSS--------------------------XXXXXXXXXXXXXX--------------------------------XXXXXXXXXXXX
-----------------------------------------------------------------------SSSSS-----------X-X------------XXXXXXXXXXXXXX-----X-X---------S-S------------XXXXXXXXXXXX
---------------------------S----------XXXXX----------------------------SSSSS------------------X----S--XXXXXXXXXXXXXX--------------------------------XXXXXXXXXXXX
--------------------E------------------------SSS-----------------------SSSSS------------------------S-XXXXXXXXXXXXXX------S---------------S---S-S-S-XXXXXXXXXXXX
-----------------------------------------------------------------------SSSSS-----------------X-X------XXXXXXXXXXXXXX--------------------------------XXXXXXXXXXXX
---------------------------------------------S-------------------------SSSSS--------------------------XXXXXXXXXXXXXX-----S-S-----------Q---S-S-S-S--XXXXXXXXXXXX
-----------------------------SSSS-----------S-S------------------------SSSSS---------------E----------XXXXXXXXXXXXXX--------------------------------XXXXXXXXXXXX
<>-------------------------<-------------------S-------QQQ---------<>-----SS---------------------------X-X-X-X-X-X-X---------------------------------X-X-X-X-X-X
[]-------------------------[>---------------------<>--------SSS----[]-----SS---------------------------X-X-X-X-X-X-X---------------------------------X-X-X-X-X-X
[]-------------------------[]-----X---------------[]--------SSS----[]-----SS------------------------------------------------------------------------------------
[]-------------------------[XXXXXXX---------------[]--------SSS----[]-------------------------------------------------------------------------------------------
XXXXXXXXXXXXXXXXXXXXXXXXXXXXXXXXXXX---------XXXXXXXXXXXXXX--XXX--XXXXXXXXXXXXXXXXXXX----------------------------------------------------------------------------