----------------------------------------------------------------------------------------------------------------------------------------------------------------
----------------------------------------------------------------------------------------------------------------------------------------------------------------
----------------------------------------------------------------------------------------------------------------------------------------------------------------
----------------------------------------------------------------------------------------------------------------------------------------------------------------
---------------------------------------------------------------------------------------------------SSSSSSSSSSSSSSSSSSSSSSSSSSSSSSSSSSSSSSSSSSSSSSSSSSSSSSSSSSSSS
---------------------------------------------------------------------------------------------------SSSS---------------------------------------------------------
-----------------------------------------SS--------------------------------------------------------SSSS---------------------------------------------------------
--------------------------------------------------------------------------------XXXX---------------SSSS---------------------------------------------------------
---------------------------------------------------E---------------------------------------------------------------------o---------------o---o-------------o----
------------------------------XXXXXXXX--o----------------XXXXXXXXXXX--------------------------------------------------------------------------------------------
---------o------------------------------XXXX--------------------------------------------------------o-----------------------------------S---S-------------S-----
----------------------SSSS?-------------------XXXX-------------------------------------------------S?SS---------------------XX--XXXXXX----------XXXXXXXX------XX
--------------------------------------------------------------------------------------------E------SSS-----------------X--XXXXXXXXXXXXXX--XX--XXXXXXXXXXXX--XXXX
--------------------------S------------------------------------------------------------------------SS-----E------------X--XXXXXXXXXXXXXX--XX--XXXXXXXXXXXX--XXXX
--------------------------------------------------------------------------XX-------------------------E-EE-E------------XE-XXXXXXXXXXXXXXE-XXE-XXXXXXXXXXXXE-XXXX
XXXXXXX----XXXXXXXXXXXXXXXXX----------------------------------------------------------XXXXXXXXXXXXXXX-XXXXXXXXXXXXXXXXXXXXXXXXXXXXXXXXXXXXXXXXXXXXXXXXXXXXXXXXXX