--------------------------------------------XXXXX-XXXXXXXXXXXXXXXX-X---XXXXXXXXXXXXXXXX----XXXXXXXXXXXXXXXXXXXXXXXXXXXXXXXXXXXXXXXXXXX--------------------------
--------------------------------------------------------[]---XXXXX-X----BEE-------[]------------------X---------------------------------------------------------
--------------------------------------------------------<>----XXXX-X----b---------<>------------------X---------------------------------------------------------
---------------------------------XXXXXXXXXX-?------------------XXX-X----B----------E----------------------------------------------------------------------------
----------------------------------------------------------------XX-X---------SXXS--------------E?---------------------------------------XXX--XX-----------------
-------------------------------------------------------------------X----------[]-----------------------------o--------------------------------------------------
-------------------------------------------------------------------X----------[]--------------------------------------------------------------------------------
------------------------------------------------------------------------------<>--------------------------------------------------------------------------------
---------------------------------------------XXXX------------------------------E--SSSSSSSSSSS---Q---------------------------------------------------------------
---------------------------------------------oooo-------------------------------------------------------------------------------------------oo------------------
----------------------------------------------------------------------------------------------------------------------------------------------------------------
--------<>---------XXX----------------------------------------------------------------------S-------------------------------------------------------------------
--------[]------------------------------------------------------------------------------------------------------------------------------------------------------
--------[]--------------XX--------------------------------------------------------------------------------------------------------------------------------------
--------[]--------------XXXXXXXX------------------------------------------------------------------------------------------------------------------XXXXXXXXXXXXXX
XXXXXXXXXXXXXXXXXXXX----XXXXXXXX--------------------------------------------------------------------------------------------------------------------------------