------XX-XXXXXXXXXXXXXXXXXXXXXXXXXX-X-XXXXXXXXXXXXXXXXXXXXXXXXXXXXXXXXXXXXXXX--X--XX--XXXXXXX------XX--XX--XX----XX---XXXXXX-------------------XXXXXXX---XXXXXXX
------[]-------------------------------[]-----[]-----------------[]----[]--[]-----SS-------[]------[]--[]--[]----[]---XXXXXXX--------------------XXXXXX--XXXXXXX
------[]-------------------------------[]-----[]-----------------[]----[]--[]-----SS-------[]------[]--[]--[]----[]-----XXXXX--XXXXXXXXXEXX-------XXXXX---------
------[]-------------------------------<>-----[]-----------------<>----[]--<>-----SS-------[]------[]--[]--[]----[]------EXXX-X--------------------XXXX---------
------<>--------------------------------------<>-----SSS--SSS-----E----<>------------------<>------[]--[]--[]----[]-------XXX-----------------------XXX---------
-----------------------------------------------E-----SoS--SoS--------------------------------------<>--<>--<>----<>------------------oo--------------XSS----SSSS
-----------------------------------------------------S-SSSS-S---------------------------------------E---E---E-----E------------------oo-------------------------
------------------------------------------------------------------------------------------------------------------------------------------XX--------------------
------------------------------XXXXX----------SSSS------oooo-----------------------------------------------------------------------------------------------------
-------------------------------oooo----------SSSS-----------------------------------------------------------------------------XXXX--------------------------SSSS
---------------------------------------------SSSS------------------------------------------------------------------------------o------------Q-------------------
---------------------------------------------SSSSSSSSSSSSSSSSSSSSSSSSSSSSSSSSSSSSSSSSSSSSSSSSSSSSSSSSSSSSSSSSSSSSSSSSSSSSSSS------------------------------------
----------------------------------------------------------------------------------------------------------------------------------------------------------------
-X--------------------------------------------------------------------------------------------------------------------------------------------------------------
XX--------------------------------------------------------------------------------------------------------------------------------------------------------------
XX--------------------------------------------------------------------------------------------------------------------------------------------------------------