----------------------------------------------------------------------------------------------X----XXXXXXXXXXXXXXXXXXXXXXXXXXXXX--XXXXXXXXXXXXXXXXXXXX------XXXX
------------------------------------------------------------------------------------------------------------------------------------------------XXXXXXX----EXEXE
-------------------------------------------------------------------------------------------------------------------------------------------------XXXXXX--SS-----
--------------------------------------------------------------------------------------------------------------------------------------------------XXXXX---------
------------------------------------------------------------------------------------------------------S?S--SSSSSSS----------SSSSSSS-----QQQQ-------XXXX-SS------
------------------------------------------------------------------------------------------------oo-----------E---------------E--E-------------------XXX---------
-----------------------------------------------------------------------------------------------------------------------------------------------------XSS--o-----
------------------------------------------------------------SSSSSSSSSSSSS----SSSSS------------------------------------------------------------------------------
------------------------------------------------------------------------------------------------------SQS---SSSSSS----------SSSSSSS------QQQ--------------------
----------------------------------------------------------------------------------------------------------------E-----------------------------------------------
------------------------oo----------------------------X----------SSSSS------------------E-----------------------------------------------------------------------
--------------------------o------------------------SSSX--------SS----------QQQQ--QQQQQQQQQ----------------------------------------------------------------------
-------------------------------------------------------------<>-------------------------------------------------------------------------------------------------
----------------------------------------B--------------------[]-------------------------------------------------------------------------------------------------
----------------------------------------b--------------------[]----E---EE---------------------------------------------------------------------------------------
XXXXXXX-XXXXXXXXXXXXXXXXXXXXXXXXXXXXXXXXXXXXXXXXX--XXXXXXXXXXXXXXXXXXXXXXXXXXXXXXXXXX-<><>----------------------------------------------------------------------