-------------XXXXXXXXXXXXXXXXXXXXXX---------X----XXXXXXXXXXXXXXXXXXXXXXX----------------------XXXXXXXXXXXXXXXXXX[]-XXXXXXXX[]XXXXXXXXXXXXXXXXXXX---XXXXXXXXXXXXX
---------------------------XXXX---------------------------------------------------------------XXXXXXXXXXXXXXXXXX<>-XXXXXXXX<>XXXXXXXXXXXXXXXXXXXX--XXXXXXXXXXXXX
----------------------------XXX-----------------------------------------------------------------E----------------E----------E---------------XXXXX---------------
-----------------------------XX----------------------------------------------------------------------E---E----------------------------b------XXXX---------------
------------------------------X?-------------------<>--------XSSSSSSSSSX-----------------------<>-------------------------------------B-------XXX---------------
------------------Q---------------------------------E--------XEE-------X-------------XXXX------[]-----SSSSSSSSS-<>-----------------------------XSS--------------
-------------------------------------------------------------X--------------XXXXX----o---------[]---------------[]----------------------------------------------
-----------------------------------------------------------------------------------------------[]---------------[]----------------------------------------------
--------------------------------SSSSSSSSSSS-X----------------------------------------------E---[]---------------[]----------------------------------------------
-------------------------------------------------------------SSS----SSSS--------------SS-------XX---QQQ?QQQQQQ?QQQQ---------------------------------------------
----------------------------------------------------------------------------------------------------------------------------------------------------------------
---------XX-----------------------------------------------------------------------------------------------------------------------------------------------------
--------XXX-----------------------------------------------------------------------------------------------------------------------------------------------------
-------XXXX-----------------------------------------------------------------------------------------------------------------------------------------------------
------XXXXX-----------------------------------------------------------------------------------------------------------------------------------------------------
XXXXXXXXXXX-----------------------------------------------------------------------------------------------------------------------------------------------------