---------------------------------------------------------X---XXXXX-XXXX----------XXXXXXXXXXXXXXXXXXXXXXXXXX--X--XX--XXXXXXXXXXXXXXXX----------------------------
---------------------------------------------------------X---XXXX------------------E-E-----E-[]----[]--E-[]-----SS-------[]----XXXXXX---------------------------
-------------------------------------------------------XXX---XXX-----------------------------<>----[]----<>-----SS-------[]-----XXXXX-----XX--------------------
-------------------------------------------------------------XX------------------------------------[]-----------SS-------<>------XXXX---------------------------
-------------------------------------------------------------X------------------------S------------<>-----------------------------XXXXXXX----------ooo----------
----------------------------------------------------------------------------XXX--------------------------------------------------------------------XXXX---------
---------------------------------------oo------------------------------------------------------------------------------------------------------oo---------------
-----------------------------------------------------------------------XX---------------------------------------------------------------------------------------
----------------------------------------------------------------------------------------------------------------------------------------------------------------
----------------------------------------------------------------------------------------------------------------------------------------------------------------
-----------------------ooo------------------------------------------------------------------------------------------------------------------------------XXXX----
--------------X-----------------------------------------------------------SSSSSSSSSSSSSSSSSSSSSSSSSSSSSSSSSSSSSSSSSSSSSSSSSSSSSSSSS-------------XX--------------
--------------X------------------------------------------------------------------------------------------------------------------------------------XXXXXX-------
--------------XX-------------<>---------------------------------------------------------------------------------------------------------------------------------
------X-------XX-------------[]--EE--E-E------------------------------------------------------------------------------------------------------------------------
XXXXXXXXXXXXXXXXXXXXXXXXXXXXXXXXXXXXXXXXXXXXXXXXXXXX-------------------------------------------------------------------------------------------------------XXXXX