---------------------------------------------------------X-----------------XXXXXXXXXXXX-----------------------------------[]XXXXXXXXXXXXXXXXXXXXXXXXXXXXXXXXXXXX
---------------------------------------------------------X----------------------EE---[]-----------------------------------[]---XXXX---------------------------[]
---------------------------------------------------------XXXXXXXXXXXX----------------[]-----------------------------------[]---XXX----------------------------[]
-------------------------------------------------------------------------------------<>-----------------------------------<>---XX-----------------------------<>
-----------------------oo-----------------------XXXXXXX----E-------------------S-----------------------------------------------X-------------------------------E
---------------------------------------XXXX----------------oooo-------------------------------------------------------------------------------------------------
------------Eooo----------XXXXXXXXXXX--o-------------------oooo-------------------------------------------------------------------------------------------------
------------XXXXX---------------------------------------------------XX-----oo-----------------------------------------------------------------------------------
-------------------------------------------------------------------------------SSSS---------------------------XX------------------------------------------------
----------------------------------------SS--XX----------------------------------------------------XXXX----------------------------------------------------------
---------------------XXXXX--------------------------------------------Q----------------------------------XXX----------------------------------------------------
-------XXXXXXXXXXX--------------------------------------------------------------------------------------------------------------------------------------SSSSSSSS
----------------------------------------------------------------------------------------------------------------------------------------------------------------
-------------------o--------------------------------------------------------------------------X-----------------------------------------------------------------
------------------XXX-------------------------------------------------------------------------X-----------------------------------------------------------------
XXXXXXXX--------------------------------------------------------------------------------------X-----------------------------------------------------------------