--------------------------------------XXXXXXXXXXX-----------------<]------------------------------------------------------------------------------XXXXXXXXXXXXXX
--------------------------------------XXXXXXXXXX------------------[]------------------------------------------------------------------------------XXXXXX---XXXXX
--------------------------------------[]--------------------------[]-------------------------------------------------------------------------------XXXXX----XXXX
--------------------------------------[]--------------------------<>--------------------------------------------------------------------------------XXXX-----XXX
--------------------------------------[]-------------------------------------------------------------------------------------------------------------XXX------XX
--------------------------------------[]--------------------------------------------------------------------------------------------------------------XX-------X
--------------------------------------<>---------------------------------------------------------------------------------------ooo---------------------X--------
-----------XXXXXXXXXXXXXXXXXXXXXXX-----E--------------XXX----------------------------------------------------------------------ooo------oo----------------------
----------------------------------------------------------------------------------------------ooooo-------------------------------------------------------------
------------------------------------------------------o-o-------------------------------------------------------------------------------------------------------
------------------------------------------------------o-o-XXXXX----------------XXXX------XXX--------------E-----------------------------------------------------
-------------------------------------------------------------------------------------------------------------------<>---------XX--XXXXXX--XXXX------------------
-------------------------------------------------------------------------------------------------------------<>----[]-------------X-----------------------------
-------------------------------------------------------------------------------------------------------------[]----[]-------------X-----------------------------
------------------------------------------------------------------------XXXXX---------XX---------------------[]-E--[]-------------X-----------------------------
XXXXXXXXXXXXXXX--XX--XX--XX--XX--X------------------------------------------------------------XXXXXXXXXXXXXXXXXXXXXXXXXXXXXX------X-----------------------------