--------------------------------------------------------------XX-XXXXXXXXXXXXXXXXXXXXXXXXXXXXXXXXXXXXXX----X---------------------------------------------------X
--------------------------------------------------------------[]-------[]--XXXXXXXXXXXXXXXXXXXXXXXXXXXX----X----------------------------------------------------
--------------------------------------------------------------[]-------[]---------XXXXXXXXXX-[]------------XXXXXXXX---------------------------------------------
--------------------------------------------------------------[]-------<>----------XXXXXXXXX-[]-----------------------------------------------------------------
--------------------------------------------------------------<>--------------------XXXXXXXX-[]--------------E------XXX-----------------------------------------
-------------------------------------------------------------------------------------XXXXXXX-<>-------E------ooooo----------------------------------------------
-------------------------oo-----------------------------------------------------------EXXXXX--E--------------ooooo--------XXX-----------------------------------
--S--SSQSSS-----------------------------SSSSSSSSSSSS--SSS------------------------------EXXXX-------------------------------------------------------XXX----------
----------------------------------------------------------------------------------------XEXX------------------------------------------E-------------------------
---------------------------------------E-------------------------------------------------XXX--------------------------------------------------------------------
------------------------------------------------------------------------------------------------------------------------------XXXXXXXXXXXXXXXXX-----------------
-SS--SSSSSSS--<>------------------E--S?S-------------XXXXX------------------------------------------------------------------------------------------------------
--------------[]-----------------<>---------------E--X----------------------------------------------------------------------------------------------------------
--------------[]-------------------------------------X----------------------------------------------------------------------------------------------------------
--------------[]-----E-E-E-------------------X-------X----------------------------------------------------------------------------------------------------------
XXXXXXXXXXXXXXXXXXXXXXXXXXXXXXXXXXXXXXXXXX---XXXXXXXXXXX--------------------------------------------------------------------------------------------------------