---------------------------------XXXXXXXXXXX---------XXXXXXXXXXXXXXXXXXXXXXXXXXXXXXXXXXXXXXXX<>XXXXXXX-XXXXXXXXXXXXXXXXXXXX-------------------------------------
-------------------------------------------------------------[]------XXXX-------------------------[]----------------------X-------------------------------------
-------------------------------------------------------------[]------XXX-------------b------------<>------------------------------------------------------------
-------------------------------------------------------------[]------XX------------?-B--------------------------------------------------------------------------
------------------------------o--------------------XX--------<>------X------------------b-------------------------SSSSSS----------------------------------------
-----------------------S------o---------------------------------------------------------B--------------------------E---------------Q----------------------------
----------------------------------------------------------------------------------------------------------------------------------------------------------------
-----------------------------XX---------------------------------oo-----------------------------------------------------------------------------------XXX--------
----------------------------------------XX---XXXXoo--XXX----------------------------------------------------------SSSSSS---------XX-----------------------------
----------------------------------------------------------------------------------------------------------------------E-----------------------------------------
------------<>------------X-------------------------------------------------------------------------------------------------------------------------------------
------------[]---ooo---------------------------------------------------------------------------------------------------------XXX-------XXX----------------------
------------[]-------------------------------------------------------------------------------------------------------------------------XX-----------------------
------------[]------------------------------------------------------------------------------------------------------------------XX------------------------------
------------[]--------------------------------------------------------------------------------------------------------------------------------------------------
XXXXXXXXXXXXXXXXXXXX------------------------------------------------------------------------------------------------------------------------------------XXXXXXXX