---------------------------------XXXXXXXXXXX-------X-------------------X------------X--XX-------XXX-----X----XXXXXXXXXXXXX--[]---------------------------------X
---------------------------------[]------------------------------------X------------X--XX-------X---------------------------[]----------------------------------
---------------------------------[]----------------------------------XXXXXXXXXEX----X--[]-----------------------------------[]----------------------------------
---------------------------------[]----------------------------------------------------[]-----------------------------------<>----------------------------------
---------------------------------[]--------------------------------------E-------------<>------------------XXX---------------E----------------------------------
---------------------------------<>--------------------------------------oooo-------------------------------------------------XXXXXXXX--------------------------
-------------------------------------------------------------------------oooo------------------------------X----------------------------------------------------
------------------------------------------------------------------------------------S-------------------------------------------------Q-------------------------
-----------------------------------------------------XXX---XXXXXXX---------------------------SSSSSSSSSS-X-----------------------------------oo------------------
---------------------------------------------XX------------------------------------------------------------o----------------------------------------------------
-------------B--------------------------------------------------------------------------------------------------------------------------------------------------
-------------b--------------------------------------------------------------------------------------------------------------------------------------------------
------E---B-----------------------------------------------------------------------------------------------------------------------------------------------------
----------b-----------------------------------------------------------------------------------------------------------------------------------------------XXX---
------------------------------------------------------------------------------------------------------------------------------------------------------------X---
XXXXXXXXXXXXXXXXXXXXXXXXXXXX----------------------------------------------------------------------------------------------------------------XXXXXXXXXXX-----X---