---------------------------------------------------------------------------------------------------XXXXXXXXXXXXXXXXXXXXXXXXXXXXX---------------------------XXXXX
---------------------------------------XXX--------------------------------------XXXXX------------------------------E---XXXXXXXXX---------------------------X-X-X
----------------------------------------o-------------------------------------------------------------------------------XXXXXXXX---------------------------X-X-X
----------------ooo------------------------------------------------------------------------------------------------------XXXXXXX--------------------------------
----------------o-o---oo---------XXXXXX--------------------------E------------------------------o----------------?SSSSSS--XXXXXX----------------------------Q-QE
------------------------------------------XXXXX--------------XX----XXXXXEEXXXXXXX---------------o--------------------------XXXXX-------------------oo-----------
-----SS---------XXX--XXXX---------------------------------------------------------------------------------------------------XXXX---------X---------oo--------Q-Q
-----------XX----------------------------------------------------------------------------------XX--ooo-----------------------XXX--------------------------------
-----------------------------XX----XXX-------------------------------------------------------------------------SSSSSSSSSS-----XX--------------------------------
----o----------------------------o-oo----------XX---------------------XXXEXXXXX----------------------------------oooo--E-----------------E----------------------
----XXXX----------------------------------------------------------------------------------------------------------------------------------------------?---------
--------------------------------------------oo----------------------------E-------------------------------------------------------------------------------------
---------------------X------------------------------------------------------------------------------------------------------------------------------------------
----------------------------------------------------------------------------------------------------------------------------------------------------------------
----------------------XXXXX-----------------------------------------------------------------------------------------------------------------XXXXX---------------
XX--------------------------------------------------------------------------------------------------------------------------------------------------------------