------------------------------------------------------------------X--------XX---X----XXXXXXXXXXXXXXXXXXXXXX---------------------------------------------------[-
------------------------------------------------------------------X--------XX-XXX----E--[]--------------------------------------------------------------------XX
---------------------------------------------------------------XXXX--------[]-----------[]---------------S-------------------------------------------------XX---
-------------------------------------XXX-----------------------------------[]-----------[]----------------------------------------------------------------------
----------------------------------------------------------------------?----[]-----------<>---SSSSSSSSSSSS?------------------------------------------------------
-----------------------------------------------------Q---------------------[]------------------------E--------------------------------------------------------E-
---------------------------------------XXXX-----E--------------------------[]-----------------------------------------------------------------------------------
--------------E-----------<>------------------------------------------XX---[]-----E-----------------------------X-----------------------------------------------
--------------------------[]----------------------XXX----------------------[]-----------------------------------[-----------------------------------------------
--------------------------[]-------------------------------XXXE------------<>---------------------SSSS----------[>------------------------------------XXXXE-----
----------SSSS-----------S[]--------------XX--------------------------------E-----------------------------------[]----------------------------------------------
--------------------------[]-----------------XX---------XX------------------------------------------------------[]X--S?S---------------<>---------X-------------
----B---------------------[]------------------------------------------------------------------------------------<>X--------------------[]--------XXX------------
----b--------------------B[]-----------------------------------------------------------------------------------------------------<>----[]-------XXXX------------
-----------------XXEXXXXXXXXXXXXXXXX---------------------------------------------------------------------------X-----------------[]BE--[]------XXXX-------------
XXXXXXXXXXXXXX---XXXXXXXXXXXXXXXXXXX---------------------------------------------------------------------------XXXXXXXXXXXXXXXXXXXXXXXXXXXXXXXXXXXX-------------