----------------------------------------------------------------------------------------------------------------------------------------------------------------
----------------------------------------------------------------------------------------------------------------------------------------------------------------
----------------------------------------------------------------------------------------------------------------------------------------------------------------
----------------------------------------------------------------------------------------------------------------------------------------------------------------
----------------------------------------------------------------------------------------------------------------------------------------------------------------
----------------------------------------------------------------------------------------------------------------------------------------------------------------
----------------------------------------------------------------------------------------------------------------------------------------------Q-?-Q-------------
---------------------XX---------------------------------------------------------------------XXX------------------------------SSSSSSSSSSS-----------------ooo----
--------------------XXX--------------------------------------------------------------------XXXX-----------------------------------------------------E----ooo----
--o----------------XXXX-------------------------------------------------------------------XXXXX-----------------------------------------------------------------
---E--------------XXXXX---------X--------------------------------------------------------XXXXXX-----------------------------------------------E------XXXXX------
SSSSS------------XXXXXXS--SSSSSSX---------------<>--------------------------------------XXXXXXXS--SSSSS-----------XXXXXX-------------------XXXEXXXXXXX----------
E---------------XXXXXXX-------------------------[]-------------------------------------XXXXXXXX------------------XXX-------E--------E---------------------------
----E----------XXXXXXXX-------------------------[]------------------------------------XXXXXXXXX-----------------XXX-------<>------------------------------------
--------------XXXXXXXXX------------------E------[]----------------XXXEEXEXEXEXEXEXXXXXXXXXXXXXX----------------XXXX-------[]-------------------------------XXXXX
XXXXXXXXXXXXXXXXXXXXXXXXX--XXXXXXXXXXXXXXXXXXXXXXXXXXXXXXXXXXXXXXXXXXXXXXXXXXXXXXXXXXXXXXXXXXXXXX--XXXXXXXXXXXXXXXX-------XXXXXXXXXXXXXXXXXX--------------------