----------------------------------------------------------------------[]------------------------------XXXXXXXXXXXXXXXXXXXX-X------------------------------------
----------------------------------------------------------------------[]------------------------------XX---[]E--[]----------------------------------------------
----------------------------------------------------------------------[]------------------------------XX---[]---<>----------------------------------------------
----------------------------------------------------------------------<>------------------------------XX---<>---------------------------------------------------
--------------oo-------------------------------------------------------E------------------------------XX-------------XXX----------------------------------------
------------------------------------------------------------------------XXXXX-------------------------XX-------------[]-----------------------------------------
-------------------------------------------------E-E-------?--------------------XXX-------------------XX-------------<>-----------------------------------E-----
--------------XXX------XXXX---------------------<><>-------E---------------------------------?SS------XX----------------------------------------------SSS-------
---------E--------------------------------------[][]----------E---------------------------------------XX--------------------------------------------------------
--------<>--------------------------------------QQQQ---------<>-------------------------------------------------------------------------------------------------
--------[]---------------------------------------------------[]----------------------------E--------------------------------------------------------------------
--------XX-------XXXX----------------------XXX---------------[]---------------------------<>---------------------------------------------------------X----------
-------------------------------------------XX----------------[]---------------------------[]--B---------------------------------------<>-------------X----------
-<>--------B--------------------------<>---------------------[]---------------------------[]--b---------------------------------X-----[]-------<>----X----------
-[]-----------------------------------[]--------XXXXXXXXXXXXXXX---------------------------[]------------------------------------XX----[]E------[]-E--X---------X
XXXXX--XXXXXXX------------------------[]--------XXXXXXXXXXXXXXX-----------------------XXXXXXXXXXXXXX----------------------------XXXXXXXXXXXX---XXXXXXXXXXXXXXXXX