----------------------------------------------------------------------------------------------------------------------------------------------------------------
----------------------------------------------------------------------------------------------------------------------------------------------------------------
----------------------------------------------------------------------------------------------------------------------------------------------------------------
----------------------------------------------------------------------------------------------------------------------------------------------------------------
---------------------------------------------------------------------------------------------------E------------------------------------------------------------
----------------------------------------------------------------------------------------------------------------------------------------------------------------
-----ooo--------------------------------Q-?-Q----------XXX-----------------------------XXXXXXXXXXXEXXX----------------------------------------------------------
-----ooo-----------------------------------------------------------------------------------------------------------SS----?SSS---------S---S---------------------
----------------------------------------------E-----E-----------------------------------------------------------------------------------------------------------
----------------------------------------------------------------------------------------------------------------------------------------------------------------
-------------------------XXX------------E------XXXXXXXXXXX---E-------------XXXXXEXXXXXXXXEXEXEXEXEEXXXXX--S-------------------<>--------------------------------
----XX--XXXXXXXXXXXXXXX--------------XXXEXXXXXXX---------------------------------------------------------------------------E--[]----QQQQQQQQQQQQ?---------------
--------X--------------------------------------------------------------------------------------------------------E----E---<>--[]--------------------------------
--------X-------------------------------------------------------------------------------------------------------<>--------[]--[]--------------------------------
--------X----------------------------------------------------XXXXXXXXXXXXXX----------------------------XXXXXE---[]--------[]--[]--------------XXXXXXXXXXXXXXXXXX
XX------X---------------------XXXXX--------------------------X--------------------------------------------------XXXXXXXXXXXXXXXXXXXXXXXXXXXXXXXXXXXXXXXXXXXXXXXX