----------------------------------XXXXXXXXXXXXXXXXXXXXXXXXXXXXXXXXXXXXXXXXXXX----XXXXXXXXXXXXXXXXXXXXXXXXXXXXXXXXXXXXX--XXXXXXXXX-------------------------------
----------------------------------XXEXXXXXXXXXXXXXXXXXXXXXXXXXXXXXXXXXXXXXXXX----[]--------------XXXXXXXXX------------------------------------------------------
---------------------------------------------------------------------------------[]---------------XXXXXXXX------------------------------------------------------
---------------------------------------------------------------------------------[]----------------XXXXXXX------------------------------------------------------
------------------XXXXXXXX-------------------------------------------------------<>-----------------XXXXXX---SSS--SSSSSSS-------------XXXX-----XX--XX-----------
----------------------------------------------------------------------------E------------------------XXXXX---------E--E-----------------------------------------
------------------------------------------------------------------------------------------------------XXXX------------------------------------------------------
--SSS--XXoo--------------------------------------------------------------------------------------------XXX----------------------------------------------------E-
----------------E-----------XXX-------------------------------------------------------------------------XX----SS--SSSSSSS-------------------XX--oooo---------<>-
------------------------------------------------------------------------------------------------------------------------------------------------oooo---------[]-
-------------------------------------------------------------------------------------------------------------------------------------------------------------[]-
-XXXXX-----XX-----------------------------------------------------------------------------------------------------------------SSSSSSSSSSSS------------------SXXS
-X--------------------------------------------------------------------------------------------------------------------------------------------------------------
-X--------------------------------------------------------------------------------------------------------------------------------------------------------------
-X--------------------------------------------------------------------------------------------------------------------------------------------------------------
XXXX------------------------------------------------------------------------------------------------------------------------------------------------------XXXXXX