-------------------------------------------------------------------------------------------------------------------XXXXXX-XXXXXXXXXXXXXXXXXXXXXXXXXXXXXXXXXXXXXX
-------------------------------------------------------------------------------------------------------------------------------------------------X--------------
-------------------------------------------------------------------------------------------------------------------------------------------------X--------------
---------------------------------------------------------------------------------------------------------------------------------------------E------------------
----------------------------------------------------------------------------------------------------------------------o-----------------------------------------
-----------------------------------------------------------------------------------------------------------------------oooo-------------------------------------
-----------------------------------------------------------------------------o-ooo------------------------------------------------------------------------------
--SSSS--------------------SS-------------------------------XXXXXXXXXXXXXXXXX------------------------------------------------------------------------------------
---------------------------------------------------------------------------------------------------------E------------------------------------------------------
--------------------------------------o-----------------------------------------XX------------------------------------------------------------------------------
----------------------------------------------------------------------------------------------------------------------------------------------------------------
--S----------------------XXXX--SSSSSSS--------------------------------------------------------------------------------------------------------------------------
----------------------XXXXX-------------------------------------------------------------------------------------------------------------------------------------
-------------------XXXXXX----------------------------------------------------------XXXEXXEXXXXXX--------------<>------------------------------------------------
---EE-------------XXXXX------------------------------------------------------------------------X--XXXXXX------[]------------------------------------------------
XXXXXXXXXXXXXXXXXXXXX------XX--XXXXXXXXXXXXXXXXXXXXXXXX-XXXXXXX--XX--XX--XX--XXXX--------------X-------X------[]------------------------------------------------