----------------------------------------------------------------------------------------------------------------------------------------------------------------
----------------------------------------------------------------------------------------------------------------------------------------------------------------
----------------------------------------------------------------------------------------------------------------------------------------------------------------
----------------------------------------------------------------------------------------------------------------------------------------------------------------
------SSSSSSSSSSSSSSSSSSSSSSSSSSSSSSSSSSSSSS--------------SSSSSSSSS---------------------------------------------------------------------------------------------
------SSSS------------------------------------------------------------------------------------------------------------------------------------------------------
------SSSS------------------------------------XXXXXXX--------------SSSSSSSSS------------------------oooo--------------------------------------------E-----------
------SSSS---------------------------------------------SSS------------------------------------------XXXX-----------------------------------------SS-------------
----------------------------------------------------------------------------------------------------------------------------------------------------------------
---------------------------E---------------------------S-----------E-----E--------------------------------------------------------------------------------------
--------E--------------E--<>--------------------------S-S---------<>----<>--------------------------------------------------------------------------------------
-------<>---<>--------<>--[]-------------QQQ-------------S--------[]----[]--------------------------------------------------E--S-------------<>---------------<>
-------[]---[]-----XX-[]--[]---XXX--------------------------------[]----[]----------------------XXX?--------------<>-------<>----------------[]---------------[]
-------[]---[]----XXX-[]--[]----------------------------------<>--[]----[]-----------E-----E----------------------[]-----------------<>------[]---------------[]
-------[]---[]---XXXX-[]--[]--------------------------------E-[]--XXXXXXXXXXXXXXXXXX<>XXXX<>----------------------[]-----------------[]------[]---------------[]
XXXXXXXXXXXXXXXXXXXX--XX--XX---------XXXXXXX----------XXXXXXXXXX--XXXXXXXXXXXXXXXXXX[]XXXX[]-------XXXXX-XXXXXX--XXXXX<>XXXXXXXXXXXXXXXXXXXXXXXXXXXXXXXXX--XXXXX