------------------------------------X---------------X---------------------------------------------------------------------XXXXXXXXXXXXXXXXX---------------------
------------------------------------X---------------X-----------------------------------------------------------------------------------------------------------
------------------------------------X---------------X-------------------------------------------------------------------------<>--------------------------------
-------------------------------------------XXXXXXXXXX--------------------------------------------------------------------------E--------------------------------
---------------------------XX------------------------------------------------------------------------------------------XXX--------------QQQ---------------------
----------------------------------------------------------------------------------------------------------------------------------------------------------------
-------------------------------------------------------XXXX-----XXXXXXXXXXXXX--------oo-------------------------------------------------------------------------
------------------------------------S--XX------------------------------------------------------------------------------------------------------E----------------
---------------------------------------------------------------------------------------------------------------------------------------------SSSSS--------------
--------------------------oo-----------------------------------------------------------------------------------------------------------------S------------------
---------------ooooo----------------------------------------------------------S--------------------------------------------------------------S-E----------------
--<>--------------------------------------------------------------------------------------------S-------------------------------------SSSSS--SSSSS---X----------
--[]----------------------------------------------------------------------------<>-------------------------E--------------------------------------EE-X----------
--[]-------------------X--------------------------------------------------------[]------------------------------------------------------------SSSSSSSX----------
--[]------------------XX--------------------------------------------------------[]-E-E--------------------------------------------------------------------------
XXXXXXXXXXXXXXXXXX-XXXXX------------------------------------------------------XXXXXXXXXXXXXXXXXXXXXXXXXXXXXXXXXXXX----------------------------XXXXXXXXXXXXXXXXXX