------------------------------------------------------------------[]---------XXXXXXXXXXXXXXXXXXXXXXXXXXXXXXXXX--XXXXXXXXXXXXXXXXXXXXXXXXXXXXXXXXXXXXXXXX---X-X--
------------------------------------------------------------------[]---------[]-------------------------b-E--------[]--------------------------------XXXXX------
------------------------------------------------------------------<>---------[]-------------------------B----------[]--b------------------------------XXXXXX----
-----------------------------------------------------------------------------<>------------------------------------[]--B-------E-------------------------XXX----
----oo--------------------------------------------------------------------------------------------------?QQQQQ-----<>----------------------Q-QQQQQQ-------------
-----------------------------------------------------------------------XXXX-----------------------------------------E------------------EQ-----------------------
------------------------------------E----E----------------------------------------------------------------------------------------------------------------------
----XXX---------------------------SSSSSSSSSSS-------------------------------------------------------------------------------------------------------------------
----------------------------------------------------------------------------------------------------------------------?SSSSSSS-------------Q-QQQQQQ-------------
---------------------------------E------------------------------------------------------------------------------------------------------------------------------
-----------------------------------------E--------X-------------------------------------------------------------------------------------------------------------
-------XXXXXXXX-------------E--S?S-------QQ?QQQQQQX-------------------------------------------------------------------------------------------------------------
---------------------------<>-----------------------------------------------------------------------------------------------------------------------------------
----------------------------------------------------------------------------------------------------------------------------------------------------------------
----------------------------------------------------------E-----------------------------------------------------------------------------------------------------
XXXX-----------XXXXXXXXXXXXXXXXXXXXXXXXXXXXXXXXXXXXXXXXXX--XXXXX------------------------------------------------------------------------------------------------