----------------------------------------------------------------------------------------------------------------------------------------------------------------
----------------------------------------------------------------------------------------------------------------------------------------------------------------
----------------------------------------------------------------------------------------------------------------------------------------------------------------
----------------------------------------------------------------------------------------------------------------------------------------------------------------
------------------------------------------------------------------------------------------------------------------------------------XX--------------------------
----------------------------------------------------------------------------------------------------------------------------o-----------------------------------
---------------------------------------------------------------------------------------------XXXXX-------------------------XXX-----------oo------------XX-------
----------------------------------SS-----------------XX----------------SS---S--------------------------------------------------o---------------XXXX-------------
----------------------------------------------------XXX--------------------------------------------------------XXX--o---o------XXXoo----------------------------
------------------------X--------------------------XXXX------------------------------------------------------------XXX-XXX--------------------------------------
--------------------------------------------------XXXXX-------------------------------XSS----XXXXXXX------------------------------------------------------S-----
------------XXXXXXXXX------------XXXX--SSS-------XXXXXX---<>----------SSS--SS--------XXX--------------------------------------------------XXX-----------------XX
-----------XXX----------------XXXXX-------------XXXXXXX---[]------------------------XXXX------------------------------------------------------------------------
----------XXX---------------XXXXX--------------XXXXXXXX---[]-----------------------XXXXX------------------------------------------------------------------------
---------XXXX---------------X-X---------------XXXXXXXXX---[]----------------------XXXXXX-----------XXXXXXXXXX---------------------------------------------------
XXXXXXXXXXXXX---------------XX-----XX--XXXXXXXXXXXXXXXXXXXXXXXXXX---XXXXXXXXXXXXXXXXXXX----------------------------XXXXXXXXXXXX---------------------------XX----