----------------------------------------------------------------------------------------------------------------------------------------------------------------
----------------------------------------------------------------------------------------------------------------------------------------------------------------
----------------------------------------------------------------------------------------------------------------------------------------------------------------
--------------------------------SSSSSSSSS-----------------------------------------------------------------------------------------------------------------------
----------------------------------------------------------------------------------------------------------------------------------------------------------------
----------------------------------------------------------------------------------------------XXX---------------------------------------------------------------
-----ooo--------------------------------------o-o------------------------------XXE-------------------------------------------------------------XX---------------
----------------------------------SSSSSSSS-X----------------------------------------------------------oo--XXXXXXX--------?SSS---?-------------------------------
----------------------------------SSSSSSS-----------XX----------------------------------------------------------------------------------------------------------
------XX--------------------------SSSSSS------------------------------------------------------------------------------------------------------------------XXXXXX
---------------------------------?SSSSS--------------------------------------------------------------------------------E----------------------------------------
-------------------E-----E--------------------XXX-----------------------XXXX------------------------XX--XX------------<>---E-------------------------E----------
-----------------------------------------------------------------------XXX--------------------------------------------[]--<>--E------------X--------<>----------
---------XX--XXXXXXXXXXXXXXX------------------------------------------XXX---------XXXXXXXX----------------------------[]--[]---------------X--------[]----------
--------------------------------XXXXXXXXX----------------------------XXXX---------------------------------------------[]--[]---------------X-------X[]X---------
XXX-XXX-------------------------XXXXXXXXX--X---------XXXXXXXXXXXXXXXXXXXX---------------------------------XXXXX--XXXXXXXXXXXXXXXXXXXXXXXXXXX--------------------