---------------------------------------------------------------------------------------------------------------------------------------------------------------X
----------------------------------------------------------------------------------------------------------------------------------------------------------------
----------------------------------------------------------------------------------------------------------------------------------------------------------------
----------------------------------------------------------------------------------------------------------------------------------------------------------------
------------------------------------------------------------------------XX--------------------------------------------------------------------------------------
---------------------------------------------------------o-----------XX-------------------------------------------------XX--------------------------------------
------------------------------------------------------------------------------------------------------------------------XX--------------------------------------
-----------------SSSSSSS-------------------------------SSS------------------------------------QQ?-----------------------XX-----------------------QQQ------------
--------------------------------------------------------------------oo--------------------------------------------------XX--------------------------------------
------------------------------------------------------------------------------------------------------------------------XX--------------------------------------
------------------E--E------------------------------------------------------------------------SSS-----------------------XX--------------------------------------
-SS-------------SSSSSSSS---------------------------<>---S---------------------------------------------------------------XX------------------<>--E?QQ-----------Q
----------------------------------E-------E--------[]-----------<>---------------------------------------------------E--XX----------<>------[]------------------
---------------------------------<>----------------[]-----------[]------------X------------------------X----------------XX----------[]------[]------------------
---------------------------------------------------[]----E------[]------------X------E-----------------X----------------XX----------[]------[]------------------
XXXXXXXXXXXXXXXXXXXXX--XXXXXXXXXXXXXXXXXXXXXXXXXXXXXXXXXXXXXXXXXXX------------XXXXXXXXXX-----------XXXXXXXXXXXXXXXXXXXXXXXXXXXXXXXXXXXXXXXXXXXXXXXXXXXX-XXXXX---