--------------------------------------------------------------------------------------------------------X-------------------------------------XXX---------------
--------------------------------------------------------------------------------------------------------X-------------------------------------XXX---------------
--------------------------------------------------------------------------------------------------------X--------------------------------------[]---------------
-----------------------------------------------------------------------------------------------------XXXX--------------------------------------[]---------------
----------------XXXX---------------------------------------------XXXXXXX-----------------------------------------------------------------------[]---------------
-----------------------------------------------------------------------------------------------------------X-------------------X---------------<>---------------
-----------------------------------------XXXXEX-----------------------------------------------------E-----------------------------------------------------------
----ooo----XX-------------------SSS---------------XXX-----------------------------------------------------------------E-----------------E-----------------------
----------------------XXX-------------------------------------------------XX-------------XXX--------------------------------------------------------------------
---------E----------------------------------------o-o--------------------------------oo-----------------------XXXXXX------------------------------XXXXXXXXXXXX--
--------------------------------------------------o-o-XXXXXXXX----------------XXXXXXXEXX-------------------------------------------XX---------------------------
XXXX---------------------------XXXXX-------------------------------------------------------------XX---------------------XXXX------------------------------------
------XX-----------------------X--------------------------------------------------------------------------------------------------------------------------------
-------------------------------X--------o-----------------------------------------------------------------------------------------------------------------------
----------------------------E--X--------X----------------------------------------------------------------------------ooo----------------------------------------
-----------------------XXXXXXXXXXX-----------------------------------------------------------------------------------XXX----------------------------------------