-------------------------[]----[]------------XXXXXXXXXXXXXXXXXXXXX-XX-XXXXXXXXXXXXXXXXXXXXXXXXXXXXXXXXXXXXXXXXXXXXX---------------XXXXXXXXXXXXXXXXXXXXXXXXXXXXXX
-------------------------[]----[]--XXXXXXXX--XXXXXXXXXXXXXXXXXXXXX-XX-XXXXXXXXXXXXXXXXXXXXXXXXXXXXXXXXXXXXXXXXXXXXX-------------------------------[]----E---EE--
-------------------------<>----[]-------------------[]-------------------------------------[]----------[]-----------------------------------------[]------------
--------------------------E----[]-------------------<>----------SSSSSSSSSSSSSSS------------<>----------<>-----------------------------------------<>------------
-------------------------------<>-------------------------------SSSSSSSSSSSSSSS---------------------------------<>-----------XXXX-------------------SS----------
-----------XXXXXX---------------E-------------?SSSSS--SSSSSSS?SS?SSSSS?????????SSSSSSSSSS?----SSSSSSS?----SSS---[]------------------------------------SSSSS-----
-----------o--------------ooooooo--------------SSSSS--SSSSSSS-----------------------------------------------E---[]----------------------------------------------
--------------------------ooooooo---o----------SSSSS--SSSSSSS---------------------------------------------------[]----------------------------------------------
-----------------------------------------------SSSSS------------------------------------------------------------[]------------------------------SSSSSSSSSSSSSSS-
------------SS--XXXXXX--X---XX-------------------------------------------------SSSSSSSSSSSSSSSSSSSSSSSSSSSSSS---[]----------------------------------------------
-------------------------------------------------------------------------------SSSSSSSSSSSSSSSSSSSSSSSSSSSSSS---[]----------------------------------------------
----QQQ------------------------------------------------------------------------SSSSSSSSSSSSSSSSSSSSSSSSSSSSSS---[]----------------------------------------------
---------------------------------------------SSSSSSSSSSSSSSSSSSSSSSSSSSSSSSSSSSSSSSSSSSSSSSSSSSSSSSSSSSSSSSSSSSSSS----------------------------------------------
----------------------------------------------------------------------------------------------------------------------------------------------------------------
------X---------------------------------------------------------------------------------------------------------------------------------------------------------
XXXXXXX---------------------------------------------------------------------------------------------------------------------------------------------------------