-------------------XXXXXXXXXXXXXXXXXXXXXXXXXXXXXXXXXXXXXXX---XX-------------------------------------------------------------------------------------------------
---------------------[]----------------------[]-----------------------------------------------------------------------------------------------------------------
---------------------[]----------------------[]-----------------------------------------------------------------------------------------------------------------
---------------------[]--------------E-------[]--------E---------------------------------------------------------XXXXXXXXXXX------------------------------------
---------------------<>----------------------<>---S------S---------------------------------------------------------------------XXX-----------------------------S
----------------------------------------------------------------------------------------XX-------------------------------------XX-------------------------------
-----------------------------------------------------------------------------------------------------------------------------------------------E---oo-----E-----
------------------------oooo-------------------------------------------------------------------------------------------------------------------S----------------
-----E------------------------------------------------------------oo--------------------------------XX------------------------------------------------------XX--
----<>-----------------------------------------------------------------------------XXXX-----XX-------------------------------------------------?----X-----------
----[]----------Q-----------------------------------------------------------------------------------------------------------------------------------------------
----XX--------------------------------------------------------------------XXXXXXXX--------------------------<>-----------------------------------------XX-------
------------------------------------------------------------------------------------------------------------[]----------------------------E----X----------------
-------B----------------------------------------------------------------------------------------------------[]---------------------------<>----X----------------
------------------------------------------------------------------------------------------------------------XX---------------------------------X----------------
X--XXXXXXXXXXX----------------------------------------------------XXXXXXXX----------------------------------XX------------------------XXXXXXXXXXX-XXX-----------