------------------------------------------XXXXXX--------------------------------------------------------X----------------XXXXXXXXXXXXXXXXXXXXXXXXXXXXXXXXXX----X
------------------------------------------XXXXXXX-------------------------------------------------------------------------------------E-------------E-X---------
--------------------------------------------XXXXX-----------------------------------------------------------------------------------------------------X---------
---------------------------------------------EXXX-XXX-------------------------------------------------------------------------------------B---------------------
----------------------------------------------XXX---------------------------------XXX---------------------------------------------------------------------------
-------------------------------------------------------EXX--------------------------E----------------------X-------------------------------------E--------------
--------E--------oo---------------------------------------------------------------------------------------------------------------------------------------------
----SSSS-----------------SQS--------XXX-------------------------------------------------------------------------------------------------------------------------
-------------------------------------------------------------E--------XX----------------------------------------XXXX---------------------------------------SSSSS
--------------------------------------------------XXX--o-o--------E------------X-------XXXXXXXXXXXXXX-----------------------------------------------------------
-------------------------------------------------------o-o-------<>---------E--X--------------------------------------------------------------------------------
----S--------------------S?S------------SSSSSSSS-----------------[]---------X--X--------------------------------------------------------------------------------
-----------------------------------------------------------------[]---------X--X--------------------------------------------------------------------------------
-----------------------------------------------------------------[]---------X--X--------------------------------------------------------------------------------
-----EE--------E-E-----------------------------------------------[]---------X--X--------------------------------------------------------------------------------
XXXXXXXXXXXXXXXXXXXXXXXXXXXXXXXXXX-------------------------------[]----XXX--X--X--------------------------------------------------------------------------------