----------------------------------------------------------------------------------------------------------------------------------------------------------------
----------------------------------------------------------------------------------------------------------------------------------------------------------------
----------------------------------------------------------------------------------------------------------------------------------------------------------------
----------------------------------------------------------------------------------------------------------------------------------------------------------------
----------------------------------------------------------------------------------------------------------------------------------------------------------------
----------------------------------------------------------------------------------------------------------------------------------------------------------------
----------------------------------------------------------------------------------------------------------------------------------------------------------------
------------------------------------------QQQQ------------------------------------------------QQQ?QQQ------------------------------------XX---------------------
----------------------------------------------------------------------------------------------------------------------------------------------------------------
------------------------------------------------------------------------------------------------E---------------------------------------------------------------
--------------------o--------B-------------------Q-----------------------E--------------------SSSSSSS---------Q--Q-------XXX----S-------------------------------
-----------------------------b-----------QQQQQ--E-------<>--------------<>----<>-----------------------E----------------E------------------------------XXXXXXXX-
--------Q?QQQ-------------B---------------------E-------[]----------<>--[]----[]----------------X------X---------------<>-------------------------<>------------
--------------------------b--------X--------------------[]----------[]--[]-B--[]---------<>-----X------X---------------[]-------------------------[]------------
-----------------------------------X--------------------[]----------[]--[]----[]---------[]--E--X------X---------------[]---------XXX-------------[]------------
XXXXXXXXXXXXXXXXXXX---XXXXXXXXXXXXXXXXXXXXXXXXXXXXXXXXXXXXXXXXXXXXXXXXXXXXXXXXXXXXXXXXXXXXXXXXXXXXXXXXXXXXXXXXXXXXXXX--[]---------XXXXXXXXXXX-XXXXXXXXXX--------