------------------------------------------------------------------------------------------------XXXXXXXXXXXXXXXXXXXXXXXXXXXX------------------------------------
----------------------------------------------------------------------------------------------------------------------------------------------------------------
----------------------------------------------------------------------------------------------------------------------------------------------------------------
----------------------------------------------------------------------------------------------------------------------------------------------------------------
-----------------------------------------------------------------------------------------------------------------------------------XXXXXX----XX--------------oo-
----------------------------------------------------------------E-----------------------------------------------------------------------------------------------
---------------------------------------------E------------SSSSSSSSSSSSSSSSSSSS------------------XXX-XXX-XXX-XXX-XXX-XXX-------------------------XXXX------------
--------------SQQS----------------Q------SSSSSS----------------------------------------------XX--o---o---o---o---o---o------XXXX--------------------------------
----------------------------------------------------------------------------------------------------------------------------o-----------------------------------
------------------------------------------------------------------E---E---E---------------------------------------------XXX-------------------------------------
---------------------o--------------------E-------?QQ--------SSSSSS?SSS?SSS?SS-------------------------------------------o---------------------------------XXXXX
---------------SS---------<>----S?SQS----SSSSSS------------<>----------------------------XX---------------------------------------------------------------------
--------------------------[]-------------------------------[]---------------------------------------------------------------------------------------------------
B-------------------------[]-------------------------------[]-------------------XXXEXEX-------------------------------------------------------------------------
--------------------------[]---------------------XXXXXXXXXXXXXXXXXXXXXXXXXXXXX--X----------------------------------------------------------------------XXXX-----
XXXXXXXXXXXXXXXXXXXXXXXXXXXXXXXXXXXXXXXXXXXXXXXXXXXXXXXXXXXXXXXXXXXXXXXXXXXXXX--X-------------------------------------------------------------------------------