-------------------------------------------------------------------------------------------------------------------------XX---------------XX-XXXXXXXXXXXXXXXXXXX
-------------------------------------------------------------------------------------------------------------------------XX--------X------[]----------[]-E--[]--
--------------------------------------------------------------------------------XX---------------------------------------XX--------o------[]----------[]----[]--
------------------------------------------------------SS-----------------------------------------------------------------XX---------------[]----------<>----[]--
------------------------------------------------------[]-----------------------------------------------------------------XX---------------<>-----------E--SS[]SS
------------------------------------------------------[]-----------------------------------------------------XXXXXXX----------------------------------------[]--
------------------------------------------------------<>---------------XXXXX------------------------XXXX----------------------------------------------------[]--
------------------------------------------------------------------------------------------------------------------------------------------------------------<>--
-------------------------------------------------------E-----------------------------------------------------------------------------------------------------E--
-----------------------------------------------E------------------------------------------------Q?--------XX-------------------XXXX-----------------------------
-------------Q-------------------<>--------XX-<>-----<>---QQ?-------<>------------------------------------------------------------------------------------------
-------------------------------?-[]-------XXX-[]-----[]-------------[]--------------------------------------------------------------------------SSSSSSSSSSSSSSSS
----------------------------<>---[]------XXXX-[]-----[]-------------[]------------------------------------------------------------------------------------------
-------<>-------------------[]---[]-----XXXXX-[]-----[]-------------[]------------------------------------------------------------------------------------------
-------[]-------------------[]---[]----XXXXXXXXXXXXXXXXXXXXXXXXXXXXXXX---------------XXEEXEXEXXXXX--------------------------------------------------------------
XXX--XXXXXXXXXXXXXXXXXXXXXXXXXXXXXXXXXXXXXXXXXXXXXXXXXXXXXXXXXXXXXXXXX---------------XXXXXXXXXXXXX--------------------------------------------------------------