----------------------------------------------------------------------------------------------------------------------------------------------------------------
----------------------------------------------------------------------------------------------------------------------------------------------------------------
----------------------------------------------------------------------------------------------------------------------------------------------------------------
----------------------------------------------------------------------------------------------------------------------------------------------------------------
----------------------------------oo----------------------------------------------------------------------------------------------------------------------------
----------------------------------------------------------------------------------------------------------------------------------------------------------------
------------------------------------------------X--oo----------------------E------------------------------------------------------XXX---------------------------
----------------------------------XXX-------oo----------------------------<>---E--------XX------------------------E---------------------------------------------
--------------------------------------------------------------------------[]-----------XXX----------------------------------------------------------------------
---------------------------------------------------------------ooo--------QQ----------XXXX-----------------------------------------------E-----------------E----
-----------------------Q------o--------------------------------ooo-------------------XXXXX---------------XSSSSSSSS----X-------------XX--<>----------------------
----------------QQQQQ-E--------------XXXXXXX--------XXX-----------------------------XXXXXX--------------XX------------X---XXX-----------[]-------------oo-------
----------------------E---<>-------------------------------------------------------XXXXXXX-------------XXX------------X-----------------[]-------------oo-------
--------------------------[]-----------------------------XXXXXXXXXXXXX------------XXXXXXXX---------<>-XXXX------------X--------X--------[]----------------------
--------------------------[]-----------------------------X-----------X----XXXXXXXXXXXXXXXX---------[]XXXXX------------X--------X--------XXXXXXXXXXXXXXXXXXXXXXXX
XXXXXXXXXXXXXXXXXXX-XXXXXXXXXXXXXX-----------------------X-----------X----XXXXXXXXXXXXXXXXXXXXXXXXXXXXXXXXXXXXXXXX----X--------X--------XXXXXXXXXXXXXXXXXXXXXXXX