---------------------------------------------------------------------------XXXXXXXXXXXXXXXXX--X-----------------------------XXX------XXX--XXXXXX--XXXXXXXXXXXXXX
----------------------------------------------------------------------------[]XXXXXX-------X--------------------------------ooo---------------[]--------[]------
----------------------------------------------------------------------------<>-XXXXX----------------------------------------------------------<>--------<>------
--------------------------------------------------------------------------------XXXX----------------------------------------------------------------------------
---------------------------------------------------------------------------------XXX-------------XXX-----XX--------------------XXXXXXX-----------------------Q-Q
----------------------------------------------------------------------------------XX-----X----------------------------------------------------------------------
-----------------------------------------------------------------------------------X-------------------------XXXX-----XXXXX-------------------------------------
------------------------SSSSSSSSSSSSS-------------------------------E------------------------------------------E------------------------------------------------
-------------ooo----------------------------------------------------------------------------X-X-------XX------------E--------E-------------------------------Q-Q
----------------------------------------------------------------X--------------------------------o-o-------------XXXXX------------------------------------------
-----------------------------SSSSS-----------------------------XX-----------------------------------------------------------------------------------------------
----------<>---------------SS----------QQQ?QQ-----------------XXX--------------------------E--------------------------------------------------------------------
------<>--[]-------------<>----------------------------------XXXX-----------------------------------------------------------------------------------------------
---X--[]--[]--------X----[]---------------------------------XXXXX-----------------------------------------------------------------------------------------------
---X--[]--[]--------X----[]----E---EE----------------------XXXXXX-----------------------------------------------------------------------------------------------
XXXXXXXXXXXXXXXXXXXXXXXXXXXXXXXXXXXXXXXXXXXXXXXXXXXXXXXXXXXXXXXXXXXXX-------------------------------------------------------------------------------------------