-----------------------------------------XXXXXXXXXXXXXXXXXXXXXXXXXXXXXXXXXXXXX--XXXXXXXXXXXXXXXXXXXXXXXXXXXXXXXXXXXXXXXXXXXXXXXXXXXXXXXXXXXXXXXXXXXXXXXXXXXXXX-X
----------------------------------------------------[]-----------[]-------[]-------------------------------------------------------------XXXXXXXXX------[][][]--
----------------------------------------------------<>-----------[]-------<>--------------------------------------------------------------XXXXXXXX------<>[][]--
-----------------------------------------------------E-----------[]------------------------------------------------------------------------XXXXXXX-------E<>[]--
---------------------XXX------------------------XXS--------------<>-------------------------------------S-------SS------E-------------------XXXXXX----------<>--
------------------------------------------------[]-------------------------------------------------------------------------------------------XXXXX--------------
------------------------------------------------[]--------------------------------------------------------------------------------------------XXXX--------------
---------------------------------XXX------------<>---------------------------------------------------------------------------------------------XXX--------------
--------------------------XX---------------------E--SSSSS-----------------------------------------------S---------------------------------------XX--------------
--------------------oo------------------------------------------------------------------------------------------------------------------------------------------
----------------------------------------------------------------------------------------------------------------------------------------------------------------
-------------------------------XXX-XXX--------------------------------------------------------------------------------------------------------------------------
----------------------------------------------------------------------------------------------------------------------------------------------------------------
--------------<>------------------------------------------------------------------------------------------------------------------------------------------------
--------------[]------------------------------------------------------------------------------------------------------------------------------------------------
XXXXXXXX------[]------------------------------------------------------------------------------------------------------------------------------------------------