---------------------X--XXXXXXXXXXXXXXXXXXXXXXXXXXXXXXXXXX---[]--[]--[]--[]--[]--[]--[]--[]--[]--[]--[]--[]--[]--[]--[]--[]--[]--[]--[]--[]--[]--[]--[]--[]--[]-
------------------------XXXXXXXXXXXXXXXXXXXXXXXXXXXXXXXXXX---[]--[]--[]--[]--[]--[]--[]--[]--[]--[]--[]--[]--[]--[]--[]--[]--[]--[]--[]--[]--[]--[]--[]--[]--[]-
------------------------oooooooooooooooooooooooooooooooooo---[]--[]--[]--[]--[]--[]--[]--[]--[]--[]--[]--[]--[]--[]--[]--[]--[]--[]--[]--[]--[]--[]--[]--[]--[]-
------------------------oooooooooooooooooooooooooooooooooo---[]--[]--[]--[]--[]--[]--[]--[]--[]--[]--[]--[]--[]--[]--[]--[]--[]--[]--[]--[]--[]--[]--[]--[]--[]-
-------------------------------------------------------------[]--[]--[]--[]--[]--[]--[]--[]--[]--[]--[]--[]--[]--[]--[]--[]--[]--[]--[]--[]--[]--[]--[]--[]--[]-
-------------------------------------------------------------<>--<>--<>--<>--<>--<>--<>--<>--<>--<>--<>--<>--<>--<>--<>--<>--<>--<>--<>--<>--<>--<>--<>--<>--<>-
----------------------------------------------------------------------------------------------------------------------------------------------------------------
----------------------------------------------------------------------------------------------------------------------------------------------------------------
---------------------X------------------------------------------------------------------------------------------------------------------------------------------
----------------------------------------------------------------------------------------------------------------------------------------------------------------
-------oooooo---------------------------------------------------------------------------------------------------------------------------------------------------
-------oooooo---------------------------------------------------------------------------------------------------------------------------------------------------
------------------------SSSSSSSSSSSSSSSSSSSSSSSSSSSSSSSSSSSSSSSSSSSSSSSSSSSSSSSSSSSSSSSSSSSSSSSSSSSSSSSSSSSSSSSSSSSSSSSSSSSSSSSSSSSSSSSSSSSSSSSSSSSSSSSSSSSSSSSS
----XXXXXXXEXXXXX-----------------------------------------------------------------------------------------------------------------------------------------------
---XXX---------XX-----------------------------------------------------------------------------------------------------------------------------------------------
XXXXXX---------XX-----------------------------------------------------------------------------------------------------------------------------------------------