--------------------------------------X-----------------------XXXXXXXXXXXXXXXXXXXXXXXXXXXX----------------------------------------------------------------------
------------------------------XXXXXXXXX-------------------------------------------------------------------------------------------------------------------------
----------------------------------------------------------------------------------------------------------------------------------------------------------------
----------------------------------------------------------------------------------------------------------------------------------------------------------------
------------------------------E---------------------------------------------------------------------------------------------------------------------------------
----------------------------------------------------------------------------------------------------------------------------------------------------------------
-------------------------------------------oo-----------------XXX-XXX-XXX-XXX-XXX-XXX---------------------------------------------------------------------------
------QQQ?QQQ?QQQ-----------------------E----------------XXXX--o---o---o---o---o---o------XXX---SSSSSSS-SSSS--------------------------------SSS----S------------
------------------------------------------------------------------------------------------o---------------------------------------------------------------------
--------E---E-------------------------------------------------------------------------XXX-----------------------------------------------------------------B-----
------SSSSSSSSSSS----------------------------------------------------------------------o------------------------------------------------------------S-----b-----
-B-----------------E----S-------------------XX-XX---------------------------------------------------<>--SSSS----------E--S?S-------------S--S-----------SSXSS---
-b------X---X------X--E-----------------------------------------------------------------------------[]---------------<>---------<>------------------------------
-B------X---X------X-------------------------------XXX----------------------------------------------[]--------------------------[]------------------------------
-----E--X---X------X-------------------------------X------------------------------------------------[]--------------------------[]-----------EE---E-------------
XXXXXXXXXXXXXXXXXXXXXXXXX--------------------------X------------------------------------------------XX------XXXXXXXXXXXXXXXXXXXXXXXXXXXXXXXXXXXXXXXXXXXXXXXXXXXX