-----------------------------------------------------XXXXXXXXXXX<>XXXXXXXXXXXXXXXXXXXX--------XXXXXXXXXXXXX--------------XXXXXXXXX-XXXXXXXXXXX------------------
----------------------------------------------------------[]------------b-E----------X--------[]-------------------------XXXXXXXXX-XXXXXXXXXXX------------------
----------------------------------------------------------[]------------B---------------------<>----------------------------------------[]-X-X------------------
----------------------------------------------------------[]----------------------------------------------------------------------------<>-X-X------------------
--------------------------------------XXX-----------------<>------------?QQQQQQQ--QQQQ---------------------------------------------------E----------------------
--------------------------------------------------------------?--------------------------------------------------------------------S----------------------------
------------------------------------------XXXXX-----------------------------------------------------------------------------------------------------------------
------------SSSSSS----------------------------------------------------------------------------------------------------------------------------------------------
------------------------------------------------------------------------------SSSSS---------------------------------------------------------------XX-----------o
-----------------------------------------------------------------------------------------------------------------X----------------------------------------------
----------SS----------------XXXXXX--------------S-------------------------------------------------------------E--X----------------------------------------------
--------------------------E-----------------------------------------------------------------------------------X--X------------------------------------------<>--
-----------------------E--------------------------------------------------------------------------------------X--X------------------------------------------[]--
-----------------------X--------------------------------------------------------------------------------------X--X------------------------------------------[]--
-----------------------X--------------------------------------------------------------------------------------X--X------------------------------------------[]--
XXXXXXXXXXXXX------XX--X------------------------XX------------------------------------------------------------X--X---------------------------------------XXXXXXX