---------------------------------------------------------------------------------------o-oo-----------S-S-S-S-S-S-S-S-S-S-S-S-S-S-------------------------------
----------------------------------------------------------<---------------------X-X-----------X-X------------------E----------------------------------S-S-------
----------------------------------------------------------[----------------X-X----------------------------------------o-o-o-o-o---------------------------------
----------------------------------------------------------[------------------------oX-X-X-X--------->-----------------------------------------------------------
----------------------------------------------------------[-----------------------------------------]-----------------o-o-o-o-o-----------E---------------------
--------------------------------------------------X---X-X-X-X-X-X-X-X-X-X-X-X-X-----------------X-X-X-X-X-X-X-X-X-X-X-X-X-X-X-X-X-X-X-X-X-X-X-X-X-X-X-X-X-------
--------E------E------------------------------------X-X-X-X-X-X-X-X-X-X-X-X-X-X-----------------X---X-X-X-X-X-X-X-X-X-X-X-X-X-X-X-X-X-X-X-X-X-X-X-X-X-X-X-------
---?SSS-------SQS--------EXX------------------------------]---------------------------------------[-------------------o-o-o-o-o---------------------------------
------------------------EXXX------------------------------]-------------------------X-X-X-X-------<-------------------------------------------------------------
-----------------------EXXXX------------------------------]-----------------------------------------------------------o-o-o-o-o---------------------------------
--------------------X--XXXXX------------------------------>-------------------X-X-----------X-X-------------------------------------------------------S---------
-----E--------SQS-----XXXXXX------------------------------------------------------------o-------------S-S-S-S-S-S-S-S-S-S-S-S-S-S-------------------------------
E---<>---------------XXXXXXX------------------------------------------------------------o-----------------------------------------------------------------------
----[]--------------XXXXXXXX------------------------------------------------------------------------------------------------------------------------------------
----[]------E------XXXXXXXXX---------------XXXXX--------------------------X-X-X-------------------S-------------------E-----------------------------------------
XXXXXXXXXXXXXXXXXXXXXXXXXXXXXXXXXX---XXX------------------------------------------o-----------------------------------------------------------------------------