----------------------------------------------------------------------------------------------------------------------------------------------------------------
----------------------------------------------------------------------------------------------------------------------------------------------------------------
----------------------------------------------------------------------------------------------------------------------------------------------------------------
----------------------------------------------------------------------------------------------------------------------------------------------------------------
-------------------------------------------------------------------------SSSSSSSSS------------------------------------------------------------------------------
-------------------------------------------------------------------------SSSS-----------------------------------------------------------------------------------
-------------------------------------------------------------------------SSSS---------------------------------------------------------------------XXXXX---------
-------------------------------------------?-----------------------------SSSS-----------------------------------------------------------------------------------
----------------------------------------------------------------------------------------------------------------------------------------------------------------
----------------------------------------------------------------------------------------------------------------------------------------------------------------
----------------oo-------------------------------------ooooo--------------o--------------------------------------------------------------B---------------------X
---------------o--o-----E--S----<>---------S----------------------Q------S?SS------------------------------E-----------------------------b----------------------
-----------------------<>-------[]-----<>--------------------------------SSS-----E-------------------------------E--------------------B----------------XXXXX----
--------------------------------[]-----[]---X----------------------------SS---E-<>----------------------------------------------------b-------------------------
--------------------------------[]-----[]E--X------------------------------E-E--[]------------------------------------------------------------------------------
X-XXXXXXXXXXXXXXXXXXXXXXXXXXXXXXXXX-XXXXXXXXX-----XXXXXXXX-XXXXXXXXX<>XXXXX-XXXXXXXXXXXXXXX-XXXXXXXXXXXXXXXXXXXXXXXXXXXXXXXXXXXXXXXXXXXXXXXXXX-XX---------------