----------------------------------------------------------------------------------------------------------------------------------------------------------------
----------------------------------------------------------------------------------------------------------------------------------------------------------------
----------------------------------------------------------------------------------------------------------------------------------------------------------------
----------S-----------------------------------------------------------------------------------------------------------------------------------------------------
----------------------------------------------------------------------------------------------------------------------------------------------------------------
-------------------------------------------------------------------------------------------------------------------------------------------------------------XX-
--------XXXX-----------------------QQQ?QQQQQQ?QQQQ------------------E-------------------------------------------------------------------------------------------
--------XXX------------------------------------[]--------------SSSSSSSSSQ-------------------------XXXX-----------------------XX--------------------------E------
-----------------------------------------------[]------------------------------------------------XXXXX----------------------XXX-----------------------------oo--
-----------------------------------------------[]-----------------------------------------------XXXXXX-------------E-------XXXX--------XXX----oooooo------------
-------------------------------------SSSSSSSSS-<>----------------------------------------------XXXXXXX------------<>------XXXXX---------------oooooo------------
---XX--------------------------------------------------------X?---------S---------------------XXXXXXXX------------[]-----XXXXXX---------------E-----------------
------------------------------------E---E-------------------XX-----X-------------------------XXXXXXXXX------------[]----XXXXXXX---------------------------------
-------XX---------------------------------------E----------XXX-----X------------------------XXXXXXXXXX------------[]---XXXXXXXX-------------XXXXXXXXXXXX--------
-------XXXXXXXXXXXXXX--XXEEXXXXXXXXXXXXXXXXXXXX<>-XXXXXXXXXXXX-----X-----------EE----------XXXXXXXXXXX------------[]--XXXXXXXXX-------------X-------------------
X------XXXXXXXXXXXXXX--XXXXXXXXXXXXXXXXXXXXXXXX[]-XXXXXXXXXXXXXXXXXXXXXXXXXXXXXXXXXXXXXXXXXXXXXXXXXXXXXXXXXXXXXXXXXXXXXXXXXXXXXXXXXX--------X-------------------