---------------------------------------XXXXXXXXXXXXXXXXXXXX-XXX---X---------------------------------------------------------------------------------------------
--------------------------------------------------XXXXXX----------XXX-------------------------------------------------------------------------------------------
-----------------------------------------------XXXXXXXXX--------------------------------------------------------------------------------------------------------
------------------------------------------------XXXXXXXX--------------XXXXXXX-----------------------------------------------------------------------------------
--------------------------------------------------XXXXXX---------------------------------------------------------XX--XX---------SSSSSSSSSSSSSSSSSSSSSSSSSSSSSS--
-----------------o-o-XXXXXXXXXXXXXXXX-------------XXXXXX----------E--------------------------------------------------------------------SS--SSSSSS--------SSSSS--
-----------------o-o-------------------------------XXXXX----------------------------------------------------------------XXX------------SS--SSSSSS--------SSSSS--
----------------------------------------------------XXXX---------------------------------------------------------------------SSS-----SS--------SS--------SSSSS--
-----------------XXX---------------------------------XXX-----------------------------------------------------XXX---oo----------------SS--------SS--------SSSSS--
-----------------------------------------------------------------------------------------------------------------------------S-------SS--------SS--------SSSSS--
--------------------------------------------------------------------------------------------------oo-------oo---------------S-S------SS----ooooSS--------SSSSS--
-------X--XXXX-------------------------------------------------------------------------XSSS------------------------------------S-----SSSS--SSSSSS----<>-----SS--
-------X-------------------------------------------------------------------------------X-----------------------------------------------SS------------[]-----SS--
-------X-------------------------------------------------------------------------------X-----------------------------------------------SS------------[]-----SS--
--EEE--X----------------------------------------------------------------------------E-EX-------------------------------------------------------------[]---------
XXXXXXXX--------------------------------------------------------------------------XXXXXXXXXXXXXXX----X-XX-------------------XXXXXXXXXXXXXXXXXXXXXXXXXXXXXXXXXXXX