-------XXXXXXXXXXXXXXXXXXXXXXXXXXXXX-XXXX---------------XXXXXXXXXXXXXXXXXXXXX-----------------------------------------------------------------------------------
---------[]E--[]-----[]----------------XX---------------------------[]------------------------------------------------------------------------------------------
---------[]---[]-----[]---<>-----------XXX--------------------------<>------------------------------------------------------------------------------------------
---------<>---[]-----<>----E-----------XXXE---------------------------------------------------------------------------------------------------------------------
--------------<>-----------------------XXX--XX------------------------------------------------------------------------------------------------------------------
-------------------------------------------------------------------------S--------------------------------------------------------XX----------------------------
---------------------------------------------------X------------------------------------------------------------------------------XX----------------------------
-------------------------------------------------------XXX-----------------------E------------------------------------------------XX----------------------------
----------------------------------------------------------------------------------------------------------------------------------XX----------------------------
--------------------------------------------------------------------------------------XXXXXXXXXXXXXXXXX---------------------------XX----------------------------
----------------------------------------------------------------------------------------------------------------------------------XX----------------------------
SSSSS--------------------------------------------------------------------------------------------------------------?QQQQQQQ-------XX--------------------XXXXX---
----------------------------------------------------------------------------------------------------------------------------------XX----------------------------
-------------------------------------------------------------------------------------------------------------------B--------------XX----------------------------
-------------------------------------------------------------------------------------------------------------------b-E------------XX---------E------------------
XXXXXX----------------------------------------------------------------------------------------------------XXXXXXXXXXXXXXX-XXXXXXXXXXXXXXXXXXXXXXXXXXXXXX--------