----------------------------------------------------------------------------------------------------------------------------------------------------------------
----------------------------------------------------------------------------------------------------------------------------------------------------------------
----------------------------------------------------------------------------------------------------------------------------------------------------------------
----------------------------------------------------------------------------------------------------------------------------------------------------------------
----------------------------------------------------------------------------------------------------------------------------------------------------------------
----------------------------------------------------------------------------------------------------------------------------------------------------------------
----------------oooooo-----------------------------------------------------------------E--------------------------------E---------------------------------------
----------------XXXXXX----------------------------------------------------------------SQS-------------XX--------------SSSS-----XX-------------------------------
-----------------------------------------------------------------------------------------------------XXX----------------------XXX-------------------------------
----------------------------------------------------------------------------------------------------EXXX---------------------XXXX-------------------------------
---------------------------------------------------------------------------------------------------XXXXX--------------------XXXXX-------------------------------
--------------------------------<>----------------<>-----------?QQQQQQQ?--------------SQS---------XXXXXX--------------SSS--XXXXXX-------------------------------
-----------XXXX?----------------[]----------------[]----------------------------<>---------------XXXXXXX------------------XXXXXXX-------------------------------
--------------------------------[]----------------[]-----------B----------------[]--------------XXXXXXXX------------X----XXXXXXXX-------------------------------
--------------------------------[]----------------[]-----------b-E-----B--------[]-EE----------XXXXXXXXX---------X--X---XXXXXXXXX-------------------------------
XXXXXXXXXXX----XXXXXXX-XXXXXXX--XXXXXXXXXXXXXXXXXXXXXXXXXXXXXXXXXXXXX-XXXXXXXXXXXXXXXXXXXXXXXXXXXXXXXXXXXXXXXXXXXX--XXXXXXXXXXXXXXXXXXXXX--XXXXXXXXXXXXXXXXXXXXX