--------------------------XXX------------X--X-------------------------------------------------------------------------------------------------------------------
--------------------------ooo------------X--X-------------------------------------------------------------------------------------------------------------------
-----------------------------------------X--X-------------------------------------------------------------------------------------------------------------------
-----------------------------------------X--X-------------------------------------------------------------------------------------------------------------------
-----------------------------XXXXXXXX----X--X-------------------------------------------------------------------------------------------------------------------
-----------------------------------------E--X----X--------------------------------------------------------------------------------------------------------------
----------------------XXX-------------------X-------------------------------------------------------------------------------------------------------------------
------------------------------------------------------------SSS-----------SSS------------------------------------------------S---------------------------------S
---------------------------E------------------------------------------------------------------------------------------------------------------------------------
--------------------------------------------------------------------------------XXXXXXXX------------------------------------------------------------------------
--------oo----o----------------------------------------------------------------------------ooooooooooooooooooooooooooooooo--------------------------------------
------------------------------------------------------------<>-----------XXXXX------------XXXXXXXXXXXXXXXXXXXXXXXXXXXXXXXXX----------------------E--------------
------------------------------------------------------------[]-----------X-----------------------------------------------------------------------------XX<>-----
------------------------------------------------------------[]-----------X---------------------------------------------------<>----------------------XXXX[]-----
------------------------------------------------------------[]--------E--X---------------------------------------------------[]---------------------XXXXX[]---E-
XXXXXXXXXXXXX----XXXX---------------------------------------XX--XXXXXXXXXXXX----------------------------------------------XXXXXXXXXXXXXXXXXXXXXXXXXXXXXX-XXXXXXX