------------------------------XXXXXXXXXXXXXXXXXXXXXXXXXXXXXXXXXXXXXXXXXXXXXXXXXXXXXXXXXXXXXXXXXXXXXXXXXXXXXXXXXXXXX---------------------------------------XXXXXX
-----------------------------------------------------------------E---[]---[]------------------------------------------------------------------------------XXXX--
----------------------------------B----------------------------------[]---[]-------------------------------------E----------------------------------------XXX---
---------------------------------------------------------------------<>---[]------------------------------------------------------------------------------XX----
-----------XXXXXX--------------XX-XQQ?---------------SS-----------------?-[]-----------SSSSSSSS-----------------------------------------------------------X-----
-----------XXXXXX--------------[]------------oo--------------------S------<>-------------------------------------------XXXEXX-----------------------------------
-----------XXXXXX--------------<>----------------------o------------------------------------------------------------------oo----------------XXXXXXXXXEX---------
---------S-XXXXXX---------------E---------------------------------------------------------------------------------------------XXX---XXXX------------------------
-----------XXXXXX-------------------------------------------------S---------------------SS?SSS------------------------------------------------------------------
-----------XXXXXX-----------------------------------------------------------------------------------------------------------------------------------------------
--------S--XXXXXX-----------------------------------------------------------------------------------------------------------------------XXX---------------------
-----------XXXXXX-----------------------------------------------------------------------------------------------------------------------------------------------
-----------XXXXXX-----------------------------------------------------------------------------------------------------------------------------------------------
---------E-XXXXXX-----------------------------------------------------------------------------------------------------------------------------------------------
-----------XXXXXX-----------------------------------------------------------------------------------------------------------------------------------------------
XXXXXXXXXXXXXXXXX--XXXXX----------------------------------------------------------------------------------------------------------------------------------------