---------------------------XXXXXXXX-----------------------------------------------X-------------------------------------------XXXXXXXXXXXXXXX------X------------
----------------------------------------------------------------------------------XX------------------------------------------[]-XXXXXXXXXXXX------X------------
----------------------------------------------------------------------------------XX------------------------------------------[]----------------XXXX------------
----------------------------------------------------------------------------------XX------------------------------------------<>--------------------------------
-----------------------------------XXXX-----------------------?----------------------XXXX-------XXXX-----XXXX------------------E------------------------XXXXXX--
----------------------------------------------------------------------------------------------------------------------------------------------------------------
-------XXXXXXX----XXXXXXX---------------XXXXXXXXXX---------------------XXXXXXX----------------------------------------------------------------------------------
------------------------------------------------------------XXX-----------------------------XX------------------------------------------------------------------
------------------------------------------------------------------------------------------------------XX--------oo----------------------------------------------
----------------------------------------------------------------------------------------------------------------SS----------------------------------------------
----------------------------------------------------------XXXXXXXXX----XXXXXXX-----------------E----------------------------------------------------------------
---------------------------------------------------------------------------------------------------------------------XXXEXX-------------------------------------
-XXX----------------------------------------------------------------------------------------------------------------------X-------------------------------------
--------------o-----------------------------------------------------------------------------------------------------------X-------------------------------------
--------------X-----------------------------------------------------------------------------------------------------------X-------------------------------------
-----------------------------------------------------------------------------------------------------------------XX-------X-------------------------------------