-----------------------------------------------------------------------------------------------------------------------------------------XXXXXX-----------------
-----------------------------------------------------------------------------------------------------------------------------------------XX---X-----------------
-----------------------------------------------------------------------------------------------------------------------------------------XX---------------------
-----------------------------------------------------------------------------------------------------------------------------------------XX---------------------
-----------------------------------------------------------------------------------------------------------------------------------------XX---------------------
-----------------------------------------------------------------------------------------------------------------------------------------XX---------------------
-----------------------------------------------------------------------------------------------------------------------------------------XX---------------------
---------------------------------------Q---SSS---------------------------------------?SS---------------Q----E----------------------------XX---------------------
-----------------------------------------------------------------------------------------------------------<>----------------<>----------XX---------------------
-----------------------------------------------------------------------------------------------------------[]----------------[]---------------------------------
-------------Q-----------------------------SSS--------------------------------E----------------------------[]-----X----------[]---------------------------------
------------------------<>-------------?-------------------------------------<>------------------------?---XXX--QQX---------QQQ?----XX--------------------------
------------------------[]-------XX<>---------------------------------------------E---B------------<>-------------------------------XX--------------------------
------------------------[]------XXX[]-------------------------------------------------b------------[]-------------------------------XX-------------------<>--<>-
------------------------[]-----XXXX[]-------------------------------------------------------X------[]---------------------------E---XX-------------------[]--[]-
XXXXXXXXXXXXXXXXXXXXXXXXXXXXXXXXXX-XXXXXXX----XXXXXXXXXXXXXXXXXXXXXXXXXXXXXXXXXXXXXXXXXXXXXXXXXXXXXXXXXXXXXXXXXXXXXXXXXXX-X-----X---XX-------------------XXXXXXX