------------------XXXXXXXXXXXXXXXXXXXXXXXXXXXXXXXXXXXXXXXXXXXXXXXXXXXXXXXXXXXXXXXXXXXXXXXXXXXXXXXXXXXXXXXXXXXXXXXX--XXXX-XXXXXXXXXXXXXXXXXXXXXXXXXXXXXXXXXXXXXXX
------------------------[]--------------------------------BEE------E-----------XXX[]-------------------------------------[]----XX----------X-----XXXXXEXEXXXXXXX
------------------------<>------------------------B-------b--------------------XXXX>-------------------------------------[]----XX----------X------X-------------
----------------------------------------------------------B--------------------XX----------------------------------------<>----XX----------X----------------E---
--------------------------------SS---------------------------------------------XX------S?SQS--------------------QQ-------------XX-------------------------------
-------------------------------------------------------------------------------------------------------------------------------XX------------------QQQQ?Q--<>---
-------------------------------------------------------------------------------------------------------------------------------XX--------------------------[]---
-------------------------------------------------------------------------------------------------------------------------------XX--------------------------[]---
---------------------------------------------------------------------------------S-------Q-------------------------------------XX--------------------------[]---
-------------------------------------------------------------------------------------------------------------------------------XX--------------------------[]---
-------------------------------------------------------------------------------------------------------------------------------XX--------------------------[]---
--------QQQ------------------------------------------------------------------------------------------------------------------------------------------------[]---
----------------------------------------------------------------------------------------------------------------------------------------------------------XXXX--
----------------------------------------------------------------------------------------------------------------------------------------------------------------
----------X-----------------------------------------------------------------------------------------------------------------------------------------------------
XXXXXXXXXXX-----------------------------------------------------------------------------------------------------------------------------------------------------