----------------------------------------------------XXX-----------XXXXXXX-XXXXXXXXXXXXXXXXXXXXXXXXXX------------------------------------------------------------
------------------------------------------------------------------------------[]----------XXXXXXXXXX------------------------------------------------------------
------------------------------------------------------------------------------[]-----------XXXXXXXXX------------------------------------------------------------
------------------------------------------------------------------?-----------[]------------XXXXXXXX------------------------------------------------------------
------------------------------------------------------------------------------<>-------------XXXXXXX------------------------------------------------------------
-------------------------------------------------------------------------------------------X--XXXXXX------------------------------------------------------------
---------------------X---XX------------oo-----------------------------------------------------EXXXXX-----------------------------------------QQSSSSS------------
----------------------------------XX-----------------------------------------------------------EXXXX-----SSSSSSS------------------------------------------------
-----------------------ooooooo-------------------------------------XXXXXX-----------------------EXXX------------------------------------E-----------------------
-----------------------ooooooo-------------------------------------oooooo--------------------------------------------------------------<>------E----------------
-----------------------------E----------------------------<>----------------------------------------------E--E------------------S------[]-----<>----------------
QQQ---------E--S------------<>---------------XXX----------[]---------------------------------------------SSSSSSS-----------------------[]-----[]----------------
-----------<>----------E----[]----------------------------[]---------------------------------------------------------------------------[]-----[]----------------
----------------------<>----[]----------XXXX--------------[]---------------------------------------------------------------------------[]-----[]--------------X-
----------------------[]----[]---------------------------XXX---------------------------------------------------------------------------XXXXXXXXXXXXXXXXXXXXXXXX-
XXXXXXXXXXXXXXXXXX----[]----[]---------------------------XXX------------------------------------------XXXXXXX--XXXXXXXXXXXXXXXXXXX-----XXXXXXXXXXXXXXXXXXXXXXXX-