-----------------------X-----------------------------X-------------------------------------------XX----------XX-------------------------------------------------
-----------------------------------------------------X-------------------------------------------[]----------XX-------------------------------------------------
-----------------------------------------------------X-------------------------------------------[]----------[]-------------------------------------------------
-------------------------------------------------------------------------------------------------[]----------[]-------------------------------------------------
-------------------------------------------------------------------------------E-----------------<>----------<>-------------------------------------------------
-------------------------------------------------------------------------------------------------------XXXX-----------------------------------------------------
-----------------------------XXXXXXX-----------oo--------------------------XXXEXXXXX-------------------o-------------------------------------------------XX-----
------------------XX------------------------------------------------------------------------------------------------------------------------------------------E-
-----------------XXX--------------------------------------------------------------------------------------------------------------------------------------------
----------------EXXX---------------------------------------XXXXXXXXX----E-------------------------------SS-----------XXXXX---XXXXX------------------------------
---------------XXXXX---------XXXXXXX----------------------------------XXXXXXXEEXXXXXXX--------------------------------------------------------------------------
--------------XXXXXX----------------------------XXX-------------------------------------------------------------------------------------------------------------
-------------XXXXXXX-----------------------------------------------------------------------------------------------------------------------<>-------------------
------------XXXXXXXX-----------------------------------------------------------------------------------------------------------------------[]-------------------
-----------XXXXXXXXX--------------------EE--XX---------------------------------------XXXXXXXXX---------------------------------------------[]-------------------
XXXXXXXXXXXXXXXXXXXX------------------XXXXXXXX---------------------------------------------------------------------------------------------[]-------------------