-------------------------------------------------------------X-----------------------[]----XXXXXXXXXX------------------[]----[]---------------------------------
-------------------------------------------------------------------------------------<>---XX-XXXXXXXX------------------[]----[]------------------------X-X------
-----------------------------------------------------------------------------------------------------------------------<>----[]----------------X---o------------
------------------------------------------------------------------------------------------------oo----------------------E----[]--------------------X------------
------------------------------------------------------------------------------------------------oo---------------------------<>----<>---------------------------
---------------------------------------------------------------------------------------------------------XXX-----XX-----------E----[]---------------------------
--------------------------------------------------------------------------------------oooo----------E-------------------ooooooo--XX[]X-----------------------X-X
---------SSSSSSS------------------SSSSSSSSS-SSSSSSSSS-SSSSSS------------------SSS---------------------------------------ooooooo---------------------------------
----------------------------------------------------------------------------------------------------------------------------------------------------------------
-----------------------------------------------------------------------<>------------------------------------XXXXX----X---XX--------------------------X-X-X-----
----------E--E-------B-------------------------------------------------[]--------------------------------------------------------------------X--X-o-------------
--------SSSSSSSS-----b--<>-------X------<>--------<>--------SSSSSSS----[]----XXXXX----------------------------------------------------------------X-X-----------
------------------B-----[]--<>---X------[]--------[]-----------------E-[]----X----------------------------------------------------------------------------------
------------------b-----[]--[]---X------[]--------[]----------------<>-[]----X---------------------------------------------------------------E------------------
------------------------[]--[]E--X------[]--------[]----------------[]-[]----X--------------------------------------------------------------------------------X-
XXXXXXXXXXXXX--XXXXXXXXXXXXXXXXXXXXX----XX--------XX---------XXXXXXXXXXXXXXXXXXX--------------------------------------------------------------------------------