----------------------------------------------------------------------------------------------------------------------------------------------------------------
----------------------------------------------------------------------------------------------------------------------------------------------------------------
----------------------------------------------------------------------------------------------------------------------------------------------------------------
----------------------------------------------------------------SS----------------------------------------------------------------------------------------------
----------------------------------------------------------------[]----------------------------------------------------------------------------------------------
----------------------------------------------------------------[]----------------------------------------------------------------------------------------------
----E----------E----------------<>------------------------------<>-------------------------------oo-------------------------------------------------------------
-SS-----------SQS-------------XX[]-------SSSSS---SS---------------------------------------------------------------------SQQQ-------------------------S----------
-----------------------------XXX[]-------------------------------E----------------------------------------------------------------------------------------------
----------------------------EXXX[]------------------------------------------------------------------------------------------------------------------------------
--------S------------------XXXXX[]------------------<>---------<>-------------------oooo------------------------------------------------------------------------
--------------SQS----------XXXXX[]-----------ES-----[]---------[]---------------------------------------------------QQQQ?SSQQQQQQ----------------QQQ?Q-----<>---
----------<>------EE-----XXXXXXX[]-----E----<>------[]---------[]--------------------------------------------------------------------------------E---------[]---
---E------[]------------XXXXXXXX[]----<>----[]------[]---------[]-------X------------------<>--------------------------------------------------------------[]---
----------[]E--------------XXXXXXXXX--[]----[]------[]--XXXXXXXXXXXXXXXXXX-----------------[]--E-E----------------EE---------------------------------------[]---
XXXXXXXXXXXXXXXXXXXXXXXXXXXXXXXXXXXX--XXXXXXXXXXXXXXXXXXXXXXXXXXXXXXXXXXXXX-XXXXXXXXXX-XXXXXXXXXXXXXXXXXXXXXXXXXXXXXXXXXX--XXXXXXXXXXXXXXXXXXXXXXXXXXXXXXXXXXXXX