--------------------------------------------------------------XX--XXXXXXXXXXXXXXXXXXXXXXXXXX-XXX-----------XXXXXXXXXXXXX-XXXXXXXXXXXXXXXXXXXXXXXXX--X-XXXXXXXXXX
-----------------------------------------------------------------------------------X-------------------------------------------------------------------[]----[]-
-----------------------------------------------------------------------------------X--------------XX-------------------------------------B-------------[]----<>-
-------------------------------------------------------------------------------------------------------------------------------------------------------<>-------
-------------------------------------------------------------------------------<>---------------------XX-------------------------ooo----------------------------
--------------------------------------------------------------------------------E-------------------------------------------------------------------------------
---------------------E-------------------------------------------------------------------------XX---------------------------------------------------------------
---------------------S--------------SSSSSS----------------------------------------------------------------------------------------------------------------------
-----------------------------------------------------------XXXXXXX----------------------------------------------------------------------------XX----------------
---------------------?------------------------------------------------------------------------ooo---------------------------------------------------------------
--------------------------------SSSS------------------?---------------------------------------------------------------------------------------------------------
--------<>------------------------------------------------------------------------------------------------------------------------------------------------------
--------[]-----------X---------------------------E--------------------------------------------------------------------------------------------------------------
--------[]-----------X-------<>---------------------------------------------------------------------------------------------------------------------------------
--------[]-----------X-------[]---------------------------------------------------------------------------------------------------------------------------------
XXXXXXXXXXXXXXXXXXXXXXX--XXXXXXXXXXXX-----XXXXXXXXXXXXXX--------------------------------------------------------------------------------------------------------