-----------------------------------------------------------------------------------------------------------------------------X--XXXXXX--------------------S-----
--------------------------------------------------------------------------------------------------------------------------------XXXXXX--------------------------
--------------------------------------------------------------------------------------------------------------------------------oooooo--------------------------
--------------------------------------------------------------------------------------------------------------------------------oooooo--------------------------
-----------------------------------------------------------------------------------------------------------------------------------------[---------------<------
-----------------------------------------------------------------------------------------------------------------------------------------[---------------[------
-------------------------------------------------------------------------------------------------------------------XXXXXXX---------------[---------------[------
-----------------------------------------------------------------------------------------------------------------------------------------[-X-X-X-X-X-X-X-X-X-X-X
-----------------------------------------------------------------------------------------------------------------------------X-----------[-X-X-X-X-X-X-X-X-X-X-X
-----------------------------------------------------------------------------------------------------------------------------------------[-----------------]----
------------------------------------------------------------------------Q--Q----------------------------------E----XXXXXXX---------------[-----------------]----
-----------------------------------------------------------------------------------------------------?QQQQQQQQQQ-------------------------->---------------->----
--<>----B----------------------------------<>-----------<>----------<>----------------------------------------------------------SSSSSSSSSS]X---------Q----------
--[]----b------X---------------------------[]-----------[]----------[]-------------------------------B----------------------------------SS]]--------------------
--[]E----------X---------------------------[]-----------[]----------[]----------------------E--------b-E--------------------------------SS]]--------------------
XXXXXXXXXXXXXXXXXXXXXXXXXXXXXXXXXXXXX--XX--XXXXXXXXXXXXXXXXXXXXXXXXXXXXXXXXXXXXXXXXXXXXXXXXXXXXXXXXXXXXXXXX-<><>------------------------SS]]--------------------