----------X-------------XXXXXXXXXXXXXXXXXXXXXXXXXXXXX---XXXXXXXXXX----------------------------------------------------------------------------------------------
----------X------------------E--------------------------X--------X----------------------------------------------------------------------------------------------
----------XXXXEXX--------------------------------------------------------------------------XXXXXXXX-------------------------------------------------------------
----------------------------------------------------------------------------------------------------------------------------------------------------------------
------------------X-------------------XXX-----------------QQ?QQQQQ----------------------------------XXXXXXX-----------------------------------------------------
------------oooo----------------------[]------------------E------------------------------------ooo----------------o-----------XX-------o------------------------
------------oooo----------------------[]-------------------------------------------------------ooo----------XXXX--o---------------------------------------------
--------------------------------------<>--------------------------------------E------------------------------------------------------SSS------------SSSS-------S
---------------------------------------E-------------SSSSSSSSS--------------------------------------------------------------------------------------------------
----------------------------------------------------------E------------XXXXX-----------XXXE------------------------XoXXXXXX--o-o--------------------------B-----
-----------------------------------------------------------------------------------------------------------------------------o-o---------------------E----b-----
-<>-----------------------------------------------------------------------------XXXXXX------------------------------------------------S--------<>---SSSSSSXSS---
-[]--------------------------------------------------------------------------------------------------------------------------------E-----------[]---------------
-[]-------------------------------------------------------------------------------------------------------------------------------<>-------X---[]---------------
-[]--------------------------------------------------------------------------ooo--------------------------------------------------[]---E---X---[]---------------
XXXX-X-----------------------------------------------------------------------XXX--------------------------------------------------XXXXXXXXXXXXXXXXXXXXXXXXXXXXXX