------------------------XXXXXXX]XXXXXX----XXXXXXXXXXXXXXXXXXXXXXXXXXXXXXXXXXXXXXX-------------------------------------------XXXXXXXXXXXXXXXXXXXXXXXXXXXXXXXXXXXX
----------------------------[][]----[]--------[]----------------------------------------------------------------------------XXXX-------------------------------X
----------------------------<>[]----[]--------[]----------------------------------------------------------------------------XXXX---SSSSSSSSSSSX---B------------X
-----------------------------E<>----[]--------<>----------------E-----------------------------------------------------------XXXX-----------EE-X------E--------E-
------------------------------------<>-----------------QQQQX--------------------XXX---XXX--XX-------------------------------XXXX---XS?SSSSS---X------E----------
-----------------------------------------------------------X----------------------------------------------------------------XXXX---X-E--E-------------Q---------
----------------------------------------------------------------------------------------------------------------------------XXXX--------------------------------
--------QQQ?QQQ---------------------E-----------------------------------------------------------S---------XXX---------------XXXX-------SSSS---------------------
--------------------------------------SSS-------------------------------------XXX--------oo---------------XXX------<>-------XXXX--------E-----------------------
----------E---------------------------------------------------------------------------------------------XXXXX------[]-------------------------------------------
--------SSSSSSS--------------------------------------------------------------------------------E-EE-----XXXXX------[]-------------------------------------------
-----------------E---------------------------------------------------------------------------------XX-XXXXXXXS----QQQ?------------------------------------------
----------X------X---------------------------------------------------------------------------------XX-XXXXXXX---------------------------------------------------
-<>-------X------X---------------------------------------------------------------------------------XX-XXXXXXX---------------------------------------------------
-[]--E-E--X------X---------------------------------------------------------------------------------X--XXXXXXX---------E-----------------------------------------
XXXXXXXXXXXXXXXXXXXXXX-----------------------------------------------------------------------------X--XXXXXXXXX-X-----X-----------------------------------------