-----------------------------------------------------------------------------------------[]--------XXXXXXXXXXXXXXX---XXXXXXXXXXXXXXXXXXXXXXXXXXXXXXXXXXXXXXXXXXX
-----------------------------------------------------------------------------------------[]------------------------------------------------------oooSSSSSS------
-----------------------------------------------------------------------------------------[]---------------------------SSSSSSSSSSSSSSSSSSSSSSSSSSS---SSSSSS------
-----------------------------------------------------------------------------------------[]---------------------------SSSSSSSSSSSSSSSSSSSSSSSSSSS---SSSSSS------
------------------------------------------------------------------------XX---------------<>-----------S---------------SSSSSSSSSSSSSSSSSSSSSSSSSSSS??SSSSSS--QQ--
------------------------------------------------------------------------------------------E--------S-S--------------------------------------------?-------------
----------------------------------------------------------E------------------------oooooooo---------S-----------------------------------------------------------
--------------------------------------------------SSS---SSSSS-SS---XX--------------oooooooo---------------------------------------------------------------------
-------------------------------------------------------------E--------------XXXX--------------------SSS-------------SSSSSSSSSSSSSSSSSSSSSSSSSSSSSSSSSSSSSS--QQ--
--------------------------------------------------------------------------------------XX-----XXXXX------------------SSSSSSSSSSSSSSSSSSSSSSSSSSSSSSSSSSSSSS------
--------------------------------------------------------------------------------------------------------------------SSSSSSSSSSSSSSSSSSSSSSSSSSSSSSSSSSSSSS------
---S?S---------------------------------------------SSS--------<>------------------XX-------------------SSSSSSSSSSSSSSSSSSSSSSSSSSSSSSSSSSSSSSSSSSSSSSSSSSSSSSSSS
---------------------------------------------------------E----[]------------------------------------------------------------------------------------------------
--------------------------------------------------------------[]------------------------------------------------------------------------------------------------
--------------------------------------------------------------[]------------------------------------------------------------------------------------------------
XXXXXXXXXXXXXXXXXXXXXXXXXXXXXXXXXXXXXXXXXXXXXXXXXXXXXXXXXXXXXXXX------------------------------------------------------------------------------------------------