-------------------XX--XXXXXXXXXXXXX--XXXXXXXX---------------XXXXXXXXXXXXXXXXXXXXXXXX---------------------------------------------------------------------------
-------------------XX--XXXXXXXXXXXXX--XXXXXXXX------------------------------------------------------------------------------------------------------------------
-------------------[]-----------------------[]------------------------------------------------------------------------------------------------------------------
----------X--------[]------E----------------[]------------------E-----------------------------------------------------------------------------------------------
-------------------<>-----------------------[]------------------------------QQ?QQ--------------------------------------------------------------XX---------------
------------------------QQQQQ---------------[]------------------------------E------?-------------------------------XXXXXXXXXXXXXXXXXXXXXXXXXXXXXXXXXX-----------
--------------------------------------------<>--------------------------------------------------------------------XX--------------------------------------------
-----?---------------------------------------E-----------------------------------------XXXXX---------Q-----------XXX---------------------------------------?SS--
------------------------------------------E--------------------SSSSSSSSSSSSSSSSS--------------------------------XXXX--------------------------------------------
------------------------------------------?----------------------E-----E----E----------------------------------XXXXX--------------------------------------------
-------------XXX----------------------------------------------------------------------------------------------XXXXXX--------------------------------------------
<>---S----X------------------------------------------------------------------------------------------?-------XXXXXXX--------------------------------------------
[]-----------------------------------------------------------------------------------------------<>---------XXXXXXXX-----------<>------------<>----<>---E---B---
[]----X------------------------------------------------------------------------------------------[]--------XXXXXXXXX-----------[]------------[]----[]-------b---
[]----X------------------------------------------XXXXXXXXX---------------------------------------[]-------XXXXXXXXXX-----------[]------------[]----[]-----------
XXXXXXX--------------------------------------------------X----------------------------------XXX--XXXXXXXXXXXXXXXXXXXXXXXXXXXXXXXXXXXXXXXXXXXXXXXXXXXXXXXXXXXXXXX