-------------------------------------------------------------------------------XXXXXXXXXXXXXXXXXXXXXXXXXXXXXXXXXXXXX--XXXXXXXXXXXXXXXXXXXXXXXXXXXXXXX-----------
----------------------------------------------------------------------------------------XXXXXXXXXXXXXXXXXXXXXXXXXXXX-----E---XXXXXXXXXXXXXXXXXXXXXXXX-----------
-----------------------------------------------------------------------------------------XXXXXXXX[]----[]--XXXXXXXXX---------XXX------------------EE------------
------------------------------------------------------------------------------------------XXXXXXX[]----[]---XXXXXXXX---------X----------------------------------
-------------------------------------------------------------------------------------------XXXXXX[]----[]----XXXXXXX---------X----------------------------------
-----------------------------------------------------------------------------------------X--XXXXX[]---S[]-----XXXXXX-----------------------------S--------------
--------------------------------------------------------------------------------------------EXXXX[]----[]------XXXXX--------------------------------------------
---------------------------------------------------------------------------------------------EXXX[]----[]-------XXXX--------------------------------------------
----------------------------------------------------------------------------------------------EXX[]----<>--------XXX--------------------------------------XX----
-------------------------------------------------------------------------------------------------<>----------------------------------------------?QQQQQQ--------
---------------<>----------------E--------?---------------------------------------------------------------------------------------------------------------------
Q------------?-[]-----S---------<>-----------------<>-----------------------------------------------------------------------------------------------------------
----------<>---[]----------------------------------[]----------------XXXXXXX------------------------------------------------------------------------------------
----------[]---[]-------------------------E--------[]----------------------X------------------------------------------------------------------------------------
----------[]---[]----------------------------------[]-----------XXXX-------X------------------------------------------------------------------------------------
XXXXXXXXXXXXXXXXX-XXXXXXXXXXXXXXXXXXXXXXXXXXXXXXXXXXXXXXXXXXXX-------------X------------------------------------------------------------------------------------