------------------------------------------------------------------------------------[]--------------------------------------------------------------------------
------------------------------------------------------------------------------------[]--------------------------------------------------------------------------
------------------------------------------------------------------------------------<>--------------------------------------------------------------------------
----------------------------------------------------------------------------------------------?-----------------------------------------------------------------
-------------------------------------------------------------------------------------------------------<>-------------------?-------------------SSSS------------
-------------------------------------------------------------------------------------------------------[]-----------------------------------------------E-------
------------------E--------------------------------------------------------------------------S---XXXXXX[]X---------------------------------------?--------------
----------------QQQQQQQ-Q-Q-Q-----------------------QQQQ------------------------------------------------------------------XXX-------------------S??----------XX-
-------oo---------------------------ooo--------------------------------------------------------------------------------------------------------------XX---------
----------------------------------------------------------------------------------------------------------------------------------------------------------------
-------------------E----------------------------------------------------------------------XXXXXX-----------------------XXXXXXXXXXXXXX---------------------------
----<>-------QQQQQQQQQQ-Q-Q-Q---<>-----------?QQQQQQ?SSQQQQ----------------------------------------------------------------------------------XX-SSSS-----XXX----
----[]--------------------------[]------------------------------------------------------------------------------------------------------------------------------
----[]--------------------------[]-----------B------------------------------------------------------------------------------------------------------------------
----[]--------------------------[]-----------b-E-----------------------------------------------------------XXXXXXXXXX---------------XXX-------------------------
XXXXXXXXXXXXXXXXXXXXXXXXXXXXXXXXXXXXXXXXXXXXXXXXXXXXX--XXXXXXXXXXXXXX--XXXXXXX------------------------------------------------------------------XXXX------------