----------------------------------------------------------------------------------------------------------------------------------------------------------------
----------------------------------------------------------------------------------------------------------------------------------------------------------------
----------------------------------------------------------------------------------------------------------------------------------------------------------------
----------------------------------------------------------------------------------------------------------------------------------------------------------------
----------------------------------------------------------------------------------------------------------------------------------------------------------------
-----------------------------------------------------o-o-XXXXX---XXXXXXXX---------------------------------------------------------------------------------------
----------------------------------------E------------o-o----------------------ooooooooo-------------------------------------------------------------------------
------------------------------------------------------------------------------XXXXXXXXXX---------------------------S----------------------------------X---------
------------------------------------------XX---------XXX---------------------------------------------------------------------------------------------XX---------
-------------------------------------------------------------------------XXX------------------o------------------------------------<>---------------XXX--E------
-----------------------------------------------------------------------------------------------------------------------------------[]--------------XXXX-<>------
-----------------------------------XXXX-------------------------------oo-------------------XSS------------------QQ?Q------E--SS----[]-------------XXXXX-[]------
---------------------------E---------------------------------------------------------------X-----------------------------<>------E-[]------------XXXXXX-[]------
-----------------------------------------------XX------------------------------------------X---------<>-------------------------<>-[]-----------XXXXXXX-[]-----E
E----------------------------------------------------------------------------o----------E-EX---------[]--E----------------------[]-[]----------XXXXXXXXXXXXXXX<>
XXXXXXXXXXXXXXXXXXXXXXXXXXXXXXXXXX-------------------------------------------XXXXXXXXXXXXXXXXXXXXXXXXXXXXXXXXXXXXXXXXXXXXXXXXXXXXXXXXXXXXXXXXXXXXXXXXXXXXXXXXX[]