-------------------------------------------------------------------------------------------------------------------------------------------------------[]----[]-
-------------------------------------------------------------------------------------------------------------------------------------------------------[]----[]-
-------------------------------------------------------------------------------------------------------------------------------------------------------<>----[]-
--------------------------------------------------------------------------------------------------------------------------------------------------------E----[]-
-------------------------------------------SSSSSSSSSSSSSSSSSSSSSSSSSSSSSSSSSSSSSSSSSSSSSSSSSSSSSSSSSSSSSSSSSSSSSSSSS-SSSSSSS---------------------------------<>-
-------------------------------------------SSSS--SSSS---------------------------------------------------------------------------------------------------------E-
-------------------------------------------SSSS--SSSS-------------------------------------------------------------------------XXX-----------------------ooooooo-
-------------------------------------------SSSS---------------------------------------------------------------------------------------------------------ooooooo-
----------------------------------------------------------------------------------------------------------------------------------------------------------------
-----------------------------<>--------------------------------------------E-----------E-------------------E------------------------XXXXXX------------X---XX----
-----------------------------[]-------------o-----E-----------------------<>----------<>------------------<>-----------------------------------XXXXX------------
------XX---------------------[]------------S?SS--SSSS---------------------[]-----XXX--[]---XXX------------[]-------------QQQ------------------------------------
-----XXXX------------------E-[]------------SSS--EE-------XXX---XXX---XXX--[]----------[]---------XXX------[]-------E--------------------------------------------
----XXXXXX----------------<>-[]------------SS-----------------------------[]----------[]------------------[]--<>--<>--------------------------------------------
---XXXXXXXX---------------[]-[]--------------E-E--------------------------[]----------[]------------------[]--[]--[]--------------------------------------------
XXXXXXXXXXXXXXXXXXXXXXXX--XXXXXXXXXXXXXXXXXXX-XXXXXXX---------------------XX----------XX------------------XX--XXXXXXXXXXXXXX------------------------------------