------------------------------XXXXXXXXXXXX----------------------------------------XXXXXXXX---------------------------XXXXXXXXXXXXXXXXXXXXXXXXXXXXXXXXXXXXXXXXXX[
---------------------------------------------------------------------------------------------------------------------XXXXXXXXXXXXXXXXXXXEXXXXXXXXXXXXXXXXXXXXXX<
----------------------------------------------------------------------------------------------------------------------------------------------------------------
----------------------------------------------------------------------------------------------------------------------------------------------------------------
------------------XXXXXX---------------------------------------------E-------------------------------------E----------------------------------------------------
--------------------E----------------------------------------------------------------------------------------XX-------------------------------------------------
------------------------------XXX-XXX----------------------------XXXEXXXXX--------XXX--------------------------------QQQQ---------------------------------------
---------------------------XX--o---o------XXXX---E-----------------------------XX--o------XXXoo----------------------[][]---------------------------------------
----------XXX---E-------------------------o-----------------------------------------------o--------------------------<><>---------------------------------------
-------------------------E------------XXX-----------------E---------------------------XXX-----------------------XX----E-E---------------------------------------
---------------------------------------o----------------XXXXXXXXXXXEEXXXXX-------------o------------------------------------------------------------------------
------?----?---------------------------------------XXX-----------------------------------------XXX--------------------------------------------------------------
----------------------------------------------------------------------------------------------------------------------------------------------------------------
-----------------------------------------------------------------------------------------------------E----------------------------------------------------------
----------------------------------------------------------------------------------------------------<>----------------------------------------------------------
XXXXX-----------------------------------------------------------------------------------------------[]----------------------------------------------------------