------------------------------------------------------------------------------XXX-------------XXXXXXXXXXXXXXXXXXXXXXXXXXXXXXXXXXXXXXXXXXXXXXXXXXXX-XXXXXXXX<>XXX
----------------------------------------------------------------------------------------------------[]---[]---[]E-------------[][][]---[]-[]---XXX-XXX----------
----------------------------------------------------------------------------------------------------<>---[]---[]--------------<>[][]---<>-[]---XXX-XXX----------
---------------------------------------XXXX--------------------------------------------------------------<>---<>---------------E<>[]----E-[]---XXX-XXX----------
----------------------------------------[]------------------------------------------------------------------------S---------------<>------[]----XX-XXX----------
----------------------------------------[]-------------------------------------------------oo---------------------------------------------[]----XX-XXX----------
----------------------------------------[]------------------------------------------------------------------------------------------------<>----XX-XXX----------
----------------------------------------[]---------------------------------------------------------------------------------------------------------XXX----------
----------------------------------------[]------------------------------------------------------------------------?--------------------------------XXX----------
----------------------------------------[]-----------------S----------------------------------------------------------------------------------------------------
------------------------------QQQQQQ?Q--<>----------------------------------------------------------------------------------------------------------------------
----------E---------------E-------------------------------------------------------------------------------------------------------------------------------------
---------<>-X-X----------<>--------------------------------S----------------------------------------------------------------------------------------------------
---------[]-X-X----------[]--X-----------------------------S-----------------------XXXX-------------------------------------------------------------------------
XXXXXXXXXXXXXXX----------[]-XXXXXXXEXEXXXXXXXXXXXXXXXXX<>XXXXXXEXXXXX-------------------------------------------------------------------------------------------
XXXXXXXXXXXXXXX------XX--XXXXXXXXXXXXXXXXXXXXXXXXXXXXXX[]XXXXXXXXXXXXX------------------------------------------------------------------------------------------