---------------------------------------------------------------------------------------------XXXXX-XXX----------------X-----------------XXX--------XXX-XXXXXX---
----------------------------------------------------------------------------------------------------------------------------------------XXX--------XX-----------
--------------------------------------------------------------------------------------------------------XXXXX----------------------------[]--------X------------
-----------------------------------------------------------------------------------------------------------------------------------------[]---------------------
-------------------------------------------------------------------------------------XXXX--XX--------------------------------------------[]---------------------
-----------------------------------------------------------------------------------------------------------------------------------------<>---------------------
-----------------------------------------------------------------------------------------------------XX------------------XXXXXXEX-------------------------------
SSSSSSSSSSSSS--?-------------------------------------------------------------XXX--------------------------------------------------------------------------------
---------------------------------------------------------XXXXX---------------------o-----oo--XXX-----------------------------------XX---------------------------
----------------------------------------------------------------------o-----------------------------ooo-------------------------------------XXX-----------------
-----SSSSS---------------------------------------------oo-------------------------------------------------------------------------------------------------------
---SS----------Q------QQ-----------------------------------------SSSSS-----XXX-XXX-----------------------------XXXX---------------------------------------------
-<>-------------------------<>---------X------------------------------------------------------------------------------------------------------------------------
-[]-------------------------[]---------X-------<>---------------------------------------------------------------------------------------------------------------
-[]----E---EE-------EE------[]-E-------X-------[]--E------------------------------------------------------------------------------------------------------------
XXXXXXXXXXXXXXXXXXXXXXXXXXXXXXXXXXXXXXXX--XXXXXXXXXXXX-----------XXXXXXXXX--------------------------------------------------------------------------------------