---------------------------------------------XXXXX--------------------------------------------------------------------------------------------------------------
----------------------------------------------------------------------------------------------------------------------------------------------------------------
----------------------------------------------------------------------------------------------------------------------------------------------------------------
---------------------------------------XX-----------------------------------------------------------------------------------------------------------------------
-------------------------------------------XX-------------------------------------------------------------------------------------------------------------------
----------------------------------------------------------------------------------------------------------------------------------------------------------------
------------------------------------------------------------------------------------------------------Xooooo---------------------XXXXXXXX-----------------------
---------------SS--SQS-----------XXXX-------------------------------------E---XXXXXXXXXXXXX-------oo--XXXXXX----------------------------------------------------
-----------------------------XX---------ooo--XXX-----------------E-------------------------------XX-------------------------------------------------------------
-------------------------------------------------------------------XXXXX----------------------------------------------------------------------------------------
-----------------------------------------------------------------------------------------------------------------ooo-----------------------XX-----------XXXXXXXX
<>--QQQQQ?----SSS--S?S------------------------------------------------------XX----------------------XX-----------------XXX--------------------------------------
[]--------------------------------------------------------X---------------------------------------------------<>------------------------------------------------
[]----------------------------------------------------<>--X---------------------------------------------------[]------------------------------------------------
[]-------B--------------------------------------------[]--X--------------ooo----------------------------------[]-----------------XXXXXXXX-----XXX---------------
XXXXXXX-XXXXXXXXXXXXXXXXXX----------------------------[]--XXXX-----------XXX--XXXXXXX--XX--XXXXXX-----XXXXXX-XXXXXXXX-------------------------------------------