---------------------------XXXX----XXXXXXXXXXXXXXXXXXXXXXXXXXXXXXXXXXXXXXXXXXXXXXXXXXXXXXXXXXXXXXXXXXXXXXXXXXXXXXXXXXXXXXXXXXXXXXXXXXXXXXXXXXXXXXXXXXXXXXXXXXXXX
-------------EXX----------------------------[]------[]---[]------------------------------------------------oSSSSSSSSSSSSSSSSSSSSSSSSSSSSSSSSSSSSSSSS------------
--------------------------------------------[]------[]---[]-----------SS-------------------S----------------SSSSSSSSSSSSSSSSSSSSSSSSSSSSSSSSSSSSSSSS------------
--------------------------------------------[]------<>---<>-----------SS---------------EE--S----------------SSSSSSSSSSSSSSSSSSSSSSSSSSSSSSSSSSSSSSSS------------
--------------------------------------------<>-------E----E---------SSSS--SSSSSSSS--SS--SSSS--SSSSSS---SSS??SSSSSSSSSSSSSSSSSSSSSSSSSSSSSSSSSSSSSSSS--QQ--------
----------XX----XEXXXXX----------------------E---------S------------SS----ooooSSo??-SS---E----ooooSS---So??-----------------------------------------------------
--------------------------------------------------------------------SS--------SS----SS------------SS---S--------------------------------------------------------
--------------------------------------------------------------------SS--------SS----SS------------SS---S--------------------------------------------------------
---------------------------SSSSS-SSSS------SSSS---------------------SS--------SS----SS------------SS---S--SSSSSSSSSSSSSSSSSSSSSSSSSSSSSSSSSSSSSSSSSS--QQ--------
-------------------------------------------SSSS-----------------------SS--SSSSSSSS--E---SSSS--SSSSSS--SSSSSSSSSSSSSSSSSSSSSSSSSSSSSSSSSSSSSSSSSSSSSS------------
-------------------------------------------SSSS-----------------------SS--SSSSSSSS------SSSS--SSSSSS--SSSSSSSSSSSSSSSSSSSSSSSSSSSSSSSSSSSSSSSSSSSSSS------------
----XX------------------------------S------SSSSSSSSSSSSSSSSSSSSSSSSSSSSSSSSSSSSSSSSSSSSSSSSSSSSSSSSSSSSSSSSSSSSSSSSSSSSSSSSSSSSSSSSSSSSSSSSSSSSSSSSSSSSSSSSSSSSS
---XXX----------------------------------------------------------------------------------------------------------------------------------------------------------
--XXXX----------------------------------------------------------------------------------------------------------------------------------------------------------
-XXXXX----------------------------------------------------------------------------------------------------------------------------------------------------------
XXXXXX----------------------------------------------------------------------------------------------------------------------------------------------------------