---------------------------------------------------------------------------------------------------------------------------------------------------XXXXXXXX-----
---------------------------------------------------------------------------------------------------------------------------------------------------[]E----------
---------------------------------------------------------------------------------------------------------------------------------------------------[]-----------
---------------------------------------------------------------------------------------------------------------------------------------------------<>-----------
-----------------------------------------------------------------------------------------------SSSSSSSSSSSSSSSSSSSSSSSSSSSSSS-----------------------------------
-----------------------------------------------------------------------------------------------SSSS-------------------------------------------------------------
--------oooo---------------------------------------------------oo------------------------------SSSS-------------------------------------------------------------
--------XXXX--------------------SSSS----------------------oo--XXXX------XXX--------------------SSSS-------E-----------------------------------------------------
-------------------------------------------------------------------o-----------------XXX-----------------<>-----------------------------------------------------
-------------------------------E----------------------------------XXX---o-o------oo----------------------[]--------------------------------oo-------------------
-------------------<>---------------------------------------------------o-o-XXXXXEXX------------o--------[]--------------------------------oo----------------E--
S----------------?-[]--------S?S---ES-------------------XX--XX---------------------------------S?SS----SS[]SS---------<>--------XXXXXXX--------X----------------
----XX-?------<>---[]-------------<>-----------------------------------------------------------SSS-------[]-----<>----[]----XXX---------------------------------
--------------[]---[]-------------[]-----------------------------XXXXX-------------------------SS--------[]-----[]----[]----XXX----------XXXXX------------------
--------------[]---[]-------------[]-------------------------------------------------------------E-EE-E--[]-----[]----[]----XXX----------X-------------------XXX
XXXX---XXXXX-XXXXXXXXXXXXXXXXXXXXXXXXXXXXXXXXXXXXXXXXXXX----------------------------------XXXXXXX-XXXXXXXXXXXXXXXXXXXXXX----XX-----------X-------------------X--