---------------------------------------------------------XX<>XXXXXXXXXXXXX-X-XXXXXXXXXXXXXXXXXXXXXXXXXXXXXXXXXXXXX--XXXXXXXXXXXXXX------------------X-----------
------------------------------------------------------------------E----------------------------[]------XXXXXXXXXXX----[]--E------XXXXXXXXXXXXXXXXXXXX-----------
------------------------------------------------------------------------------------B----------[]-------XXXXXXXXXX----[]----------------------------------------
-----------------------------------------------------------------------------------------------<>--------XXXXXXXXX----[]----------------------------------------
-------------------------------------------------------------------SSSSSSSSS-----------Q------------------XXXXXXXX----<>----------------------------------------
--------------------------------------------------------------------E--------------------------------------XXXXXXX-----E----------QQ----------------------------
----------------------------------------------------------------------------------------------------------------------------------------------------------------
-------------------------------------------------------------------------------------------oo------------------------------------------------------------------X
-------------------------------------------------------------------SSSSS?SSS-------------------------------------------------------?Q--------------------S------
----------------------------------------------------------------------------------------------------------------------------------------------------------------
----------------------------------------------------------------------------------------------------------------------------------------------------------------
---------<>---------------------------X----XXXXX------------------------------------------------------SSSSSSSSSSS?SSSSSSSSSS------------------------------------
---<>----[]----------------------------------------E------------------------------------------------------------------------------------------------------------
---[]----[]---------------------------------------<>-----------------------------------------------------------------------------------------------------X------
---[]----[]---------------------------------------[]-----------------------------------------------------------------------------------------------------X------
XXXXXXXXXXXXXXXXXXXXXXXXXXXXXXXXXX--XXXXXXX-------XX-----------------------------------------------------------------------------------------------------X------