----------------------------------------------------------------------------------------------------------------------------------------XXXXXXXXXXXXXXXXX-------
-------------------------------------------------------------------------------------------------------------------------------------------------b--------------
-------------------------------------------------------------------------------------------------------------------------------------------------B--------------
----------------------------------------------------------------------------------------------------------------------------------------------------------------
-------------------SSSSSSSSSSSSSSSSSSSSSSSSS------------------------------------------------------------XX----------------------------------o-------------------
---------------------SSSSSSSSSSSSSSSSSSSSSSS------------------------------o---------------------------------XX-------------------------------oo------o----------
---------------------SSSSSSSSSSSSSSSSSSSSSSS-----------------------------XXX------------------------------------------------------------------------------------
---------------EXX---SSSSSSSSSSSSSSSSSSSSSSS---------------------------------o-------------------------------------------XXXXXXXXXX-----------------------------
--------------EXXX---SSSSSSSSSSSSSSSSSSSSSSS--------------o---o---o---o------XXX-------------------S------------XX----------------------------------------------
-------------EXXXX---SSSSSSSSSSSSSSSSSSSSSSS-------------XXX-XXX-XXX-XXX----------XXXXXXXX-----------------o-o--------------------------------------------------
-------------XXXXX---SSSSSSSSSSSSSSSSSSSSSSS---------------------------------------------------------------o-o------XXX-----------------------------------------
-------------XXXXX---SSSSSSSSSSSSSSSSSSSSSSS----<>----------------------------------------------<>--------------------------------------------------------------
-------------XXXXX---SSSSSSSSSSSSSSSSSSSSSSS----[]----------------------------------------------[]--------------------------------------------------------------
-------------XXXXX---SSSSSSSSSSSSSSSSSSSSSSS----[]----------------------------------------------[]-X------------------------------------------------------------
-------------XXXXX---SSSSSSSSSSSSSSSSSSSSSSS----[]----------------------------------------------XX-X--------------------------------------------------------XXXX
XXXXXXXXXXXXXXXXXXXXXXXXXXXXXXXXXXXXXXXXXXXXXXXXXXXXXXXXXXXXXXXXXXXXXXXXXXXXX-------------------XX-X------------------------------------------------------------