-----------------------XX-----XXXXXXXXXXXXXXXXXXX---------XXXX----XXX-------------------------------X-XXXXXXXXXXXXXXXXXXXXXXXXXXXXXXXXX------X---XXXXXXXXXXXXXXX
------------------------------X------E-----------------X---------------------------XXXXXX-----------X-----X------[]--[]-[]--------XXXXX----------------oooSSSSSS
-------------------------------------------------------o-----------------------XX-------------------XX----X------[]--<>-[]---------XXXX-----------SSSSS---SSSSSS
-------------------------------------------EE-------------------------------------------------------XX----X------<>---E-<>---------EXXX-----------SSSSS---SSSSSS
-------------------------XXX---??SSSSSSSSS--SSSSS-XXXX--------------------XXX-----------------------XX------------ES---------XXX-----XX-----------SSSSSS??SSSSSS
------------------------------E?ooooooooSS---E-------------------------------------------------------------------------------[]-------XS----------------?-------
------------------------------S---------SS-----------------------------------------------------------------------------------<>---------------------------------
------------------------------S---------SS------------------------------------E---------------------------------------------------------------------------------
------------------------------SSSSSSSS--SS-----------------------------------------------------------SSSSSSSSSSSSSS-----------------------------SSSSSSSSSSSSSSSS
------------------------------SSSSSSSSSSSS--SS----------XX-----------XXX-----------------------------------E-----------------------------S------SSSSSSSSSSSSSSSS
--XXXXXXXX--------------------SSSSSSSSSSSS--SS--------------------------------------------------------------------------------------------------SSSSSSSSSSSSSSSS
------------------------------SSSSSSSSSSSSSSSSSSS-------------------------------------------XXXXX-----------------------------------------SSSSSSSSSSSSSSSSSSSSSS
----------------------------------------------------------------------------------------------------------------------------------------------------------------
----------------------------------------------------------------------------------------------------------------------------------------------------------------
-----------XXXXXXEEX--------------------------------------------------------------------------------------------------------------------------------------------
X---------------------------------------------------------------------------------------------------------------------------------------------------------------