------------------------------------------------------------------------------------------------XXXXXXXXXXXXXXXXXXXXXXXXXXXX----XX--XXXXXXXXXXXXXXXXXXX---------
------------------------------------------------------------------------------------------------XXXXXXXXXXXX--[]---[]-----XX----------------X-E-E---------------
-----------------------------------------------------------------------------------------------------[]XXXXX--<>---[]------XXX--------------X-------------------
-----------------------------------------------------------------------------------------------------[]XXXXX-------[]-------XXXX--------------------------------
-----------------------------------------------------------------------------------------------------[]XXXXX-------<>---------XXXX--SSSS-------------Q----------
-------------------------------------------------------------------------------------------------XSSS[>XXXXX----------------------------------------------------
----------------------------------------E-----------------------------------X--------------------X-EE<E-XXXX----------------------------------------------------
---------S-----------------------------------------------------------------------------------------------XXX--------------------------------------------------X-
----------------------------------------------------------------------------------------------------------XX-------------------SS------------------------E------
----------------------------------------------------------------------------------------------------------------------------------------------------------------
--------S-------------------------------------<>----------------------------------------------------------------------------------------------------------------
----------------------------------------------[]------------------------------------------------------------------------SSSS------------------------------------
---------------------------------B------------[]----------------------------------------------------------------------------------------------------------------
---------E----B------------------b---<>-------[]-------E---------E----------------------------------------------------------------------------------------------
---------------------------------BEE-[]------XXXXXXXXX<>XXXXXXXX<>XXXXXXXXXXXXXXXXXXXX--------------------------------------------------------------------------
XXXXXXXXXXXXXXXXXXXXXXXXXXXXXXXXXXXXXXXXXX---XXXXXXXXX[]XXXXXXXX[]XXXXXXXXXXXXXXXXXXXX------------------------------------------------------------------------X-