------------------------------------------------------------------XX----XXXXXXXXXXXXXXXXXXXXXXXXXXXXXXX<>XXXXXXXXXXXXXXXXXXXXXXXXXXXXXXXXXX--XXXXXX-XXXXXXXXX---
-------------------------------------------------------------------X----------------E-[]--------[]---------E--[]--------XXXXB----------------------------------X
--------------------------------------------------------------------------------------[]--------[]------------[]--------XXXX------------------------------------
--------------------------------------------------------------------------------------[]--------<>------------[]--------XXXX------------------------------------
-------------SSSSSSSS-----------------------------------------------------------------<>------------?---------<>--------XXXX-------o------XXX-------------------
------------------------------------------------------------------------------------------------------------------------XXXX-----oo-----------------------------
------------------------E-----------------------------------------------------------------------------------------------XXXX------------------------------------
-----------------------<>----------------------------XXX----------------------------------------------------------------XXXX------------------------------------
-----------------------[]-------------------------------------------XXX-------------------XX--------Q-------------------XXXX----------XXXXX--XXXXXX-------------
-----------------------[]-----------------------------------------------------------------------------------------------XXXX--------------------ooo-------------
-----------------------[]-----------------------------------------------------------------------------------------------XXXX------------------------------------
------------------XXX--[]------------------------------XXXXXXXX----E----------------------------------------------------XXXX------------------------------------
<>---------------------[]------------------?QQ------------------------------------------------------------------------------------------------------------------
[]---------------------[]------------X--------------------------------------------------------------------------------------------------------------------------
[]---------------------XXXXXXXXXXXXXXX--------------------------------------------------------------------------------------------------------------------------
XXXXXXX-XXXXXXXXX------XXXXXXXXXXXXXXXXXXXXXXXXXXXXXXXXX--------------------------------------------------------------------------------------------------------