----------------------------------------------------X-----------------------------------------------------------------------------------------------------------
-----------------------------------XXXXXXXXXXXXXXXXXX-----------------------------------------------------------------------------------------------------------
----------------------------------------------------------------------------------------------------------------------------------------------------------------
----------------------------------------------------------------------------------------------------------------------------------------------------------------
------------------------------------------------------------------------------------------------------------------------------?---------------------------------
----------------------------------------------------------------------------------------------------------------------------------------------------------------
---------------------------XXX------------------------------------------------------------------------------------------------------------------------XX--------
----------------------SS------------------------------E-----------------------------------------X-SS---XX-------------------XXX--ooo------------E-----------XX--
-----------------------------------------------------------------------------------------------XX------------X-------------------ooo------------------------XX--
----------------------------------------------------------------------------------------------XXX-------o-------------------------------------------------XXXX--
--------------------SS-----------------------------------------------------------------------XXXXS------o-XX-------------XXXXXXXXX------------------------XXXX--
--------------X----------------------------------------------------------------E------------XXXXX--------------------------------------------------------XXXXX--
------<>------X---------------------------------------------------<>-----X-----X-----------XXXXXX--------------------------------------------------------XXXXX--
------[]------XX--------------------------------------------------[]-----B-----X----------XXXXXXX--------------------------------------------------------XXXXX--
------[]E-----XX--------------------------------------------------[]-------E---X----E----XXXXXXXX---------------XXXXXXX------------XXXXXXXXXXXE----------XXXXX--
XXXXXXXXXXXXXXXXXXXXXXX-X-----------------------------------XXXXXXXXXXXXXXXXXXXXXXXXXXXXXXXXXXXXXXX-X----------------------------------------------------XXXXXXX