----------------------------------------------------------------------------------------------------------------------X-X-X-X----------------X-X-XX--Bb---------
-------------------------------------------------------------------------------------------------------------------------------------------------XX-X-X-X-X-----
--------------------------------------------------------------------------------------------------------------------------------------------------X-X-X-X-X-----
----------------------------------------------------------------------------------------------------------------------X-X-X--X----------------------------------
----------------------------------------------------------------------------------------------------------------------------------------------X-----------------
-----------------------------------------------------------------------------------------------------------------X-------------------------------------------E--
----------------ooooo--------------------------------------------------------------------------------------X----------------------------------------------------
---------------XXXXXXX---------------XX--------XX--------------------------------------------X-X----------------------------X----X-X-X-X-X-X-----------------?--
-------------------------------------XX----------------------------------------------X--------------------------------------------------------------------------
-------------------------------------XX-----------------------------------------------XXXX--------E--X------------X---------------------------------------------
----------------------------------Q--XX----------------?----------------X---------------------------------X-X---------------------------------------------------
X--------SS--------------------------XXS-----------<>---------<E-------EX---------------------X---------------------------------X-X-X-X-X-X-E-------------------
X------------------------------------XX------------[]---------[>------XXX------------------------o-o------------------------------------------------------------
XX-----------------------------------XX------------[]----------------XXXX------------------------X-XX-----------------------------------------------------------
XX--------------------E----E-E-------XX------------[]---------------XXXXX--------------------------X------------------------------------------------------------
XXXXXXXXXXXXXXXXXXXXXXXXXXXXXXXXXXXXXXXXXXXXXXXXXXXXXXXXX<>XXXXXXXXXXXXXXXX--X---------------------o------------------------------------------------------------