----------------------------------------------------------------------------------------------------------------------------------------------------------------
----------------------------------------------------------------------------------------------------------------------------------------------------------------
-----------------------------------------------------------XXXX------XX-----------------------------------------------------------------------------------------
-----------------SSSSSSSSSSSSSSSSSSSSSSSSSSSSSSSSSSSSSS---------------------------------------------------------------------------------------------------------
---------------SS---------------------SSSSSSSSSSSSSS------------------------------------------------------------------------------------------------------------
--------------------------------------SSSSSSSSSSSSSS-----------XXXXXX--XX---------------------------------------------------------------------------------------
--------------------------------------SSSSS-SSSSSSSS----------------------------------?-------------------------------------------------?-----------------------
------------------SSSSS-----------------------------------------------------------------------------------------------------------------------------------------
------------------SSSSS--SSS-----------------------------------o-o-----o-------------------------------------------oooo-----------------------------------------
------------------SSSSS--SSS-----------------------E------oo----------------------E-----------------------------------------------------------------------------
------------------SSSSS--SSS?SS???????SS?----SSSSSSS---?-----------------------XXXXXXEX---------oo----------------------------------XXXEX-----------------------
-------------------------------SSSSSSS----->---------------------------------------------------o--o---------------------------------------XX------------<>------
---E-------------------<>------SSSSSSS----<]--------------------------------------------------------------X------X--------------------------------------[]------
-----------------------[]-----------------[]--------------------------------------------------------------X------X--------------------------------------[]------
----------------XXXXXXXXXXXXXXXXXXXXXXXXXXXXXXXXXXXXXXXX--------------------XX----------------------------X------X----------------------------X------X--[]------
XXXXXXXXXXXXXXXXXXXXXXXXXXXXXXXXXXXXXXXXXXXXXXXXXXXXXXXX--------------------------------XXXXXXXXXXXXXXXXXXXXXXXXXXXXXXXXXXXXXXXXXX------------XXXXXXXX--XXXXXXXX