------------------------------------------------------------------------------------------------------------------------------------------------------XXXXXXXXX-
------------------------------------------------------------------------------------------------------------------------------------------------------SSSSSSSSS-
------------------------------------------------------------------------------------------------------------------------------------------------------SSSSSSSSS-
---------------------------------------------------------------------------------------------------------------------------------------------------SSSSSSSSSSSS-
-----------------------E-------------------SSSSSSSSSSSSSSS---------------------------------------------------------------------------------------------SSSSSSSS-
------------------------------------------------------------------------------------------------------------------------------------------------------SSSSSSSSS-
-----------------------------------------------------------------E---------------------------------------------E---------------------------------E----SSSSSSSSS-
-------------?---------------------------------------------------S-----------------------------------------SSSSSSSS-------------S---------------------SSSSSSSSS-
--------------------------------------------------------------------------------------------------------------------------------------------XX--------SSSSSSSSS-
------------------<>---------------------------------------------?------------------------------------------------------------------------------------SSSSSSSSS-
------------------[]--------------X---------------------------------------------------------?QQQQQ?------------E-----------S--------------------------SSSSSSSSS-
-------QQQQ--Q----XXX---------------X--------------------------------------------------------------------X?----QQ?QQ-----XS----QQQQQQ-----------------SSSSSSSSS-
----------------------------<>-----XX--------E-----------E-------X--------------------------------------XX---------------X--------------------------------------
----B--E--------------------[]----XXX-------<>--<>------<>-------X-------------------------------------XXX---------------X--------------------------------------
-----------------------XXXXXXXXXXXXXX-------[]--[]------[]-------X---------EXXXXXXXXXXXXXXXXXXXXXEXXXXXXXX--------------EX--------------------------------------
XXXXXXXXXXXXXXXXXXXXXXXXXXXXXXXXXXXXXXXXXXXXXXXXXX----XXXXXXXXXXXXXXXXXXXXXXXXXXXXXXXXXXXXXXXXXXXXXXXXXXXXXXXXXXXXXXXXXXXXXXXXXXXXXXXXXXXX----------------------