-------------------------------------------------XXXXXXXX-XXXXX--------------XXXX-------------------------------------------------------------------------------
--------------------------------------------------------X---XX--------------------------------------------------------------------------------------------------
--------------------------------------------------------X----X--------------------------------------------------------------------------------------------------
--------------------------------------------------------X-----------------------------------------------------------------------------------------------------SS
-------------------------------------------------------------------XXX---XXX----------------------------------------------------------------------------------[]
------------------------------------------<>------------------------------------------------------------------------------------------------------------------[]
-XX---------------------oooo--------------[]------------------------------------------------------------------------------------------------------------------<>
-[]--------------------XXXXX--------------XX--------------------------------------------------------------------------S-----------------------------------------
-[]------------------------------------------------------------------------------------------------------------------------------------------------------------E
-[]----------------------------------------------------------------------o-o--------------------------------------------------------------------------E---------
-<>SSSSSS----------------------------------------------------------------o---------------------ooo-----------------------------------------------------XX----<>-
----------------E--X----------------Q-------------------------------------------------------------------------------QQQQ-------------------------------------[]-
--E------------<>-XX----------------------------------------------------------------[>------<>------------------------------------------------X--------------[]-
----E----------[]-XX----------------------------------------------------------------[]-<>---[]-------------X----------------------------------X--------------[]-
XXX<>XXXXXXXXXXXXXXX------------E---------------------------------------------------[]-[]---[]-------------X--------------------------------E-X----------oXXXXXX
XXX[]XXXXXXXXXXXXXXXXXXXXXXX-XXXXXXXXXXXX-------------------------------------------XXXXXXXXXXXXXXXXXXXXXXXXXXXXXXXXXXXXXXXXXXXXXXXXXXXXXXXXXXXXXXXXXX---XXXXXXX