----------------------------------------------------------------------------------------------------------------------------------------------------------------
----------------------------------------------------------------------------------------------------------------------------------------------------------------
----------------------------------------------------------------------------------------------------------------------------------------------------------------
------------------ooo-------------------------------------------------------------------------------------------------------------------------------------------
------------------o-o----------------------------------------------------------------------oo------------------------------------------------------SSSSSSSSSSSS-
----------------------------------------------------------------------------------------------------------------------------------------------------------------
------------------XXX--XXXXX---------------------------------------E--------------------------XXX----------------XX---------------------------------------------
--------X----------------------XXXXXXX-------S---------------------S--------oooo--------------------------------------------------------------------------------
----------------------------------------------------------------------------o--o------------------------E-------------------------------------------------------
-------------------------------------------------------------------?------------------------------E-------------------------------------------------------------
------------------------------------------------<------------------------------XXXXXXXXXXXXXXX------XXXXXXXXXXXX------------------------------------------------
-----------------------------------------------X[----------S?S-------X-----------------------------------------------------------------B---------------------XXX
--------------------------------------------E-XX[------------------X-X---XXX-----------------------------------------------------------b--------------<>----EXXX
----------------------------------------X--XXXXX[>-----------------X-X-----------------------------------------------------------------B--------------[]---XXXXX
----------------------------------------X-XXXXXXX]-----------------X-X--------------------------------------------------------------------------------[]--XXXXXX
XXXXX---X----XX-------------------------XXXXXXXXX]-----XXXXXXXXX-XXXXXXXX--------------------------------------------XX--XX-XXXXXXXXXXXXXXXXXXXXXXXXXXXXXXXXXXX-