----------------------------------------------------------------------------------------------------------------------------------------------------------------
----------------------------------------------------------------------------------------------------------------------------------------------------------------
----------------------------------------------------------------------------------------------------------------------------------------------------------------
----------------------------------------------------------------------------------------------------------------------------------------------------------------
-----------------------------------------XXXXXXX----------------------------------------------------------------------------------------------------------------
----------------------------------------------------------------------------------------------------------------------------------------------------------------
------------------------------------------------------XXXXX---------SSSS----------------------------------------------------------------------------------------
---------------------------------------------------------------------[]----------------------------------------XX--SSSS--------------------------------XSSSSS---
----------------------------------XXXXXX-----------------------------[]---------------------------------------XXX--------------------------------------X--------
---------------------------------------------------------------------[]---------------------------------------XXX------------------<>------------------X--------
--------------X----------------------------------------------S?-<>---[]-------------------------------------<>XXX---E--------------[]-----------------EX--E-X---
--------<>----XS-X-----X----------------------------------------[]---<>--------------------------------X----[]XXX--SSSS------------[]------------------XSS?SX---
----<>--[]-------X-----X-E--------------------------------------[]-------------------------------------X----[]XXX----------------E-[]---<>------B---------------
----[]--[]----SSSX-----X-X--------------------------------------[]----E----------------------E---------X----[]XXX---------------<>-[]---[]------b---------------
----[]--[]-------------X-X-----------------------------------XXXXXXXXXXXXXXXXXX-XXXXXXXXX-XX<>XXXXXXXXXXXXXXXXXXX---------------[]-[]---[]----------------------
XXXXXXXXXXXXXXXXXXXXXXXX-X-----------------------------------XXXXXXXXXXXXXXXXXXXXXXXXXXXXXXX[]XXXXXXXXXXXXXXXXXXXXXXXXXXXXXXXXXXXXXXXXXXXXXXXXXXXXXXXXXXXXXXXXXX