------------------------------------------[]--------XXXXXXXXXXXXXXXXXXXX---XXXXXX--XX---XXXXXXXXXX-------XXXXXX--XX---------------------------------------------
------------------------------------------[]----------------EE----------------XXXX-[]---XXXXXXXXX-----------XXXX-[]---------------------------------------------
------------------------------------------[]-----------------------------------XXX-[]-----XXXXXXX------------XXX-[]---------------------------------------------
------------------------------------------<>-----------------------EE-----------XX-[]------XXXXXX-------------XX-[]---------------------------------------------
----------------------------XXX----------------------??SSSSSSSSSSS--SSSS-----------<>-------XXXXX----------------<>---------------------------------------------
-----------------------------------------------------?ooooooooooSS---E--------------E--------XXXX-----------------E---------------------------------------------
---------------SSSSS--XXX---------------------------S-----------SS---------------------------------------------------------------------E------------------------
----------------------------------------------------S-----------SS-------------------------------------------------------XX--XXX-----SSSSSS------------SSS------
----------------------------------------------------SSSSSSSSSS--SS----------------------------------------------------------------------------------------------
---------------------------------XXXXX--------------SSSSSSSSSSSSSS--SSSS----------------------------------------------------------------------------------------
-QQQ?Q---------SSSSS--------------------------------SSSSSSSSSSSSSS--SSSS---------------------------------------------------------------E------------------------
----------------------------------------------------SSSSSSSSSSSSSSSSSSSSSSSSSSSSSSSSSSSSSSSSSS????SSSSSSSSSSSSSSSSSS-------------------QQ?QQQQQ----<>------X----
---------------------------------------------------------------------------------------------------------------------------------------------------[]---E--X--<>
---------------------------------------------------------------------------------------------------------------------------------------------------[]------X--[]
XXXEXEXXXXXXXXXXXXXX-----------------------------------------------------------------------------------------------------------------------------E-[]------X--[]
XXXXXXXXXXXXXXXXXXXX--------------------------------------------------------------------------------------------------------------XXXXXXXXXXXXXXXXXXXXXXXXXXXXXX