--------------------------------------------------------------------------------------------------------------------------------------------------------[]------
--------------------------------------------------------------------------------------------------------------------------------------------------X[]X--[]------
---------------------------------------------------------------------------------------------------------------------------------------------------[]---<>------
-----------------------------------------------------------------------------------------------------------------S---------------------------------<>-----------
-------------------SSSSSSSSSSSSSSSSSSSSSSSSSSSSSSSSSSSSSSSSSSSSSSSSSSSSSSSSSSSSSSSSSSSSSSSSSSSS????SSSSSSSSSSSSSSS----------------------------------E--------XXX
-------------------------------------------------------------------------------------------------------------SSSSS-------------------------------------------XX-
-------------------------------------------------------------------------------------------------------------SSSSS-----XX---------------------------------------
-------------------------------------------------------------------------------------------------------------SSSSS-----[]-------<>------------------------------
-------------------------------o---------o---o---------------------------------------------------------------SSSSS-----[]-------[]------------------------------
-------------------------------------------------------------------------------------------------------------SSSSS-----[]-------[]----------XXXXXX--------------
------------------------------S---------S---S-----------------------------------------------XXXXXX-----------SSSSS-----<>SSSSSSS[]------------------------------
-----X--------------------XX------XXXX-----------------------------------------------------XXXXXXX-------<>-----SS--------------[]------------------------------
--E--X--<>---------------XXXXX--XXXXXXXX--XX--XX--------------------XX---------XXX--------XXXXXXXX-------[]-----SS------E-------[]------------------------------
-----X--[]--------------XXXXXX--XXXXXXXX--XX--XXXX----------------XXXXXX-----------------XXXXXXXXX-------[]-----SS--------E-----[]-----<>-----------------------
-----X--[]-------------XXXXXXXE-XXXXXXXXE-XXE-XXXX--------------XXXXXXXX---------------XXXXXXXXXXX-------[]-------XXXXXXX<>XXXXXXXXXX--[]-----------------------
XXXXXXXXXXXXXXXXXXXXXXXXXXXXXXXXXXXXXXXXXXXXXXXXXXXXXXXXXXXXXXXXXXXXXXXXXXXX-----------XXXXXXXXXXXX---XXXXXXXXXXXXXXXXXXX[]XXXXXXXXXXXXXXX----------------------