------------------------------------------------XXXXXX-----------------XXXXXXXXXXXXXXXXXXXXXXXXXXXXXXXXXXXXXXXXXXXXXXXXXXXXXXXXX-XXXXXXXXXXXXXXXXXXXXXXXXXXX---X
-----------------------------------------------------------------------XXXXXXXXXXXXXXXXXXXXXXXEXEXXXXXXXXXXXXXXXXXXXXXXXXX-------------XXXXXXXXXXXXXXXXXXX------
---------------------------------------------------------------------------------------------------------------------------------------XXXX-----------XXXX------
---------------------------------------------------------------------------------------------------------------------------------------XXXX------------XXX------
----------------------------------------------------------------------------------------------------------------------------------------XXX-------------XX------
-----------------------------------------------------------XXXXXXXXXX---------------SS---QQQQQQ?Q--<>-------XSSSX-XSS?X-----------------XXX---------------------
---------------------------------SS----------------------------E-----------------------------------[]-------X---X-X---X-----------------XXX---------------------
---------------------------------------------------------------------------------------------------[]-------------X---X-------------------X---------------------
------------------------------------------XXXXX--------XXXX----------------------------------------[]-------------X--EX-------------------X-----------SS--------
--------------------------------o------------------------------------------------------------------[]-------------------------------------X-----------SS--------
--------------------------------XXXX---------------------------------------------------------------[]-------------------------------------------------SS--------
---------<>----------------------------------------------------------------------------------------[]-------------------------------------------------SSSSSSSSSS
-------<>[]---------------------------------------------------------------------------------------XXXX----------------------------------------------------------
-------[][]-----------------------------------------------------------------------------------------------------------------------------------------------------
-------[][]------------<XXXXX-----------------------------------------------------------------------------------------------------------------------------------
XXXXXXXXXXXXXXXXXXXXX--[----------------------------------------------------------------------------------------------------------------------------------------