-------------------------------------------------------------------------------------------------------XXXXXXXXXXXX---------XXX---------------------------------
---------------------------------------------------------------------------------------------------------------[]-X---------ooo---------------------------------
---------------------------------------------------------------------------------------------------------------[]-----------------------------------------------
---------------------------------------------------------------------------------------------------------------[]-----------------------------------------------
-----------------------X---------------------------------------------------------------------------------------<>--------------XXXX-----------------------------
----------------------------------------------------------------------------------------------------------------------------------------------------------------
---------------------------E-----------X-----------------------------------------------------------------------------XXXXXX---------X---------------------------
--XXX-----------SSS----------------------------------------------------------------------------XXXoo-----------------------------------------------XSSSSS-------
-------------------------------------------E--oo-----------------------------------------------------------------------------E----------XXX--------X------------
----------------------------------------------SS--------------------------X------------------------------------------------------------------------X------------
-------------------------------------------------------------------------XX-----------------------------------------------------------------------EX--E-X-------
----------------XXXX----------------------------------------------------XXX------------------------------------------------------------------------XSS?SX-------
--------------------X--X----------------------------------------------EXXXX-------------------------------------------------------------------------------------
---------------X------------------------------------------------------XXXXX-------------------------------------------------------------------------------------
-------------X-X------------XXXXXX-XX--------------------------------XXXXXX-------------------------------------------------------------------------------------
X----XXXXXXXXX-XXX----------XXXXXX-------------XX--XXXXXXXXXXXXXXXXXXXXXXXXXXXXXXXXXXXXXXXXX---------------------------------------------XXXXXXXXXXXXXXXXXXXXXXX