-------------------------------------------XXXX--XX--XXXXXXXXXXX[]XXXXXXXXXXXXXXXXXX------XX--XXXXXXXXXXXXXXXXXXXXXXXXXXX---------X-----------------------------
-------------------------------------------------[]--XXXXXXXXXXX<>XXXXXXXXXXXXXXXXXXXX--------------------------------------------------------------------------
-------------------------------------------------[]--[]----------E----------------XXXXXX------------------------------------------------------------------------
-------------------------------------------------[]--[]--------E---------------------XXXXX----------------------------------------------------------------------
---SSSS---------------SSSSSSSSSSS----------------<>--[]---------------------------------XXXX--SSSSSS-------E?QQQ--------XXXX------------------------------------
----------------------SSSS---------------------------[]-------<>SSSSSSSSX---------------------------------------------------------------------------------------
----------------------SSSS---------------------------[]-------[]--------X---------------------------------------------------------------------------------------
----------------------SSSS---------------------------[]-------[]---------------------------------------------------------------XX-------------------------------
-------------------------------------XSSS------SSSSS-<>-------[]-------------------------SS-----------------QQQQ----XXXXX---------------------------------------
------------------------------------XXX-----------------------XX-------------------------------------------------------------E----------------------------------
----------Q-------------E----------XXXS-------------------------------------------------------------------------------------------------------------------SSS?--
--------------E--------<>---------XXXXX-----------------------------------------------------------------------------------------------XX------------------------
------<>-----<>--------[]--------XXXXXX-SSS-------------------------------------------------------------------------------------------XX------------------------
------[]---------------[]-------XXXXXXX-----------------------------------------------------------------------------------------------XXX-----------------------
------[]---------------[]---E--XXXXXXXX-----------------------------------------------------------------------------------------------XXX-----------------------
XXXXXXXXXXXXXXXXXXXXXXXXXXXXXXXXXXXXXXXXX---------------------------------------------------------------------------------------------XXXXXXXXXXXXXXXXXXXXXXXXXX