-------------------------------------------------------------------------------[]----[]----X------------------------XXXXXXXXXXXXXXXXXXXXXXXX--------------------
-------------------------------------------------------------------XXXXXEEX----[]----[]----X--XXXXXXXXXXEEXEXXXXXX-----XXXXXXXXXXXXXXXXXXX----------------------
-------------------------------------------------------------------------------<>----[]----XXX-------------------------------[]----XXXXXXX----------------------
--------------------------------------------------------------------------------E----[]--------------------------------------<>-----XXXXXX-SSS------------------
-------------------------------------------------------------------------------------<>----------------------------------------------XXXXX----------------------
--------------------------------------------------------------------------------------E-----------------------------------------------XXXS----------------------
--------------------------------------------------------------------------------ooooooo------------------------------------------------XXX----------------------
-------------------SSS--SS---------------------------------E--------o-----------ooooooo-------------------------------------------------XSSS--------------------
----------------------------------------------------------------------------------------------------------------------------------------------------------------
------------------------------------------------------------------------------X---XX----------------------------------------------------------------------------
-----?----------------------XXX-------oo------------------------------------------------------------------------------------------------------------------------
-<>----------SS--------X-------------------X-----------X--------------------------------------------------------------------------------------------------------
-[]--------------E--E--X-------------------X-<>--------X-------------------------------------------------------------------------------------------------<>-----
-[]-------------<>-----X-------------------X-[]--------X-------------------------------------------------------------------------------------------------[]-----
-[]-------------[]-----X-------------------X-XXXXXXXXXXXXXXXXXX------------------------------------------------------------------------------------------[]-----
XXXXXXX<>XXXXXXXXXXXXXXXXXXX------XXXXXXXXXX-XXXXXXXXXXXXXXXXXX-------------------------------------------------------------------------------XXXXXXXXX--[]XXXXX