----------------------------------------------------------------------------------------------------------------------------------------------------------------
----------------------------------------------------------------------------------------------------------------------------------------------------------------
----------------------------------------------------------------------------------------------------------------------------------------------------------------
----------------------------------------------------------------------------------------------------------------------------------------------------------------
----------------------------------------------------------------------------------------------------------------------------------------------------------------
----------------------------------------------------------------------------------------------------------------------------------------------------------------
----------------------------------------------------------------------------------------------------------------------------------------------------------------
----------------------XX--------------------------------E---------------------------------------?--SS-----------------------------------------------------------
---------------------XXX-------------------------------<>-------------------------------------------------------------------------------------------------------
--------------------XXXX-------------------------------[]----------------------<>------------------------------------------------------------o-o---------X-X----
-------------------XXXXX---------------------B---------[]----------------------[]---------------X-----X-----------------------------------------------E---------
------------------XXXXXX---------------------b--------SXXS----------------S----[]-----ooo-------XS----XQQQQ---------------------------------o-o---------X-X-X---
------------------XXXXXX----------------?-B----------------------------------E-[]--E-------------------------<-------------------<-----------------------------<
------------------XXXXXX------------------b---------------------------------<>-[]-------------------------->-[-------------------[-----------------------------[
------------------XXXXXX----------------------------------------------------[]-[]-------------------------->-X>X-X-X-X-X-X-X-X-X-X>X-X-X-X-X-X-X-X-X-----------[
XXX--XX-XXXXXXXXXXXXXXXX----XXXXXXXXXXXXXXXXXXXXXXXXXXXXXXXXXXXXXXXXXXXXXXXXXXXXXXXXXXXXXXXXXXXXXXXXXXXXX-<Q--]X-X-X-X-X-X-X-X-X-X]X-X-X-X-X-X-X-X-X-X----------