-----------------------------------------------------------------------------------------------------------------------XX---------------------------------------
-----------------------------------------------------------------------------------------------------------------------[]---------------------------------------
-----------------------------------------------------------------------------------------------------------------------<>---------------------------------------
------------------------------------------------------------------------------------------------------------------------E--------------------------------SSSS---
-----------------------------------------------------------------------------------------XXXX-----------------------------------------XXX-----------------------
-----------------------------------------------------------------------------------------XXXX-------------------------------------------------------------------
-------------------------------------------E---------------------------------------oo----XXXXE---------------------E--------------------------------------------
------------------------------------SSS?SSSSSSSS-------XQQ?QQX---------------------------XXXXQS--XXXoo---SSSS---E----------------------------------E------------
-------------------------------------------------------X-----X---------------------------XXXX-------------------------------------------------------------------
-------------------------------------------------------X-----X---------------------------XXXX-------------------------------------------------------------------
--E------------------------------------------E---------XE-E--X-------ooooo---------------XXXX------------SSSS---------------------------------------------------
----SSS--------S--------------------SSSSSSSSSSSS-------XQQ-QQX---------------------------XXXXQS-----------------------------------------------------------------
--------------------<>-----------E-------------------------------------------------------XXXX-------------------------------------------------------------------
--------------------[]---------------------------------------E-------------------------<>XXXX---------------------------------X--------------XXXXX--------------
--------------------[]E----------------------------------------------------------E-E---[]XXXX---------------------------------XX--------------------------------
XXXXXXXXXXXXXXXXXXXXXXXXXXXXXXXXXXXXXXXXX-XXX--XXXXXXXXXXXXXXXXXXXXXXXXX-XXXXXXXXXXXXXXXXXXXXXXXX-----------------------------XXX-------------------------------