---------------------------------------------XXXXXXXXXXXXXXXXXXXXXXXXXXXXXXXXXXXXX----------------------------XXX----------XXXXXXXXXXXXXXXXXXXX-----------------
---------------------------------------------XXXEXEXXXXXXXXXXXXXXXXXXXXXXXXXXXXXXX----------------------------ooo-----------------XXXXSSSSSSSSS-----------------
---------------------------------------------------------------XXXXXXXXXXXXX----[]--XX--XXX---------------------------------------XXXXSSSSSSSSS-----------------
----------------------------------------------------------------XXXXXXXXXXXX----[]------------------------------------------------XXXXSSSSSSSSS-----------------
-----------------------------------------------------------------XXXXXXXXXXX----[]-------------------------------XXX--------------XXXXSSSSSSSSS-----------------
----------------------------------------------QQQ?Q--<>-----------XXXXXXXXXX----[]-----------------------------------XXXXX--------XXXXSSSSSSSSS-----------------
-----------------------------------------------------[]-------------XXXXXXXX----<>--------------------XXXXXXX----------E----------XXXXSSSSSSSSS-----------------
-----------------------------------------------------[]--------------XXXXXXX-----E-------------E----------------------------------XXXXSSSSSSSSS-----------------
-----------------------------------------------------[]---------------XXXEXX--E--------------------------------E------------------XXXXSSSSSSSSS-----------------
------------X----------------------------------------[]------------------XXX--?----------------?----------------------------------XXXXSSSSSSSSS-------------E---
-----------XX----------------------------------------[]---------------------------------------------------------------------------XXXXSSSSSSSSS------------<>---
X---------XXX---------E------<>---XXXXEXX------------[]---------------------------------------------------------------------------XXXXSSSSSSSSS------------[]---
X--------XXXX--------<>------[]---------X-----------XXXX---------------------------------------------------------------------------------------------------[]---
XX------XXXXX--------[]---B--[]---------X--------------------------------------------------------------------------------------------------------------XX--[]---
XX----XXXXXXX--------[]-XXX--[]---------X------------------------------------------------------------------------------------------------------------------[]---
XXXXXXXXXXXXXXXXXXX--XXXXXX--XXXXX------X---------------------------------------------------------------------------------------------------------XXX------[]-XX