----------------------------------------------------------------------------------------------------------------------------------------------------------------
----------------------------------------------------------------------------------------------------------------------------------------------------------------
----------------------------------------------------------------------------------------------------------------------------------------------------------------
----------------------------------------------------------------------------------------------------------------------------------------------------------------
----------------------------------------------------------------------------------------------------------------------------------------------------------------
---------------------XX-----------------------------------------------------------------------------------------------------------------------------------------
--------------------EXX-----------------------------------------------------------------------ooo-------------------E-------------------------------------------
------------------XXXXX------------------XX-------------o-------------------------------------XXXX-----------------SSSSSSS-------SSSSS--------------------------
-----------------XXXXXX-----------------------------------------------------------ooo----oX---------------------------------------------------------------------
----------------XXXXXXX-------------------------------------------------E--------------XXXo---------------<>----------------------------------------------------
-------------XXXXXXXXXX---------------o-----------------XX------------------------------------------------[]-------------------------------Q--------------------
------------XXXXXXXXXXX--------SS--------------------------------------------------XXXX------------------QQQQQQQ---------ES----QQQQ--QQQ---------------------XX-
-----------XXXXXXXXXXXX----<>-------------------------------XXXXXXXXXXXXXXX---------------XXX?--------------------------<>------------------------<>--<>----XXX-
--------B--XXXXXXXXXXXX----[]------------------------XXX-----------X------X-----------XXXX------------------------------[]------------------------[]--[]----XXX-
--E--------XXXXXXXXXXXXXX--[]--------------------------------------X------X-XXXXXXX---------------E---------------E-----[]------------------------[]--[]E---XXX-
X--XXXXXXXXXXXXXXXXXXXXXXXXXXXXXXXXXXXXXXXXXXXXXXXX----------------X------X-X----------------XXXXXXXXXXXXXX-X-XXXXXXXXXXXXXXXXXXXXXXXXXXXXXXXXXXXXXXXXXXXXXXXX--