------------------------------------------------------------------------------------------------XXXXXXXXXXXXXXXXXXXXXXXXXXXXXXXXXXXXXXXXXXXXXXXX----------X---X-
------------------------------------------------------------------------------------------------XXXXXXXXXXXXXXXXXXXXXXXXXXXXXXXXXXXXXXXXXXXXXXXX----------X---X-
--------------------------------------------------------------------------------------------------]------------------[]----E----------------XX-X----------X-----
-----------------------------------------------------------------------------SSSSSSSSSS-----------]------------------<>----------------------X------------X-----
--------------------------------------------------------------------------------------------------]-----------------------<>------------------------------X-----
-------------------------------------------------------------------------------------------------->------------ooo--------[]------------------------------X-----
--------oooooo-----------------ooo-----oo-----------XXXXX--XXX-------------------------------------------------ooo--------[]-----------------------E------X-----
---SSSSSSSSSSSSSS---------------------XXXX--------------------------------------------------------------------------------[]------------------------------------
-------------------------------------------o----------------------------oo------------------------------------------------[]--------------------------XXXX---X--
--------------------------------XX--------XXX---------------------------SS------------------EX---------------------------SSSS-----------------------------------
------------------------oooo---------------------XX-------------XXXXXX------------------------------------------------------------------------------------------
--------?SSSSSSS------------o-----------------------------------------------------------------------------------------------------------------------------------
----E------------------------------------------------------------------------oooooooo---------------------------------------------------------------------------
---<>------------------------------XXX---XXXXX------------o------------------oooooooo---------------------------------------------------------------------------
---[]-------E----------------------------------X----------X------------------XXXXXXXX---------------------------------------------------------------------------
XXXXXXXXXXXXXXXXXXXXXXXXXXXXXXXXX----------------------------------------XX--XXXXXXXX---------------------------------------------------------------------------