-------------------------------------------------X---------------------------------------------------------------------------------------------XXXXXXXXXXX--XXXX
-------------------------------------------------X------------------------------------------------------------------------------------------------[][][]--------
-------------------------------------------------XXXXXX-------------------------------------------------------------------------------------------<>[][]--------
---------------------------------------------------------------------------------------------------------------------------------------------------E<>[]--------
------------------------------------------------------------------------------------SSS--[]SSS--------------------------------------------------------<>--------
---------------------------------------------S---------XXXXXXXXXX------------------------[]SSS-------------------------------------------------------------o----
---------------------------------------------------------------------------oo------------[]SSS---------------------------------------------XXX------------------
--------------------------------------------------------------------------XXXX-----------[]SSS--XXXX---XXXoo------------------------E---------------------------
-------------------------------------------------------o-----------------------o---------[]SSS-----------------------------------E------------------------------
------------------------------------------------------------------------------XXX--------[]SSS------------------------------------------------------------------
----------------------------E-------XXXXXX------------------------------------------------]SSS------------------------------------------------------------------
-----------------------QQQQQQQ------------------------------------------------------------]SSS------------------XX----------------------------------------------
------XXXXXXXXXXXXXXXXX-------------------------------------------------------------SSSSSSSSSS------------------XX-X--------------------------------------------
--------------------------------------------------------------------XXXXXX---XXXXX--SSSSSSSSSS------------------XXXX--------------------------------------------
----------------------------------XX--------------------------------X---------------SSSSSSSSSS------------------XXXX--------------------------------------------
XXXXXXXXXXXXXXXXXXXXXXXXX-<><>--------------------------------------X---------------XXXXXXXXXX------------------XXXXXXXXXXXXXX----------------------------------