----------------------------------------------------------------------------------------------------------------------------------------------------------------
----------------------------------------------------------------------------------------------------------------------------------------------------------------
----------------------------------------------------------------------------------------------------------------------------------------------------------------
------------------------------------------?---------------------------------------------------------------------------------------------------------------------
-----------------------------------------------------ooo--------------------------------------------------------------------------------------------------------
-----------------------------------------------------XXXX-------------------------------------------------------------------------------------------------------
-----------------------------------------XXXX----------------------------------------------------------------------------------X?-------------------------------
---------------------------------------------------------------------------------E-----------XXX-----------S---------------------ooo----------------------------
---------------------------------------------------------------------------------------------------------------------------------ooo----------------------------
----------------------------------------------------------------E---------XXX-----------------------------------------------------------------------------------
-------------------------------------------------------------------------------------------------------------------------------X-X------------------------------
--------QQQQ?QQ--------------------------------------------------------------------------------XXX--------------------QQQQQ-------------------------------------
----------------------E----------------X-----<-------XXXXXXXXXXXXXXXXXXXXXX--------------------------------<>--------------------------------------------XXXXX--
-----------------------------------<>--X-----[-------------------------------XXX--XX-----------------------[]------------------------------------------------X--
------EE---------------------------[]--X-----XEE----------------------------X------------------------------[]-------------X--------XXXXXXXXXXXXXXXXXXXXX-----X--
XXXXXXXXXXXXXXXXXXXXXXXXXXXXXXXXXXXXXXXX-----XXXXX----------------------------------------XXXXXX-------XXXXXXXXXXXXXXXXXXXX----------------------------------X--