--------XXXXXXXXXXXXXXXXXXXXXXXXXXXXXXXXXXXXX-------------------------------------------------------------------------------------------------------------------
--------XXXXX--X------------[]----------------------------------------------------------------------------------------------------------------------------------
--------XXXXX--X------------[]----------------------------------------------------------------------------------------------------------------------------------
--------XXXXX---------------<>-------------------------------------------------------------------------------------XXXX-----------------------------------------
--------XXXXX-------------------?--QQ-------------------------------------------------------------------------------[]------------------------------------------
--------XXXXX------------E-----------------------------------------------------------o------------------------------[]------------------------------------------
--------XXXXX-------------------------------------------------------------------------------------------------------<>------------------------------------------
--------XXXXX----------------------------------XXXXXX------------------------------SSS--------------------------------------------X-----------------------------
--------XXXXX-------------------Q------------------------------------------------------------------------------------E-----------XX-----------------------------
--------XXXX--------------------------------------------------------------------------------------------------------------------XXX-----------------------------
---X----XXXX-------------------------------------------------ooooo--------------------------------------------------------X----XXXX--------------------------ooo
--------XXXX------------------------------------------------XXXXXXX-----------------S------------------------------------XX---XXXXX-------XX--------------------
---------------------------------------------------------------------------------E------------------------------------<>XXX--XXXXXX------XXXX-------------------
--------------------------------------------------------------------------------<>------------------------------------[]XXX-XXXXXXX-----XXXXXX-----<>-----------
--------------------------------------------------------------------------------[]---E---------------------------X----[]XXXXXXXXXXXXXXXXXXXXXXX----[]----E------
XX----------------------------------------------------------------XXXXXXXXXXXXXXXXXXXXXXXXXXXXXXXXXXXXXXXXXXXXXXXX----[]XXXXXXXXXXXXXXXXXXXXXXXXXXXXXXXXXXXXXXXX