----------------------------------------------------------------------------------------------------------------------------------------------------------------
----------------------------------------------------------------------------------------------------------------------------------------------------------------
----------------------------------------------------------------------------------------------------------------------------------------------------------------
---------------------------------------------------------------------------------------------------------------------------------------S-S-S-S-S-S-S-S-S-S-S-S-S
------------------------------SSS------------------------------------------------------------------------------------------SSSSSSSSSSS-S------------------------
----------------------------------------------------------------------------------------------------XX---------------------SSSSSSSS--SSSS-S-S-S-S-S-S-S-S-S-S-S-
-----------------------------------------------------------------------------------------------------------------SSS-------SSSSSSSS--SS-S-----------------------
---------------------------------Q---------------------Q-------------SSSSSSS------------------------------------S----------SSSS--SS---S-S-----------------------
---------------------------------------oooo--------------------------------------------------------------------------------S-----SS-----------------------------
---------------------------------------------------------------------------------------------------------------------------S-----SS-----------------------------
----oo----------------------------------------------------------------E--E-------------------------o-----QQQSSSS-------E----?ooooSS----S---------------------E--
------------------------oo-------S---------------------?-------------SSSSSSS-------------XXXX-------------------------------??SSSSS--SE----S--->-------<--S-->--
------------------------------SSSS---X-------------<>-------------------------------------------------------------------------------EES-S--S---]-------[E----]--
------------------------------SSSS---X-------------[]--------<>----------------------B-----------------------------------------------------SS-<]-------[>---<]--
------------------------------SSSS---X-------------[]--------[]-----------------------------------------XXXEXXXXXXXXXXXX---------------X---XS-[X-------X]X-X[X-X
XXXXXXXXXXXXXXXXXXXXXXXXXX-X--XXXXXXXXXXXXXXXXXXXXXXXXXXXXXXXXXXXXXXXXXXX--XXXXXXXXXXXXXXX-----XX-------XXXXXXXXXXXXXXXX---XXXXXXXXXXX-X-X--SX[X-------X]X-X[X-X