-----------XXXXXXXXXXXXXXXXX-XXXXXXXXXXXXXXXXXXX--XXXXXXXXXXXXXXXXXXXXXXXXXXXXXXXXXX--XXXX---XXXXXXXXXXXXXXXX--XX-------------XXXXXXXXXXXXXXXXXXXXXXXXXXXXXXXXXX
---------------------------------------XXXXXXXXX----[]---[]----------------XXXXXXXXX----[]----[]---[]--E--XXXX-[]---------------XXXXXXXXX--b--------------[]----
----------------------------------------XXXXXXXX----[]---[]-----------------XXXXXXXX----[]----[]---[]------XXX-[]----------------XXXXXXXX--B--------------[]----
-------------------XXXXXXX---------------XXXXXXX----[]---<>------------------XXXXXXX----[]----<>---<>-------XX-[]-----------------XXXXXXX-----------------<>----
--------------o---------E-QQQQ------------XXXXXX----<>-------SSS--SSS---------XXXXXX----<>-----E----E----------<>--XXX-------------XXXXXX-------SSS---S?S---SSSS
---------------oo--------------------------XXXXX-------------SoS--SoS----------XXXXX-----E-------S--------------E--------------------XXXX--------E--------------
-------------------------------------------------------------S-SSSS-S------------------------------------------------------E---------XXXX---------------E-------
---------------------------------------------------------------------------------------------------------------------------------------XX-----------------------
---------------------------------------------------------------oooo--------------------------------------------------------------------XX-------SSS------SSSSS?S
------------------------------------------------------------------------------------------------------------------------E---------------------------------------
----------------------------------------------------------------------------------------------------------------------------------------------------------------
------------------------------------SSSSSSSSSSS?SSSSSSSSSSSSSSSSSSSSSSSSSSSSSSSSSSS?SSSSSSSSSSSSSSSSSSSSSSSSSSSSSSSSSS------------------------------------------
----------------------------------------------------------------------------------------------------------------------------------------------------------------
----------------------------------------------------------------------------------------------------------------------------------------------------------------
----------------------------------------------------------------------------------------------------------------------------------------------------------------
XXXX------------------------------------------------------------------------------------------------------------------------------------------------------------