----XX-XXXXXXXXXXXXXXXXXXXXXXXXXXXXXXXXXXXXXXXXXXXXXXXXXXXXX--XXXXXXXXXXXXXXXXXXXXXXXXXXXXXXXXXXXXXXXXXXXXXXXXXXXXXXXXXXXXXXXX----------------------------------
----[]-------------X---XXXXXXXXXXXXXXXXE----------------------XXXX--------------------XXXXXXXXXXXXXXXXXXXXXXXXXXXXXXXXXXXXXXXX---------------XXXXXXX------------
----[]-------------X----XXXXXXXX------------------------------XXXX----B------------XXX-------------------------------------XXX-----------------------------XX---
----[]-------------X-----XXXXXXX--oo--------------------------XXXX------------------XX--------------------------------------XXX---------------------------------
----<>-------------X------XXXXXX--oo-------------XSSSSS-------XXXX-----------------------------------------------------------XXXXX--XXXXXX----------------------
-------------------X-------XXXXX-----------------XEE---------oXXXX-----------------------ooo-----------ooo---------------------------------------X-----X--------
-------------------X--------XXXX-----------------X-----o------XXXX-----------------------ooo-----------ooo------------------------------------------------------
-------------------X---------XXX------------------------------XXXX----------------------------------------------------------------------------------------------
-------------------X----------XX------------------------------XXXXS-------------------------------------------------------------------------------------------E-
-------------------X-----------X-----------------SSS----------XXXX----------------------------------------------------------------------------------------E-----
--------------------------------------------------------------XXXX----------------------------------------------------------------------------------------------
--------------------------------------------------------------XXXX----------------------------------------------------------------------------------------------
----------------------------------------------------------------------------------------------------------------------------------------------------------------
----------------------------------------------------------------------------------------------------------------------------------------------------------------
----------------------------------------------------------------------------------------------------------------------------------------------------------------
XX--------------------------------------------------------------------------------------------------------------------------------------------------------------