----------------------------------------XXXXXXXXXXXXXXXXXXXXXXX--------------XXXXXXXXXXXXXXXXXXXXXXXXXXXXX-XXXXXXXXXXXXX[]X-X-X-X-X-X-X-X-X-X-X-X-XXXXX-X-XoXoXo
-------------------------------------------------------------------------------------------------XXXXX--[]--------------X>X-X-X-X-X-X-X-X-X-X-X-X-XXXXX-X-X-X-X-
--------------------------------------------------------------------------------------------------XXXX--[]--------------[-------------------------XXXXX----ooooo
------------------------------------------------------------------------------------------------E--XXX--[]--------------<-------------------------XXXXX---------
--------------------------------------------------------------XXXXX-----XXX-------QQ?--S------------XX--<>-----------------------S---------o------X-XXXS-S-SoSoS
-----------------------------------------------------------------------------------------------------X------------------------------------o---------XXX---------
--------------------------------------------------------------------------------------------------------------------------------------------o-------X-X-SES-S-S-
----------------------------------------------------------------------------------------------------------------------------------------------------------------
--------------------------------------------------------XXXXXXX----------------------SSS------------------------------------------------------------------------
------------------------------------------------------------------------------------------------------------------------------------------------------------E---
--------X---------------------------------------------------------------S---------------------------------------------------------------------------------------
---QQQQ-X-------------------------------------------------------------SS-SSSSS----------------------------------------------------------------------------------
----------------------------------------------------------------------------------------------------------------------------------------------------------------
B--E------------------X-----------------------------------------------------------------------------------------------------------------------------------------
----------------------XXXXXXXXXXXXX-----------------------------------------------------------------------------------------------------------------------------
XXXXXXXXXXXXXX--------X------------X----------------------------------------------------------------------------------------------------------------------------