----------------------------------------------------------------XXXXXXXXXXXXXXXXXXSSS---------------------------------------------------------------------------
----------------------------------------------------------------------------E-----SSS-----------------------------------------------X[]X------------------------
----------------------------------------------------------------------------------SSS------------------------------------------------[]-------------XXXXX-------
----------------------------------------------------------------------------------SSS------------------------------------------------<>-------------------------
-----------------------------------------------------------------------------------------------------X--------------------------------E----------------o--------
------------------------------------------------------------------------------------------------------------ooo----------------------------XXXXXXX--------------
------------------------------------------------------------------------------SXXX--------------------------XXX--------E----------------------------------------
------------------------------------------------------------------------------------------XXXXX---------------------------E----------------------------------XX-
-------------------oooo--------------------------------------XXX----------------------------------E-------------------------------------------------------------
--------------------------------------------------------------------------------------------------------------------------------XXXX----------------------------
----------------------------------------------------------XX--------------------------------------------------------------------------------------------XXXX----
<>--------------<>------------------------------Xooo------X----------------------------------------------------oooo--------------------------------------oo-----
[]--------------[]-----------------------------XX---------------------------------------------------------------------------------------------------------------
[]--------------[]-------<>-------------------XXX---------------------------------------------------------------------------------------------------------------
[]--------------[]-------[]--EXXXXXXXXXXXXXXXXXXX---------------------------------------------------------XXXXXXXXX---------------------------------------------
XXXXXXXXXXXXXXXXXXXXXXXXXXXXXXXXXXXXXXXXXXXXXXXXXXXX--------------------------------------------------------------X---------------------------------------------