------------------------------------------------------------------------------------------------------------X-------------------------------XXXXXXXXXXXXXXXXXXXX
------------------------------------------------------------------------------------------------------------XXXXX--XXXXXXXX-----------------XXXXXXXXXXXXXXXXXXXX
---------------------------------------------------------------------------------------------------------------------------------------------------------------E
----------------------------------------------------------------------------------------------------------------------------------------------------------------
---------------------SSSSSSSSSSSSSSSSSSSSSSSSSSSSSSSSSSSSSSSSSSSS------------?------------------------o--------------------------------------------QQQQQQQQ?----
-------------------------------------------------SSSS------------------------------------------------XXXX---E--------------XXXXXEX------------------------------
-------------------------------------------------SSSS-----------------------------------------------------------------------------------------------------------
-----XX------------------------------------------SSSS------------------------------------------------------------------------E----------------------------------
----XXX------------------------------------------S-----------------------------SS-------------------------------------------------------------------------------
---EXXX------------------------------------------S----------------------------------X--------------------------------------------?--XXXXXX----SSS---------------
--XXXXX----------------------E----------S--------So-------------------------S------XX--------------o------------------------------------------------------------
XXXXXXX-----X---------------<>--------E----E------S----XX-------------------------XXX---QQQQQ------oo-----------------------------------------------------------
XXXXXXX----XX------------XX-[]-------<>---<>----------EXX----E-------------------XXXX---------------------------------------------------------------------------
XXXXXXX---XXX-----?-----XXX-[]-------[]---[]---------XXXX---<>------------------XXXXX-----------XXXXXX----------------------------------------------------------
XXXXXXX--XXXX----------XXXX-[]-------[]---[]--------XXXXX---[]--E--------------XXXXXX-------X---XX--------------------------------------------------------------
XXXXXXXXXXXXXXXXXX-XXXXXXX--XX---XXXXXXXXXXXXXXXXXXXXXXXXXXXXXXXXXXXXXXXXXXXXX-XXXXXXXXXXXXXX---XX--------------------------------------------------------------