-----XXXXXXXX------XXXXXXXXXXXXXXXXXXXXXXXXXXXXXXXXXXXXX<>XXXXXXXXXXXXXXXXXXXXXXXXXXXXXXXXXXXXXXXXXXXXXXXXXXXXXXXXXX--XXXXXX------------------------------------
------------------------XXXXXXXX------------------[]-----------------------E------------E--[]------------------------------X------------------------------------
----------E----------E---XXXXXXX------------------[]---------------------------------------[]-------------------------------------------------------------------
--------------------------XXXXXX------------------[]---------------------------------------<>-------------------------------------------------------------------
----?----------------------XXXXX-------E?---------<>----------QQQQQQ-------------------S--------------------------Q?SSQQQQQQ-----------------XXXXXXXX-----------
---------S-----------?------XXXX----------------------?------------------------------------------oo-----------ooo---------------XXXXEEXXXXX---------------------
----------------------------XXXX--------------------------------------------------------------------------------------------------------------------------------
----------------------------XXXX--------------------------------------------------------------------------------------------------------------------------------
----------S----XXXX---------XXXX--------Q----------------------QQQQ---------SSSSSSSSSSSSS--------------------------QQQQ-----------------------------------------
----------------------------XXXX---------------------------------------------E--------------------------------------------------XXXXXEXXXXX---------------------
----------------------------XXXX--------------------------------------------------------o-----------------------------------------------------------------------
----------------------------XXXX------------------------------------------------------------------------------------------------------E-----------------XXX-----
----------------------------------------------------------------------------------------------------------------------------------------------------------------
--------------------------------------------------------------------------------------------------------------------------------------------------------------XX
--------------------------------------------------------------------------------------------------------------------------------------------------------------X-
XX------------------------------------------------------------------------------------------------------------------------------------------------------------X-