---------------------------------------------------------------------------XXXXX-XXXX------------------XXXXXX-XXXXXXX-------------------------------------------
---------------------------------------------------------------------------------[]---------------------------------------------------XXXX-XXXEEX---------------
---------------------------------------------------------------------------------[]--------------------------?--------------------------------------------------
---------------------------------------------------------------------------------[>------------------------------------SSSS-------------------------------------
---------------------------------------------------------------------------------[--------------------------------------------------------X---------------------
---------------------------------------------------------------------------?-----<------------------------------------------------------------------------------
-----------------------------------------------------------------------------------------------oo----------------------------------------------------------XXX--
--------------E--------SQS---------------------S-----------------------------------------------------------------------------------------oo---------------------
-----------S-------------------------------------------------S-----------o---------------------------------------------------XXXXX-------------------E----------
-------------------------------------------------------------------------o--------------------------------------------------------------------------------------
------------------------------------------------------------------------o-----------------------------------------------<>-X------------------------------------
---B---XXX-------------S?S--------------------------QQ------------------o-----------------------XX----------------------[]--------------------------------------
---b-------------------------------------E-----<>-----------------------------------------------------------------------[]--------------------------------------
---B-------X--------X--------------------------[]------------X--<>------------------------------------------------------[]--------------------------------------
-----------X-------XX--------------------------[]------------X--[]------------------------------------------------------[]--------------------------------------
XXXXXXXX---X-----XXXXXXXXXXXXXXXXXXXXXXXXXXXXXXXXXXXXXXXXX---X--[]----------------------XXXX----------------------------[]--------------------------------------