--------------------------------------------------------------------------------------------------------------------------------------XXXXXXXXXXXXXX------------
---------------------------------------------------------------------------------------------------------------------------------XXX--XXXXXXXXXXXXXX------------
--------------------------------------------------------------------------------------------------------------------------------------------X-----[]------------
--------------------------------------------------------------------------------------------------------------------------------------------X-----[]------------
-----------------------------?-------------------------------------------------------------------------------------XX-----------------------X-----[]------------
----------------------------------------------------------------------------------------------------------------------------XXXXXX----------------[]------------
----------------------------------------------------------------------------o------------E-----------------------X--------------------------------<>------------
---------------------------------------------------------------------XXXXX----------SSSSSQS--------------------------------------------------------E------------
-------------------------------SS-------------------------------------------------------------------------------------XX------------------------E---------------
--------------------------------------X---------------------------------------------------------------------------------------------------------?---------------
------oooo----------o-----SSS--------XX----------------------Q--------------------------------QQQQ-------------------------------------------------------XXXXXXX
----------------------------------X-XXX----------------------------------XXXX----------SSQS---------------------------------------------------------------------
---------------------------------XXXXXX-----E----------------------------------------<>---------E---------------------------------------------------------------
--------------------------------XXXXXXX----------------------------------------------[]------X------------------------------------------------------------------
-------------------------------XXXXXXXX----------------------------------------------[]-----XXXXXXXXXXXXX-------------------------------------------------------
XXXXXXXXXXXXXXXXXXXXXXXXXXXXXX-XXXXXXXXXXXXXXXXXXXXXXXXXXXXXXXXXXXXXXXXXXX-----XXXXXXXXXXXXXXXXXXXXXXXXXXX------XXXX--------------------------------------------