----------------------------------------------------------------------------------------------------------------------------------------------------------------
----------------------------------------------------------------------------------------------------------------------------------------------------------------
----------------------------------------------------------------------------------------------------------------------------------------------------------------
-------------------------------------------------------------------------------------XXXX-----------------------------------------------------------------------
--------------------------------------------------------------------------------------[]------------------------------------------------------------------------
--------------------------------------------------------------------------------------[]------------------------------------------------------------------------
--------------------------------------------------?-----------------------------------[]------------------------------------------------------------------------
----------------------------------?Q--------E-------------------o-o-------------------[]-------------------------------X--EX------------X-----------------------
--------------------------------------------------E-----------------------------------[]-------------------------------X---X-----------XX-----------------------
--------------------------------------------------------------------------------------[]--------------------X-EE-----X-X---X----------EXX-----------------------
---------------------------------QQ-----------------------------XXXX-------QQQQQQQ?Q--<>--------------------XSSSSSSSSX-XSS?X---------XXXX-----------------------
---------------QQQQ----------------------------------------------------------------------------X------------------------------------XXXXX-----------------------
-----------------------------------------------------------------------------------------------X-----------------------------------XXXXXX-----------------------
------------B--E------------------------------------------XXXXXX-------------------------------X----------------------------------XXXXXXX-----------------------
-----------------------------X--XXXXXXXXXX----------------X---------------XXXXXXXEXEXXXXXXXXXXXXXXXXXXXXX--XXXXXXXXXXXXXXXXXXXXXXXXXXXXXX-----------------------
XXXXXXXXXXXXXXXXXXXX<>XXXXXXXX--X-------------------------X---------------XXXXXXXXXXXXXXXXXXXXXXXXXXXXXXX--XXXXXXXXXXXXXXXXXXXXXXXXXXXXXXXXXXXXXXXXXX--XX-XXXXXX