----------------------------------------------------------------------------------------------------------------------------------------------------------------
----------------------------------------------------------------------------------------------------------------------------------------------------------------
----------------------------------------------------------------------------------------------------------------------------------------------------------------
----------------------------------------------------------------------------------------------------------------------------------------------------------------
----------------------------------------------------------------------------------------------------------------------------------------------------------------
----------------------------------------------------------------------------------------------------------------------------------------------------------------
-------------------------------------------------------------------------------------------?-----------------E--------------------------------------------------
-SS--SSS-------SSSSSSS------------E---------------------------SSS?SSS----SSSS--------------E--------------E-----------------------------------------------------
----------------------------------------------------------------------------------------------E--------------------------------------X--------------------------
---------------------------------------------------------------------------------------------<>-------Q?-------------------Q------------------------------------
------E---------E--E-------------------------------------------E----------------------?QQ----[]--------------------------------------------------------------X-<
-SS--SSS-------SSSSSSS-----XXXXX----------QQ--------E----<>---SSSSSSS---S--------------------[]---E----------------------------------------------------------X-[
------------------------E---------------------B----<>----[]---------------E---------X--------[]--<>------------SSSSS-S------X-------X----------------------X-X-[
----------------------------------------------b----------[]------------------------XX--------[]--[]--------------------X-XQXXX-X-X-----X-X-X-X-X-X-X-X-X-X-X-X-X
-------------------------------------------------------E-[]--------------E---E----XXXXXXXXXXXXX--[]-XXXX---------------X---X-X-X-X-----X-X-X-X-X-X-X-X-X-X-X-XX-
XXXXXXXXXXXXXXXXXXX--XXXXXX-------------XXXXXXXXXXXXXXXXXXXXXXXXXXXXXXXXXXXXXXXXXXXXXXXXXXXXXXX--XXXXXXX-------------S-S--------------------------------E---XXXX