------------------------------------------------------------------------------------------XXX----XX------------------------------------------------------------X
------------------------------------------------------------------------------------------ooo------------------------------------XXXXXX-------------------------
----------------------------------------------------------------------------------------------------------------------XXXXXXXXX---------------------------------
----------------------------------------------------------------------------------------------------------------------------------------------------------------
---------------------------------------------------------------------------------------------XXX------------------------E---------------------------------------
-------------------------------------------------------------------------------------------------SS-------------------------------------------------------------
------------------------------------------------------?QQQQQQE-----------XX--------XXXXXX--------------------XXXX--E--------------------------------------------
------------------------------------------------------------->-----------------------------------------oo-------------------------------------------------------
----------XX-------------------------------------------------]-----------------------------E-------E------------------------------------------------------------
-------------------------------------------------------------Q--------------------------------------------------------------------------------------------------
------------------------------------------------------SSSSSS--------S-X---------------------------------XXX-----------------------------------------------------
--------------------------------------------X-------------------------------------------------------------------------------------------------QQ---<>-----------
-------------------------------------------XX-----------E------------------------------------------------------------------------------------------[]-----------
------------------E-----------------------XXX--E---------------------------------------------------------------------------------------------------[]-----------
-------------------------E---------------XXXXX<>XXXXXXXXXXXXXXXXXXX-----------XX-------------------------------------------------------------------[]-----------
-----------XXXXXXXXXXXXXXXXXXXXXXXXXXXXXXXXXXX[]XXXXXXXXXXXXXXXXXXX-----------------------------------------------------------------------XXXXXXXXXXX-----------