-----------------------------------------------------------------[]---XXXXX[]------------XXXXXXXXXXXXXXXXXXXXXXX----XXXXXXXX--XXXXXXXXXXXXXXXXXXXXXXXX-X-XXXXXXX
-----------------------------------------------------------------[]-----X-X<>--------------[]--[]--[]---XXXXXXXX----SS--E-[]--------------XXXXXX----------------
-----------------------------------------------------------------[]-----X---E--------------[]--[]--[]----XXXXXXX----SS----[]---------------XXXXX----------------
-----------------------------------------------------------------[]-----X------------------[]--<>--[]-----XXXXXX----SS----<>----------------XXXX----------------
-----------------------XXXX--------------------------------------<>-----------XX----XX-----<>---E--<>------XXXXX-----------E-----SSS---------XXX--SSSSSS---Q----
-----------------------XXXX---------------------------------------E----------------------?--E---------------XXXX-----------------SoS--SS------XX----------------
----SSS----------------XXXX----------------------------------oooooo-----?-----------------------------S--------------------------S-SSSSS------------------------
-----------------------XXXXX--------XX-----------------------oooooo---------------------------------------------------------------------------------------------
-----------------------XXXX---------XX----------------------------------S-------XXoo----------?SSS---------------------------------ooooo---------SSS?SSS--------
----X-----o------------XXXX-------XXXX------------------------XX--------E-------------oo---------------SSS------------------------------------------------------
----XEE----------------XXXX-------XXXX------------------------------------------------oo------------------SS----------------------------------------------------
----XSSSSS------------XXXXX------XXXXX--------------------E-------------------------------------------------SSS?SSSSSSSSSSSSSSSSSSSSSSS?SSSS--------------------
---------------------XXXXXX-----XXXXXX--------------------------------------------------------------------------------------------------------------------------
--------------------XXXXXXX----XXXXXXX----E-----oXXXEXXEXXXX----------------------------------------------------------------------------------------------------
------------------XXXXXXXXX---XXXXXXXX----------X----------X----------------------------------------------------------------------------------------------------
XXXXXXXXXXXXXXXXXXXXXXXXXXX-XXXXXXXXXXXXXXXXXXX------------X----------------------------------------------------------------------------------------------------