-----------------------------------------------------------------------------------------------------------------------------------------------------XXXXXXXXXXX
-----------------------------------------------------------------------------------------------------------------------------------------------------X----------
-----------------------------------------------------------------------------------------------------------------------------------------------------X----------
-------------------------------------------------------------------------------XXX-SSSSSSSSSSSSSSSSSSSSSSSSSS---------------------------------------------------
-----------------------------------------XXXX----------------------------SSSSS----------------------------------------------------------------------------------
-----------------------------------------XXXX----------------------------------------------------------------------------------------------------------------o--
-----------------------------------------XXXX-------------------------------------------------------------------------------------------------------------------
-----------------------------------------XXXX-------------------------------------------------------------------------------------------------------------------
-----------------------------------------XXXX--------------------------------------------------------------------------------------------------E----------------
-----------------------------------------XXXX-----------------------------------------------------------------------------------------<>------------------------
----------------------------------X------XXXX--------?---------------------------------------------------------XXX--------------------[]--E---------------------
--------------E---------------------XX---XXXX----<>----------------------------------------------------------------------------------QQQQQQQ--------------------
-------------<>--------------X-----XXX---XXXX----[]--------------------------XX----oooooooooooooooooooooooo-----------------------------------------------------
-----------------------------X----XXXX---XXXX----[]-------------------------XXXXXX-oooooooooooooooooooooooo-----------------------------------------------------
-----------------------------X--XXXXXX---XXXX----[]------------------------XXXX----XXXXXXXXXXXXXXXXXXXXXXXX-----------------------------------------------------
XXXXXXXXXXXXXXXXXXXXXXXXXXXXXXXXXXXXXXXXXXXXXXXXXXXXXXX<>XXXXXXXXXXXXXXXXXXXXX-----XXXXXXXXXXXXXXXXXXXXXXXX-----------XXXXXXXXXXXXXXXXX-<><>--------------------