-----------------------XXXXXXXXXXXXXXXXXXXXXXXXXXXXX--XXXX---XXXXXXXXXXXXXXXXXXXXXXXXXXXXX----------------------------------------------------------------------
-----------------------X-----------[]--[]---XXXXXXXX----[]----[]----------[]---EX-------------------------------------------------------------------------------
-----------------------------------[]--[]----XXXXXXX----[]----[]-----SS---<>----X-------------------------------------------------------------------------------
-----------------------------------[]--[]-----XXXXXX----[]----[]-----SS---------X----------XX-------------------------------------------------------------------
-----------------------------------[]--<>------XXXXX----<>----[]-----SS---------XS---------XXX-----------------------------------------------SSSSSSSSSSSSSSSSSSS
-----------------------------------<>-----------XXXX-----E----[]--SSSSS------------------------------------------------------------------------------SSSS-------
------------------------------------E-----S-------------------[]--SSSSS---------------------E--------------------------------------------------------SSSS-------
-----------------XXX------------------------------------------<>--SSSSS-------------------------------------------------------------------------------SSS-------
--------------------------------SS-----------------------------E--SSSSS-----------------------------------------------------------------------------------------
-------------------------------------------SSS--------------------SSSSS-----------------------------------------------------------------------------------------
----------------------------------------------SS------------------SSSSS-------------------------------------XXX--XXXX-------------------------------------------
------------------------------------------------SSS?SSSSSSSSSSSSSSSSSSS----------------------------------------------------------------------------------XX-----
---------E-------------------------------------------------------------------------------------------------------------------<>-------------------------XXX-----
-----------------------------------------------------------------------------------------------------------------------------[]---------E--------------XXXX-----
---------------------------------------------------------------------------------------------------XXXXXX--------------------[]-------------------E---XXXXX-----
XXXXXXXXXXXXXX---------------------------------------------------------------------------------------------------------------[]--XXXXXXXXXXXX--XXXXXXXXXXXXXX---