----------------------------------------------------------------------------------------------------------------------------------------------------------------
----------------------------------------------------------------------------------------------------------------------------------------------------------------
----------------------------------------------------------------------------------------------------------------------------------------------------------------
------------------------------------------------------------------------------------------------------------------------------------------------------?---------
----------------------------------------------------------------------------------------------E--------------------------------------XXX------------------------
--------------------------------------------------------------------------------------o---------------------------------------------------------o---------------
-------------------------------------------------------------------------------------XXX----------------------------------------------------------o--S----------
-----------------XX--------------------------------------SSSS--------XX------------------o-----XXXXXX------S-------------------------------XXX------------------
-----------------------------------------------------------------------------------------XXX-----------------------oooo-----E-XXXXXX----------------------------
-----------------------------------------------------------------------------------X-----------------------------------------------------E----------o-----XXXX--
----------------------------SSS?----------------X---------E-----------------------X-----------------------------------------------------------------XXXX--------
-------------<>--------<>------------XXXXXXXXXX----------SSSS----------------<>---------------------------------<>------------------------------XXX-------------
----B--------[]--------[]----------------------------------------------------[]----------------------------<>---[]----------------------------------------------
----b--------[]--------[]----------------------------------------------------[]----------------------------[]---[]----------------------------------------------
-------------[]------E-[]--------------------------------------------------E-[]---------------X------------[]---[]----------------------------------------------
XXXXXXXXXXXXXXXXXXXXXXXXXXXXXXXXXXXXXX------------XXXXXXXXXXXXXXXXXXXXXXXXXXXXXXXXXXXXXXX----XX--XX--XXXXXXXXXXXXXXXXXXXXX--------------------------------------