---------------------XXXXXXXXXXX-------[]XXXXXX---------------XXXXXXXXXXX-XXXXXXXXXXXXX--------XXXXXX-----XXXXXXXXXXXXXXXXXXXXXXXXXXXXXXXXXXXXXXXXXXXXXXX-------
---------------------X-----------------[>XXXXXX-----------------------XXXX[]--[]------------------XXXX----XXXXXXXXXXXX--------BEE---[]----------------------XX--
---------------------X-----------------<E-------------XXXXX------------XXX[]--[]-------------------XXXXXX-XXXXXXXXXXXX--------b-----<>--------------------------
---------------------X--------------------------------------------------XX<>--<>----------XXX-------XX----XXXXXXXXXXXX--------B--------------Q?QQ---------------
--------------------------------------------------------E--------XXX-----------E--------------------------XXXXXXXXXXXX------------------------------------------
----------------------------------------------E----XX------------[]---------------------------------------XXXXXXXXXXXX------------------------------------------
-----XXXX-------?------------------------------------------------<>---------------------------------------XXXXXXXXXXXX------------------------------------------
----------------------------------------------------------------------------------------------------------XXXXXXXXXXXX------------------------------------------
-----------------------------------E--------------oo--------XX--------------------------------------------XXXXXXXXXXXX-----E------------------------------------
----------------------------------------------------------------------------------------------------------XXXXXXXXXXXX------------------------------------------
----------XXXXXEX-----------------------------------------------------------------------------------------XXXXXXXXXXXX------------------------------------------
----------------------------------------------------------------------------SSSSSSSSSSSSSSSSSSSSSSSSS-----XXXXXXXXXXXX------------------------------------------
------------------------------------------------------------------------------------------------------XXX-------------------------------------------------------
----------------------------------------------------------------------------------------------------------------------------------------------------------------
----------------------------------------------------------------------------------------------------------------------------------------------------------------
-XX-------------------------------------------------------------------------------------------------------------------------------------------------------------