----------------------------------------------------------------------------------------------------------------------------------------------------------------
----------------------------------------------------------------------------------------------------------------------------------------------------------------
----------------------------------------------------------------------------------------------------------------------------------------------------------------
----------------------------------------------------------------------------------------------------------------------------------------------------------------
----------------------------------------------------------------------------------------------------------------------------------------------------------------
----------------------------------------------------------------------------------------------------------------------------------------------------------------
---------------------------------------------------------------------------------------------------oo-----------------------------------------------------------
--------------------------SSSSSSSS---------------?---------------SSS--------------------------------------------------------------------------------------------
---------------------------------------------------------------E------------------------------------------------------------------------------------------------
---------------------------------------<>----------------X---------------------------XX-oo--------------------X-EE-----X----------------------------------------
---------------------------E---E-------[]------------------------------------------XXXX-----------------------XSSSSSSSSX--------XSS-SQ--------------------------
--------------------------SSSSSSSS-----[]--------Q-------------<>-----------------XXXXX----------------------------------------XXX------------------------------
----------------E--------------------E-[]----------------------[]------<>--------XXXXXX----------E----------------------------XXXX------------------------------
---------------<>-------------------<>-[]----------------------[]------[]-------XXXXXXX---------<>---------------------------XXXXX--------B------------------<>-
------------------------------------[]-[]----------------------[]------[]------XXXXXXXX---------[]-E----XXX--XXXXXXXXXXXXXXXXXXXXX--SSSSS-------E------------[]-
<>XXXX--X-XXXXXXXXXXXXXXXXXXXXX--XXXXXXXXXXXXXXXXXXXXXXXX-XXXXXXX---XXXXXXXXXXXXXXXXXX---XXXXXXXXXXXXXXXXXX--XXXXXXXXXXXXXXXXXXXX-------XXXXXXXXXXXXXXXXXXXXXXXX