--------------------------------------------------XXX-----XXXXXXXXXXXXXXXXXXXXXXXXXXXXXX-XXXXXXXXXXXXXXXXX-XXXX-------------------------------------------------
--------------------------------------------------ooo-----[][][]--------------------[]----------[]-------E------------------------------------------------------
----------------------------------------------------------<>[][]--------------------<>----------[]--------------------------------------------------------------
-----------------------------------------------------------E<>[]-----------E--------------------[]----------------S---------------------------------------------
-----------------------------------------------------XXX------<>--------------S?S---------------<>-----------------SSSSSSSSSSSSSSSSSSSSSSSSSSSSSSSSSSSSSSSSSSSSS
----------------------------------------------------------------------------------------------------------------------------------------------------------------
----------------------------------------------XXX---------------------------------------------------------------------------------------------------------------
---------------------------E-----------------XX-------------------------------------------------E---------------------------------------------------------------
--------------------------SSSS---------------XX----E---------------------------------------SS-------------------------------------------------------------------
------------------------------------EE------XXX-----------------------------------------------------------------------------------------------------------------
----------E-----------X-E--E--------<>-----XXXX-------------------------------------------------------------------XX----------------------------S---------------
----------------------XS?SSSSS------[]-----XXXX-----------------------------------------------------------------------------------------------E----E--------E--<
-------------<>----E----------EE----[]-----XXXX--------------------------------------------------------------------------XXX-----------------<>---<>-------<>--[
-------------[]-------SSSSSSSSSSSS--[]----EXXXX-------------------------------------------------------------------------------<>-------------[]---[]-------[]--[
-------------[]-------------------XXXXXXXXXXXXX-------------------------------------------------------------------------------[]--X----------[]---[]-----E-[]--[
-X-XXXXXXXXXXXXXXXXXXXXXXXXXXXXXXXXXXXXXXXXXXXX-------------------------------------------------------------------------------XXXXX---------XXXXXXXXXXXXXXXXXXXX