--------------------------------------------------------------------------XXXXXXXXXXXXXXXXXXXXXXXXXXXXXXXXXXXXXXXXXXXXXXXXXX------------------------------------
-------------------------------------------------------------------------------------b---[]--[]--[]-----[]----XXXX-XXXXXXXXX------------------------------------
-------------------------------------------------------------------------------------B---[]--[]--[]-----<>-----------------X------------------------------------
------------------------------------------------------------------XXXXXX-----------------[]--<>--[]-------------------------------------------------------------
--------------------------------------------------------------XXX------------------------<>---E--[]---------------------------XXXX---XXXXX----------------------
-----------------------------------------------------------------------XXXX--oo-----------E------<>-------------------------------------------------------------
--------------------------------------------------------------------------------------------------E-------------------------------------------------------------
------?--------------------------------------------------------------------------------------------------------------------------------------XXXXXXXXX----------
--------------------------------------------------------------------------------------------?SSS----------------------------------------------------------------
------------------------------------------------------------------------------------------------------------------------------------oo-----E--------------------
-----------------------------------------------E------------------XXXX------------------------------------------------------------------------------------------
---XS--------------------------B----------------------------------ooo-------------------------------------------------------------------------------------------
---X--------------------<>-----b--?-B---------------------------------------------------------------------------------------------------------------------------
---X--------------------[]-----B----b---------------------------------------------------------------------------------------------------------------------------
--EX--------------------[]-------------------XXX--XXXXXX--------------------------------------------------------------------------------------------------------
XXXXXXXXXXXXXXXXXXXXXXXXXXXXXXXXXXXXXXXXXXXXXXXX-------X--------------------------------------------------------------------------------------------------XXXXXX