-----------XXXXXXXXXXXXXXXX--XX-------XXXXXXXXXXXXXXXXXXXXXXXXXXXXXXXXXXXXX--XX---XXXXXXX-----------------------------------------------------------------------
-----------------[]--E--XXXX-[]------------]---[]----------------------E-[]--[]---------------------------------------------------------------------------------
-----------------<>------XXX-[]------------]---[]------------------------<>--[]---------------------------------------------------------------------------------
------------------E-------XX-[]------------>---<>-------------------------E--[]---------------------------------------------------------------------------------
-----------------------------<>------------E----E--SSS--SSS--SSS--SSS--------[]-------QQQ-----------------------------------------------------------------------
------------------------------E-XXX----------S-----SoS--SoS--SoS--SoS--------<>----------------------------------------------------oo---------------------------
---------------------------------------------------S-SSSS-S--S-SSSS-S---------E-------------XXX------------------------------------oo------------X--------------
------------------------------------------------------------------------------------------------XX------------------------XXXXX-----------------XX--------------
-----XSSS--------------------------------------------oooo------oooo-----------------------------------------------------X----------------------XXXXX------------
----XXX----------------------------------------------------------------------------------------------------------------XX---------------------EXXX----X---------
---XXXS-------------------------------------------------------------------------------------------XXXXXXX-------------XXX-------------?------XXXXX--------------
--XXXXX-----SSSSSSSSSSSSSSSSSSSSSSSSSSSSSSSSSSSSSSSSSSSSSSSSSSSSSSSSSSSSSSSSSSSSSSSSSSSSS----------------------------EXXX--------XX---------XXXXXX-------------X
--XXXXX-SSS---------------------------------------------------------------------------------------------------------XXXXX------------------XXXXXXX-E------------
--XXXXX------------------------------------------------------------------------------------------------------------XXXXXX-----------------XXXXXXXX<>------------
--XXXXX-----------------------------------------------------------------------------------------------------------XXXXXXX----------------XXXXXXXXX[]------------
XXXXXXXXX-------------------------------------------------------------------------------------------------XXXXXXXXXXXXXXX-------------XXXXXXXXXXXX[]----XXXXXXXX