-------------------------------------XXXXXXXXX--XX--XXXXX--XXXXX--XX--XXXXXXXXXX-X-X-XXXXXXXXXXXXXXXXXXXXXXXXXXXXXXXXXXXXXXXXXXXXXXXXXXXXXXXXXXXXXXXXXXXX-S-----
---------------------------------------------------------------------------------X-X-X----E-[]--------------------------------------[]---------XXXXXXXXXX-S-----
---------------------------------------------------------------------------------X-X-X------[]--------------------------------------<>---------XXXXXXXXXX-S-----
-----------------------------------------------------------------------------E---X-X-X------[]-------------------------------------------------XXXXXXXXXX-S-----
---------------------------------------------------------XX----------------------X-X-X------<>-S-----------------------------------------------XXXXXXXXXX-------
-----------------------------------------------------------------------------------X-X-------------------------------------------------S--------XXXXXXXXX-------
-----------------------------------------------------------------------------------X-X-----------------------------------------------------------XXXEXXXX-------
-------------------------------------------------------------------------------------X------------------------------------------------------------XX-EXXX-------
-----------------------------------------XXXXXXXXXXX-------XXXXXXXXXXX---------------X----------------------------------------------S--------------X--EXX-------
----------------------------------------------------------------------------------------------------------------------------------------------------------------
---Q------------------------------------------------------------------------------------------------------------------------------------------------------------
----------------<>-------------------------------------------------------------------------------------------------------------------------------------------XXX
----------------[]---------XXXXXXX------------------------------------------------------------------------------------------------------------------------------
----------------[]----------------------------------------------------------------------------------------------------------------------------------------------
----------------[]----------------------------------------------------------------------------------------------------------------------------------------------
XXXXXXXXXXXXXXXXXXXXXXXXXX--------------------------------------------------------------------------------------------------------------------------------------