--------------------------------------------------------------------------------------------------------X----XXXXXX---------X-----------------------------------
--------------------------------------------------------------------------------------------------------X----X--------------------------------------------------
-----------------------------------------------------------------------------------------------------XXXX----X--------------------------------------------------
----------------------------------------------------------------------------------------------------------------------------------------------------------------
----------------------------------------------------------------------------------------------------------------------------------------------------------------
-----------------------------------------------------------XXXXXXXXXX------o------------------------------------------------------------------------------------
---------------------------E-E-E-E-----------------------------------------o------?--XXXX-----------------------------------------------------------------------
-----SS-SS----------------<><><><>----------------------------------------------------------------------------------------------------------------------------Q-
-------E------------------[][][][]-----------------------------------------XXX----------------------------------------------------------------------------------
--------------------------QQQQQQQQ-----------------------------------------------------------------------------------XXXXXXXX-----------------------------------
----------------------------------------------------------------------------------X-----------------------------------------------------------oo----------------
--------<>----------------------------------------------------------------------E----------E-------------------------------------------------o--o-----------S?SQ
--------[]--------------------------------------------------------------------------------<>-----------------------------------------E-----------------<>-------
--------[]-----------------------------X--------------------------------------------------[]-------------------------------------XX--X-----------------[]-------
--------[]----------------XXXXXXXXXXXXXX----XXXXX----------------------------------------X[]X--XXX-----------------------------------X-----------------[]-------
XXXXXXXXXX------XXXX-X-X--XXXXXXXXXXXXXX---------------------------------------------------------------------------------------------X--XXXXXXXXXXXXXXXXXXXXXXXX