----------------------------------------------------------------------------------------------------------------------------------------------------------------
----------------------------------------------------------------------------------------------------------------------------------------------------------------
----------------------------------------------------------------------------------------------------------------------------------------------------------------
----------------------------------------------------------------------------------------------------------------------------------------------------------------
-----------------------------------------------------------------------------------------------------------------------------------------------------XXXXXX-----
---------------------------------------------------------------oo------------------------------------------------------------------------------------XXXXXX-----
-----------------------------------------------E-----E----------o------------------------------------------------------------------------------------XXXXXX-----
-----------------------------------XX-------------E--------------o-------------------------------------------------------------X--EX--------------XX-XXXXXX-----
----------------------------------XXX----------------------------o-------------------------------------------------------------X---X--------------XX-XXXXXX-----
----------XXX---------------------XXX---------------------XXXX---------------------------------------------------------------X-X---X------------XXXX-XXXXXX-----
--------------------------------<>XXX----------------------------X------------------------------------E----------------SSSSSSX-XSS?X------------XXXX-XXXXXX-----
-------------------------------X[]XXX----------------------------------------------------------------->---------------------------------------XXXXXX-XXXXXX-----
-------------SSS-<>-X---------XX[]XXX--------------------------------------------<>------------------<]--------------------------------------XXXXXXX-XXXXXX-----
-------------SSS-[]-XX----S--XXX[]XXX---X----------------------------------<>----[]------------------[]-------------------------------------XXXXXXXX-XXXXXX----<
-------X-----SSS-XXXXXX-EXXXXXXXXXXXX--XXXXX----------------------XXXXXXX--[]----[]----EE------------[]-XXXXXXXXX-XXXXXXXXXXXXXXXXXXXXXXXXXXXXXXXXXX-XXXXXX----[
XXXXXXXX--XXXSSS-XXXXXXXXXXXXXXXXXXXXXXXXXXX-------------------------------[]----[]--XXXXXXXXXXX-XX--XXXXXXXXXXXXXXXXXXXXXXXXXXXXXXXXXXXXXXXXXXXXXXXXXXXXXXXXXXX