----------------------------------------------------------------------------------------------------------------------------------------------------------------
----------------------------------------------------------------------------------------------------------------------------------------------------------------
----------------------------------------------------------------------------------------------------------------------------------------------------------------
----------------------------------------------------------------?-----------------------------------------------------------------------------------------------
----------------------------------------------------------------------------------------------------------------------------------------------------------------
----------------------------------------------------------------------------------------------------------------------------------------------------------------
--------------------------------------------?--XXXXXX----------XXXXXXXX----------------------------------------------SSS----------------------------------------
--------------------------------------XX---------------------------------------------------------------------------------X--------------------------------------
--------------------------------------------E----------------------------------------------------------------------------X----------------------------------E---
------------------------------------------------------------------------------------------------------------------------XX--------------------------------------
--oo----------------------------------------------------------------------------------------------oooo-----------------XXX------------------------------XXXXXXXX
-o---------------------------------------------------------XX-----------------------------------------o-----------XX--XXXX----------------------SSSS?-----------
------------------------------------------------------------------------------------------------------------------XX-XXXXX---<>---------------------------------
-------------------------------------------------------------------------X-----------------------------------<>---XXXXXXXX---[]----------X----------S-----------
------------XXXXXX--XXXXXX--X--------------------------------------------X-----------------------------------[]---XXXXXXXX---[]----------X-E--------------------
XXXXXXXXXXXXXXXXXX--------------------------------------X----------------XXXXXXXXXXXXXXXXXXXXXXXXXXXXXXXXXXXXXXXXXXXXXXXXXXXXXXXXXXXXXXXXXXXXXXXXXXXXX----------