----------------------------------------------------------------------------------------------------------------------------------------------------------------
----------------------------------------------------------------------------------------------------------------------------------------------------------------
----------------------------------------------------------------------------------------------------------------------------------------------------------------
----------------------------------------------------------------------------------------------------------------------------------------------------------------
----------------------------------------------------------------------------------------------------------------------------------------------------------------
--------------------------------------------------------------------------------------------------------------------------------------------------------------o-
----------------------------------------------------------------------------------------------------------------------------------------------------------------
---------------XX------SSSSSSS-------------QQQQQ--------------------------------------------------------------------------------------------XX-----XXX-------XXX
-------------------------------------------------------------------------E--o---ooX---------------------------------------------------------XX------------------
---------------------------------------------------------------------------XXX-XXXXXX--------oooo-----------------------------------------XXXX------------------
------------------------E--E----------<>-----------------------------------------------------oooo---XXXXXXXXXX--------------X-------<>----XXXX------------------
-----------------------SSSSSSS--------[]--E?QQQQ-----QQQQ---------------------------------------------------------------------XX----[]---XXXXX-------XXXXXXXX---
---------------------------------<>---[]---------------------------------------------SSS-------------------------------------XXX----[]---XXXXX------------------
--------------------E------------[]---[]----------B--E-------------------------------SSS---XXXXXXX--------------X-----------XXXXX---[]---XXXXX---<>-------------
---------------------------------[]---[]---------------------------------------------SSS---X--------------------XXXXXXXXXXXXXXXXX---[]---XXXXX---[]-------------
XXXXXXXXXXXXXXXXXXXXXXXXXXX--XXXXXXXXXXXXXXXXXXXXXXXXXXXXXXXXXXXXXX--------XXXXXXXXXXSSS---X--------------------XXXXXXXXXXXXXXXXXXXXXXXXXXXXXXXXXXXXXX----------