----------------------------------------------------------------XXXXXXXXXXXXXXXXXX------------------------------------------------------------------------------
-----------------------------------------------------------------------------XXXXX------------------------------------------------------------------------------
--------------------------------------------------------------------E---------XXXX------------------------------------------------------------------------------
-------------------------------------------------------------------------------XXX------------------------------------------------------------------------------
--------------------------------------------------------------------------------XX-----------------------------SS-----------------------------------------------
-------------------------------------------------------------------S-------------X------------------------------------------------------------------------------
-------------------------?-------------------------------------------------------------------------------------------------------XXXX-E--XXXXXXXXE--------------
-------------------------E-----------SSQSSS-----------------------------------------------XX-----S---------------------------------------------------E----------
-----------------------------XXXXX-----------------------------E----S---------------------XX--------------------------------------------------------------------
--<>-----------E------------------------------------------------------------------------X-XX------------------------------------------X-------------------------
--[]----E-----<>----<>------------------------------------------------------------------X-XX------S-------XXXX--------------------------------------------------
-QQQQQQQQQ----[]----[]---------------SSSSSS-------XX----------------------------------X-X-XX--------------------------------------------------------------------
--------------[]----[]-------------------------E--------------------------------------X-X-XX---------------------------X----------------------------------------
--------------[]----[]----------------------------------------------------------------X-X-XX------------XX-------------XX-------------------------XX------------
--------------XXXXXXXXXXXX----------------------X-------------------------------------X-X-XX----E---------------------XXXX--------------------------------------
XXX-X-<><>----XXXXXXXXXXXX----------XXXXXXXXXXXXXX------XXXX--------------------------X-X-XXXXXXXXXX------------XXXXXXXXXXX---X--------------------------XXXXXXX