------------------------XXX-----X-----------------------------------------------XXX-----------------------------------------------------------------------------
------------------------ooo-----------------------------------------------------ooo-----------------------------------------------------------------------------
----------------------------------------------------------------------------------------------------------------------------------------------------------------
----------------------------------------------------------------------------------------------------------------------------------------------------------------
---------------------------XX---XXXX-----------------------------------------------XX--XXXXXXXXXXXX----------------------------------------------XXXX-----------
-------------------------------------------------------------------------------------------------------------------------------------------------XXXX-----------
----XXX-------XXXXXXXXX--------------------------------------------------XXXXXX----------------------------------------------oo---Q-?-Q----------XXXX----XXXX---
------------------------------E-----------------------------------------------------------------------------------XXoo---------------------------XXXX-----------
-------------------------E-------------------------------------------------------E------------------------------------------------------E--------XXXX-----------
-XX--------------------------------?-------------------------------------------------------------------------oo----------------------------------XXXX-----------
-XX-------XXX----------------------------------------------------B-----------------------------------------XXEXX------------------E------XXXXXXX-XXXX-----------
-XX-----------------------------------------XX-------------------b------------------------------------------------------------XXXXEXXXXXXX-------XXXX--X--------
XXX----------------------------------------XXXX-------------?-B---------------------------------------XXXX---------------------------------------XXXX--X--------
XXX---------------------------------------XXXXXX--------------b----------------------------------------------------------------------------------XXXX--X--------
XXX-----------------------------------XXXXXXXXXXX------------------------------------------------------------------------------------------------XXXX--X--------
XXX-----------------------------------XXXXXXXXXXXXXXXXXXXXXXXXXXXXXXXXX-------------------------------------------------------------------------XXXXXXXX------XX