---------------------------------------------XXXXXXXXXXXXXXXXXXXXXXXXXXXX[]-------XXXXXXXXXXXXXXX---XXXXXXXXXXX----[]---X---------------------------------------
---------------------------------------------XXXXXXXXX--[]-----XXXXXXXX-X<>-------X--------XXXXXXX--------[]-XX----[]---X---------------------------------------
-------------------------------------------------XXXXX--<>-----XXXXXXXX---E-------X----------XXXXX--------<>--X----[]---XXXXXXX---------------------------------
--------------------------------------------------XXXX----------XXXXXXX-----------X-----------XXXX-----------------[]-------------------------------------------
---------------------------------------------------XXX-----------XXXXXX-----------X--QQ--------XXX-----------------[]-------------------------------------------
----------------------------------------------------XX-------------XXXX-----------X--------------------------------<>-----oooo---XXXXX--------------------------
-----------------------------------------------------X--------------XXX-----------X----------------oo---------------------oooo----------------------------------
---------XXXX------------E---------S---------------------------------XX-----------X-----------------------------------------------------------------------E-----
---------XXXX-----------<>--------------------------------------------X-----------X-----------------------------------------------------------------------------
---------XXXX-----------[]------------------E---------------------------------XXXX--------------------------------------------------------XXXXXXXXXXXXXX--------
---------XXXX---------E-XXX-------------------------------------------------------------------------------------------------------------------------------------
---------XXXX-----------------------------------------------------------------------------------------------------------------------------------------------XXX-
---------XXXX-----------------------------------------------------------------------------------------------------SSSS------------------------------------------
---------XXXX--------------<><>----<>---------------------------------------------------------------------------------------------------------------------------
----E----XXXX--------------[][]----[]--------------------------------------------------------------------------------------------------------------------ooo----
XXXXXXXXXXXXXXXXXXXXXXXXXXXXXXXXXXXXXXXX-----------------------------------------------------------------------------------------------------------------XXX---X