--------------------------------------------------------------------------------------------------------------------------------------------------------XXXXXXXX
----------------------------------------------------------------------------------------------------------------------------------------------------------------
----------------------------------------------------------------------------------------------------------------------------------------------------------------
----------------------------------------------------------------------------------------------------------------------------------------------------------------
-----------------------------------------SSSSSSSSSSSSSSSSSSSSSSSSSSSSSS----------------------------------------------------------------------------------??SSSSS
-----------------------------------------SSSSSSSSSSSS----------------------------------------------------------------------------------------------------?oooooo
-----------------------------------------SSSSSSSSSSSS---------------------------------------------------------------------------------------------------S-------
-----------------------XSSSSS------------SSSSSSSSSSSS--------------------------?SSS----------------------S---------SSSSSSSSSSSS-------------------------S-------
-----------------------X---------------------------------------------------------------oooo-------------------------------------------------------E-XXX-SSSSSSSS
-----------------------X-----------------------------------------------------------------------------------------------------------------<>-------------SSSSSSSS
------------SS--------EX--E-X-------------ooooooo---------------S------------E-----------------------------------------------------------[]-------------SSSSSSSS
-----------------------XSS?SX------------S?SSSSSS----XX-------E----E--------<>---E--<>-------------------S------------------<>-----------[]-------------SSSSSSSS
----<>-----------------------------------SS---------XXX----E-<>---<>--------[]--<>--[]------------<>------------------------[]---------E-[]---------------------
----[]-----------------------------------SS--------XXXX---<>-[]---[]------E-[]--[]--[]------------[]------------------------[]--------<>-[]---------------------
----[]----------------------------------------E---XXXXX---[]-[]---[]--E-----[]--[]--[]------------[]------------------------[]--------[]-[]---------------------
XXXXXXXXXXXXXXXXXXXXXXXXXXXXXXXXXXXXXXXXXXXXXXXXXXXXXXXXXXXXXXXXXXXXXXXXXXXXXXXXXXXXXXXXXXXXXXXXXXXXXXXXXXXXXXXXXXXXXXX-----XX--XXXXXXXXXXXXXXX-----------------