----------------------------------------------------------------------------------------------------------------------------------------------------------------
----------------------------------------------------------------------------------------------------------XXXXXXXXXXXXXXXXXXX-----------------------------------
----------------------------------------------------------------------------------------------------------------------------------------------------------------
--------------------------------------------SSSSSSSSS-----------------------------------------------------------------------------------------------------------
----------------------------------------------[]---[]-----------------------------------------------------E-----------------------------------------------------
----------------------------------------------[]---[]-----------------------------------------------------------------------------------------------------------
----------------------------------------------[]---[]----E---------------SSSX----ooo-----------XXXX---?---------------------------------------------------------
---------SSQSSS?SSS---------------------------<>---[]-------------------S---X----ooo----------------------------------------------------------------------------
---------------------------------------------------[]------------------SS---X-----------------------------------------------------------------------------------
-------------------------------oooooo--------------[]-----------------SSS---X-----------------------------------------------------------------------------------
----------------------o----------------------------[]----------------SSSS--?X---------------------XXXEX------------------------XXXXXXXX-------------------------
---------SSSSSSSSSS--------------------------------<>-----------------------X-------XXXXXX----------------------------------------------------------------------
----------------------------------------------------------------------------X-------X-----------------------------------------------------------E---------------
---<>----------------------------------------------------------------B------X--X----X---------o--------------------------------------------------------------XXX
---[]-------------------------<>-----XXXXXXXXX--XXXXXX----XXXXXXXXXXXXXXXXXXXXXX----X---------X------------------------------------------------------XXXXX---X--
XXXXXXXXXXXXXXXXX-X-XXXXXXXXX-[]------XXXXXXXX--XXXXXX----XXXXXXXXXXXXXXXXXXXXXX----X------X----------------------------------------------XXXXXXXXXX---------X--