-------------------------X---XXXXXXXXXXXXXXXXXXXXXXXXXXXXXX---XXXXXXXXXXXXXXXXXXXXXXXXX----------------------------------------------X--------------------------
----------------------------------[]--------------------------[]------E-[]------------------------------XXXXXXXXXXXXXXXXXXXXXXXXXXXXXX----------------------XXXX
----------------------------------[]-----SS-------------------[]--------[]--------------------------------------------------------------------------------------
----------------------------------[]-----SS-------------------[]--------[]--------------------------------------------------------------------------------------
----------------------------------<>-----SS-------------------[]--------<>---------SSS--XXXX---------------------ooooooooooooooooooooo--------------------------
-----------XXXXXXXXX------------------SSSSS-------------------<>-----------------------------XXXX--------------------------------------XXXXXXXXXEXEXEEXXXXXXX---
--------------------------------------SSSSS---------------------------------------------------------------------------------------------------------------------
---------------E----------------------SSSSS---------------------------------------------------------------------------------------------------------------------
----------------------------SS--------SSSSS---------------------------------------------------------------------------------------------------------------------
----------------------------SS--------SSSSS-------------------------------------------------------------XXXXX---------------------------------XXXXXXXEXXXXX-----
----------------------------SS--------SSSSS---------------------------------------------------------------------------------------------------------------------
----------------------SSSSSSSSSSSSSSSSSSSSS-----------------------------------------------------------------------------------------------------------E---------
----------------------------------------------------------------------------------------------------------------------------------------------------------------
----------------------------------------------------------------------------------------------------------------------------------------------------------------
-----X----------------------------------------------------------------------------------------------------------------------------------------------------------
XXXXXX----------------------------------------------------------------------------------------------------------------------------------------------------------