------------------------------------------------------------------------------------X--XXX-X--------------------------------------------------------------------
--------------------------------------------------------------------X-X-X-X-X-X-X-X-X---X------------------------------------------------------------------X----
--------------------------------------------------------------------X-X-X-X-X-XQXQXQ----X--o---------------------------------------------------------------[X-X-
---------------------------------------------------------------SSSS---------------------X-----------------------------------------------------------------X<X-X-
------------------------------------------------------------------------------E---------X-X-X-------------------------------------------------------------------
-------------------------------------------------------------------------------------------------X-----------------------------------------------X-X------------
----------------------------------S--------------------?----------------------Q-Q-Q-------o-------------X-------------------------------------------------------
-----XQQ?QQX-------------------------------------------E------X---------------------------o--------------------------------------------o--------------------X-S-
-----X-----X---------------------------------------------------------------------------------X-X----------X--------------------------------X-X--------------]---
-----X-----X---------------------------------------------<>----------------------------------o----X--------------------X-X----------?----------------------->---
-----XE-E--X------------------------------QQQ------------[]----------------------------------------------------<-----X-X-X----------------------------------E---
-----XQQ-QQX-----------------------<>--------------------[]----------------------------------------------------[-----X-X-X-----X----E-------------X-X---------S-
-----------------------------------[]-------E------------[]---------------------------------X-X----------------[---X-X---X-X-X-X--------------------------------
-----------E-----------------------[]--------------------[]-----------------------------------o----------------XEX-X-XXX-X-X-X-X--------------------------------
----------------------XXXXXXXXXXXX-XX--XXXXXXXXXXXXXXXXXXXX----------------------------------------------------->X-X-XXX-X------------------X-------------------
XXXXXXXXXXXXXXXXXXXXXXXXXXXXXXXXXX-XX--XXXXXXXXXXXXXXXXXXXX-----------------------------------------------------]]-XXXXX-X--------------------------------------