---------------------------------------------------------------XXXXXXXXXXXXXXXXXXXXXX---------------------------------------------------------------------------
---------------------------------------------------------------XXXXX-XXXXXXXXXXXXXXXX---------------------------------------------------------------------------
---------------------------------------------------------------X------------------------XXXXXX------------------------------------------------------------------
----------------------------------------------------------------------------------------------------------------------------------------------------------------
------------------------------------------------------------------------------------------------X---------------------------------------------------------------
---------------------------------------------S--------------------------------------E---------------------------------------------------------------------------
------------------------------------------SSS-------------------------------------------------------------------------------------------------------------------
---------------SSSSS------------------------------XXXX----------------------------------------------------------------------------------------------------------
--------------------------------------------------XXXX----------------------------------------------------------------------------------------------------------
-----------------------------------------S--------XXXX----------------------------------------------------------------------------------------------------------
-----------------------------------------------XX-XXXX--------------------------------------------------o-------------------------------------------------------
-------B--------S----X----------------<>------XXX-XXXX--------------------------------------------------------------E--X-----------E---------------------------o
-------b----------E--X----------------[]-----XXXX-XXXX-------------------------------------------------------------<>-XX----------------------------------------
-------B-------------X-------<>-------[]----XXXXX-XXXX-------------------------------------------------------------[]-XX--------------------------------B-----X-
---------------------X-------[]-------[]---XXXXXX-XXXX--------------------------------------------------------XXXXXXXXXX-------------------------------------XX-
XXXXXXXXXXXXXXXXXXXXXXXXXXXXXXXXXXXXXXXXXXXXXXXX--XXXXXXXXXX--------------------------------------------------XXXXXXXXXXXXXXXXXXXXXXXXXXX-XXXXXXXXXXXXXXXXXXXXXX