----------------------------------------------------------------------------------------------------------------------------------------------------------------
----------------------------------------------------------------------------------------------------------------------------------------------------------------
----------------------------------------------------------------------------------------------------------------------------------------------------------------
----------------------------------------------------------------------------------------------------------------------------------------------------------------
-----------SSSSS-----------------------------------SSSSSSSSSSSSSSSSSSSSSSSSSSSSSSSS--[]SSSSSSSSSSS-SSSSSSSSSSSSSSSSSSSSSSSSSSSSSSSSSSS-----------------------SSS
-----------SSSSS---------------------------------------------------------------SSSS--[]SSSSSSSSSSS-SSSSSSSSSSSSSSSSSSSSSSSSSSSSSSSSSSS--------------------------
-----------SSSSS------------------------XX-------------------------------------SSSS--[]SSSSSSSSSSS-SSSSSSSSSSSSSSSSSSSSSSSSSSSSSSSSSSS--------------------------
-----XX----SSSSS-----SQ-----------------[]-------------------------------------SSSS--[]SSSSSSSSSSSSSSSSSSSSSSSSSSSSSSSSSSSSSSSSSSSSSSS--------------------------
-----------SSSSS------------------------[]--------------------------------------SSS--[]SSSSSSSSSSSSSSSSSSSSSSSSSSSSSSSSSSSSSSSSSSSSSSS--------------------------
-----------SSSSS------------------------[]---------------------E---------------SSSS--[]SSSSSSSSSSSSSSSSSSSSSSSSSSSSSSSSSSSSSSSSSSSSSSS--------------<>----------
------------SSSS------------------------[]-----------------E--<>--------------SSSSS---]SSSSSSSSSSSSSSSSSSSSSSSSSSSSSSSSSSSSSSSSSSSSSSS--------------[]----------
--------------SS-----SS--------E--------<>--------E-------<>--[]-----------<>--S--S---]SSSSSSSSSSSSSSSSSSSSSSSSSSSSSSSSSSSSSSSSSSSSSSS------Q------QQQQQQ-------
--------------SS-----------------------------X-XX<>----XX-[]--[]-X---------[]-----SSSSSSSSSSSSSSSSSSSSSSSSSSSSSSSSSSSSSSSSSSSSSSSSSSSS--------------------------
--------------SS-------------------------E--XXXXX[]---XXX-[]--[]-----------[]-----SSSSSSSSSSSSSSSSSSSSSSSSSSSSSSSSSSSSSSSSSSSSSSSSSSSS--------------------------
-----------------------------------X---XXXXXXXXXX[]--XXXX-[]--[]-----------[]-----SSSSSSSSSSSSSSSSSSSSSSSSSSSSSSSSSSSSSSSSSSSSSSSSSSSS-------------------------X
<>XXXXXXX--XXXXXXXXXXXXXXXXXXXXXXXXX---XXXXXXXXX-XXXXXXX--XX--XX--------XXXXXXXXXXXXXXXXXXXXXXXXXXXXXXXXXXXXXXXXXXXXXXXXXXXXXXXXXXXXXX-XXXXXXXXXXXXXX-X-XXXXXXXX