----------------------------------------------------------------------------------------------------------------------------------------------------------------
----------------------------------------------------------------------------------------------------------------------------------------------------------------
----------------------------------------------------------------------------------------------------------------------------------------------------------------
----------------------------------------------------------------------------------------------------------------------------------------------------------------
---------------------------------------------------------------------------------------------X------------------------------------------------------------------
---------------------------------------------------------------------------------------------XX-----------------------------------------------------------------
---------------------------------------------------------------------------XXX---------------------------------------------------------E------------------------
-----XQQ?QQX----------------------------------------SSS-----------------------------------------------------------SQQQQQ---------------S---------SSS------------
-----X-----X---------------------------------ooo-----------------------------------------E-------E---------------------------------E----------------------------
-----X-----X----------------------------------------------------------------------------------------E----------------------------------?------------------------
-----XE-E--X------------X-----------------------------------------oo-------XXXXX--------------------------------------------------------------------------------
-----XQQ-QQX--------------X---------------<>-------XXXXX---XX------------------------------------------------------SSQQQ-----------<>----oooo---S----X-XX-------
-------------------------XXX--------------[]-------X-------------------------------------------------------------------------------[]--X----------E--X----------
-----------E------------XXXX--------------[]-------X---------------------------------------------------<>--------------------------[]--X-------------X----------
--------------------XXXXXXX---X-----------[]-------X---------------------------XXXXXXXXX---------------[]--------------------------[]--X-------------X--------XX
XXXXXXXXXXXXXXXXXXXXXXXXXXX---XXXXXXXXXXXXXXXXXXXXXXXX--------XXXXXXXXXX---------------X---------------XXXXXXXXXXXXXXXXXXXXXXXXXXXXXXXXXXXXXXXXXXXXXXX-----XXXXX