------------------------------------------------------------XXXXXXXXXXXXXXXXXXXXXXXXXXXXXXXXXXXXXXXXXXXXXXX---XXXXXXXXXXXXXXXXXXXXXXXXXXXX-XXXXXXXXXXXXXXXXXXXXX
----------------------------------------------------------------------------------------[]--------E-[]---------------------------------------------------------E
----------------------------------------------------------------------------------------<>----------[]-----------B----------------------------------------------
--------------------------------------------------------------------------------------------E-------[]----------------------------------------------------------
----------------------------------------------------------------------------------------------------<>------------------QQQ-------------------------------------
--------------------------------------------------------------------------------------------------------------------------------SSSSS-------------------SSSSSS--
------E----------------------------------------XXXX-----------------------------------------------------------------------------------------------------SSSSSS--
----QQQQQQQQ--------------------------SQQS-----------------XXX--------------------------------------------------------------------------------------------------
-----------------------------------------------------------------------------?--------------------------SSSSS------------S------------------------------oooooo--
----------------------------------------------------------------------------------------------------------------------------------------------------------------
-------E----------------------------------S------------E--------------------------------------------------------------------------------------------------------
---QQQQQQQQQ---------------------E-----SS---------------------------------------------------------------------------------------------------------SSSSSSSSSSS?SS
----------------------------------------------------------------------------------------------------------------------------------------------------------------
-----------------<>---------------------------o-----------------------------------------------------------------------------------------------------------------
-----------------[]XXXXXXXXXX-----------------X------XXX--------------------------------------------------------------------------------------------------------
XXXXXXXXXXXXXXXXXXXXXXXXXXXXXXXXXXXXXXXXXXXX---------XXX--------------------------------------------------------------------------------------------------------