--------------------------------XXXXXXXXXXXXXXXXXXXXX----------X------------------------------------------------------------------------------------------------
--------------------------------------------E-E-------XXX------X------------------------------------------------------------------------------------------------
---------------------------------------------------------------X------------------------------------------------------------------------------------------------
---------------------------------------------------------------X--XXXXX-----------------------------------------------------------------------------------------
-----------------------------------------------------------EXEXX-----------------------------------------------XXXX-----------------------------------------SSSS
---------------------------------------------------S-----------------------------------------------------------XXXX-----------------------------------------SSSS
-----------------------XXXX--E---------------------------------------------------------------------------------XXXX-----------------------------------------SSSS
-------------------------------XXX-------------S---------------------------------------------------S----------XXXXX-----------------------------------------SSSS
-----------------------------------------------QSSS--------------------------------------------------------E--XXXXX----oooo-------------------------------------
-------------------------------------------------E---------------------------------------------------------XX-XXXXX---------------------------------------------
-----------ooooo----S-----------------------------------------------------------------------------S--------XX-XXXXX---------------------------------<>--------E-
----------------------------------------------------------------------------------E------------------------XX-XXXXX---------------------------------[]-------<>-
---------------------------------------------------------------------------------<>----------E-------------XX-XXXXX--X------------------------------[]-------[]-
---------------------------------------------------------------------------------------------------E-<><>--XX-XXXXX--X---------------------------<>-[]-------[]-
-----------------------------------------------------------------------------------------------------[][]--XX-XXXXX--X---------------------------[]-[]-------[]-
XXXXXXXXXXXXXX-------------------------------------------------------------XXXXXXXXXXXXXXXXXXXXXXXXXXXXXXXXXX-XXXXXXXXXXXXXXXXXXXXXXXXXXXXXXXXXXXXXXXXXXXXXXXXXX