---------------------------------------------------------------------------------------------------XXXXXXX---XXXXXXXXXXXXXXXXXXXXXXXXXXXXXXXXXXXXXXXXX---XXXXXXX
--------------------------------------------------------------------------------------------------------[]----[]---[]---------------------------------------EE--
--------------------------------------------------------------------------------------------------------[]----[]---[]-----------------SS------------------------
--------------------------------------------------------------------------------------------------------[]----<>---<>-----------------SS---------EE-------------
--------------------------------------------------------------------X-XXX-------------------------------<>-----E----E---QQQQQ--SSS--SSSS--SSSSSS--SSSS----------
-----------------------------------------------------------------------------------------------XX--------E-------S-------------So??-SS----ooooSS---E------------
--------------------------------------------------------------------------XXXXXXX----------------------------------------------S----SS--------SS----------------
---------------------------?----------XX---------------------------------------------------------------------------------------S----SS--------SS----------------
--------------------o----------------XXX----------------------------XXX--------------------------------------------------------S----SS--------SS----------------
-------------------XXX--------------XXXX--------------------------------------------------------------------------------------SSSS--E-SS--SSSSSS--SSSS----------
-----------------o-----------------XXXXX-------?-----------------------------------XX-----------------------------------------SSSS----SS--SSSSSS--SSSS----------
---------------------------S------XXXXXX----------------XX----------------------------------------SSSSSSSSSSSSSSSSSSSSSSSSSSSSSSSSSSSSSSSSSSSSSSSSSSSSSSSSSSSSSS
-----------------------<>--------XXXXXXX----------------XX------------------------------------------------------------------------------------------------------
----?------------------[]---X----XXXXXXX----------------XXXXXEX-------------------------------------------------------------------------------------------------
-----------------------[]E--X----XXXXXXX------XX--------XXX-----------------------------------------------------------------------------------------------------
XXXX-XXXXXXXXXXXXXXXXXXXXXXXXXXXXXXXXXXXXXXXXXXX--------XXX----------------------------X------------------------------------------------------------------------