----------------------------------------------------------------------XXXXXXX-----------------------------------------------------------------------------------
----------------------------------------------------------------------------------------------------------------------------------------------------------------
----------------------------------------------------------------------------------------------------------------------------------------------------------------
----------------------------------------------------------------------------------------------------------------------------------------------------------------
----------------------------------------------------------------------------------------------------------------------------------------------------------------
-----------------------------------------------------------?----------------------------------------------------------------------------------------------------
-------------------------------------------------------oo------------------------------------------XXXXXX-------------------------------------------------------
------------------------------------------------------XXXX-------------------------------------------------XXXXXXX----------E-----------o------------SSSSXXX----
------------------------------------------------------------------------------------------E-------------------------------------------ooo----------------XXX----
-------------------------------------------------ooo------XX--------------------------------------------------------XXXXXX-------------------------------XXX----
-----------------------------------?-------------ooo-----------------------------XXXXXXXXXXXXXXX-------------------E-------------------------<>----------XXX----
------------------------------------------------------------------------------------------------------------------------------XX---E---X-----[]----------XXX----
-------------------------------<>------------------------------------------------------------------------------------------------------------[]----------XXX----
-----------------------<>------[]--------------XXXXXXX---XXX----X----------------------------------------------------------------------------[]----------XXX----
-----------------------[]------[]--------------X----------------X----------------------------------------------------------ooo-----XXXX------[]----------XXX----
XXXXXXXXXXXXXXXXXXXXXXXXXXXX---[]XXXX<>XXXXX---X----------------X----------------------------------------------------------XXX---------------XXXXXXXXXXXXXXXXXXX