-----------------XXXXXXXXXXXXXXXXXXXXXXXXXXXXXXX--XX--------------------------------------------------------------------------------------------------------XXXX
---------------------------------[]-----------------------------------------------------------------------------------------------------------------------------
---------------------------------<>-----------------------------------------------------------------------------------------------------------------------------
----------------------------------E------------------------------------------------------XXXX--------------XXXXXXXX---------------------------------------------
------------------oooo--------------------------------------------------------------------[]--------------------------------------------------------------------
------------------------------------------------------------------------------------------[]-------------------------XXXX--XXXX--XXX----------------------------
--------------------------------------------------------------------------XEX-------------[]-------------------------o-----------------E------------------------
------------------------------------------------------------------------------------------[]--------------------------------------------------------------------
-------------------------------------------------------X----------------------------------[]--------------------------------------------------------------------
--<>--------------------------------------------------------------------------------------[]--------------------------SS----------------------------------------
--[]----E---------------------------------------------------------X-------------QQQQQQ?Q--<>------QQQQQQ?Q---------------------------------------XXXXXX---------
-QQQQQQQQQ----------------------SSS----------------------XXX-----XX---------------------------------------------------------------------------------------------
----------------------------------------------------------------XXX---------------------------------------------------------------------------------------------
---------------------------------------------------------------XXXX------------X--------------------------------------------------------------------------------
--------------------------------------------------------------XXXXX------------XXXXXXEXEXXXXXXXXXXXXXXXEXEXX---------------------------------XX-----------------
XXX-X-<><>----------------------------------------------------XXXXXXXXXXXX-----XXXXXXXXXXXXXXXXXXXXXXXXXXXXX----------------------------------------------------