-------------------XXXXXXXXXXXXXXXXXXXXXXXXXXXXXXXXXXXXXXXXXXXXXXXXXXXX---X-------------------------------------------------------------------------------------
-----------------------------[]--[]--------[]E------X----E---XXXXXXXXXX------X----------------------------------------------------------------------------------
-----------------------------[]--[]--------[]-------X------------------------o----------------------------------------------------------------------------------
-----------------------------[]--<>--------<>-------X-----------------------------------------------------------------------------------------------------------
-----------------------------<>---------------------X-----------------------------------------------------------------------------SSSSSSSSSSSSSSSSSSSSSSSSSSSSSS
-------------------?--------------------------------------------------------------------------------------------------------------SSSS--------------------------
--XXX----------------------------------------------------------------Q?-----------------------------------------------------------SSSS--------------------------
--------E-------------------------------------------------------------------------XXXXXX---XQQ?QQX--------------------------------SSSS--------------------------
----------XXX-------------------?S--------------SSSSSSSSSS---------------------------------X-----X--------------------------------------------------------------
----------------oo-----------------------------------E-E---------XX-----------XXX----------X-----X--<>----------------------------------------------------------
----------------oo-------------------------------------------------------------------------XE-E--X--[]--------S---------------------E---------------------------
-------------------------------------------------------------------------------------------XQQ-QQX--XXX----------------------------<>---------------------------
-----------------------------------------------------------------------------------------------------------------------------------[]-----------E-----E----E----
-------------------------------------------------------------------------------------------------E---------------------X-----------[]---------------------<>----
-----------------------------------------------------------------------------------------------------------------------X-------E---[]------------X-----X--[]---E
-----X----------------------------------------------------------------------------------XXXXXXXXXXXXXXXXXXXXXXXXXXXXXXXXXXXXXXXXXXXXXXXXXXXXXXXXXX--XXXX--XXXXXX