----------------------------------------------------------------------------------------------------------------------------------------------------------------
----------------------------------------------------------------------------------------------------------------------------------------------------------------
----------------------------------------------------------------------------------------------------------------------------------------------------------------
-----------------------------------------------------------------------------------------XXX--------------------------------------------------------------------
-----------------------------------SSSSSSSSSSSSSSSSSSSSSSSSSSSSSSSSSSSSSSSSSSSSSSSSSSSSS------------------------------------------------------------------------
----------------------------------------------------------------------------------------------------------------------------------------------------------------
----------------------------------------------------------------------------------------------------------------------------------------------------------------
--------------------------------------------oooo------E---------E--------------------------------------------------------------------------------------------SSS
-----------------------------------------------------<>--------<>-----------------------------------------------------------------------------------------------
------------------------------------------S-SSSS-S---[]--------[]-----------------------------------------B-----------------------------------------------------
--------oo----------------------------E---SoS--SoS---[]--------[]-----------E-----------------------------b---X-------------------------------------------------
-------------------------------------<>---SSS--SSS--?SSS--E--SS[SSS--------<>---------------------<>----SSXSSSX-----------------------------------------------S-
------------<>----------E------------[]------------------<>----[]----------[]----------XX---------[]------------------------------------------------<>--<>------
------------[]---<>------------------[]------------------[]----[]----------[]---------XXXXXX------[]------------------------------------------------[]--[]------
---E--------[]E--[]----------------E-[]------------------[]-E--[]------EE--[]-----E--XXXX---------[]------------------------------------------------[]--[]--E---
XXXXXXXXXXXXXXXXXXXXXXXXXXXXXXXXXXXXXXXXXXXXXXXXXXXX----XXXXXXXXXXXXXXXXXXXXX--XXXXXXXXX--------XXXXXXXXXXXXXXXXXXXXXXXXXXXXXX-XXXXXXXXXXXXXXXXXXXXXXXXXXXXXXXXX