----------------------------------------------------------------------------------------------------------------------------XXX-XXXXXXXXXXXXXXX-XXXXXXXXXXXXXX--
----------------------------------------------------------------------------------------------------------------------------------------------------------XXXX--
----------------------------------------------------------------------------------------------------------------------------------------------------------XXXX--
---------------------------------------------------------------------------------------------------------------XX---XXXXXXXX?-----------------------------XXXX--
-----------------------------------------------------------------------------------------------------------------------------------------------------------XXX--
------------------<>--------------------------------------------------------------------------------------------------o-oo----------------------------------XX--
------------------[]------------------------------------------------------------------------------------X--------------ooo-----------------------------------X--
---QQSSSSS--------XX--XX------------------------------------------------------------------------------------------E---------------------------------------------
-----------------------------------------------------------------------------------------------------------------------------XX-----------XXXXX-----------------
---------------E-------------------------------------------------------------------------------------------------------------oo------------oooo-----------------
------------------------XX----------------------------------Q---------------------------------------------------------------------------------------------------
--SSS---------XXX-------------------------------------X---------------------------------------------------------------------------------------------------------
--------------XX--------------------------------------X------------<>-------------------------------------------------------------------------------------------
----------------------------------?-------------------X------------[]----------------------------<>-------------------------------------------------------------
------------------------------------------------------X------------[]EE--------------------------[]---------XX--------------------------------------------------
XXXXXXXXX-X--------------XXXXXXXXX-XXXXXXXXXXXXXXXXXXXXXXXXXXXXXXXXXXXXXXXXXXXXXXXXXXXXXXXXXXXXXXXXXXXXX----XX--------------------------------------------------