--------------------------------------------XXXXXXXXXXXXXXX--X----------------------------------------------------------------------------------------------XXXX
-------------------------------------------------XXXXXXXXXX--X----------------------------------------------------------------------------------------------XXXX
--------------------------------------------------XXXX-------X-----------------------------------------------------------------------------------------------[]-
---------------------------------------------------XXX-------------------------------------------------------------------------------------------------------[]-
----------------------------------------------------EX-------------------------------------------------------------------------------------------------------[]-
-----------------------------------------------------X-----------------S-------------------------------------------------------------------------------------<>-
---------------------------------------o-------------------------------------QQQ?QQQQQQQQQQQ--------------------------------------------------------------------
-------SSSS----------------------------o-------------------------------------------------[]---------------------------------------------------------------------
-----------------------------------------XX----------------------------------------------[]--------------------------------------------------------E------------
-----------------------------------------------------------------------------------------[]--------oo-------------------------------------------------E---------
-------------------------------------------------------------------------------SSSSSSSSS-<>------Eooo-----------------------------------------------------------
-------SSSSS---------QQQQ----------------------------------------------------------------------------------------------------------------------XXX--------------
---------------------------------XXXXXXX--------------------------------------E---E-----------------------------------------------------------------------------
------------------B--E--------------------------------------------------------------------E---------------------------X-----------------------------------------
---------------------------------------------------------------------------XXXXXXXXXXXXXX<>-XXXXXXXXXXXXXXXXX-XXXXXXXXXX------E---------------------------------
XXXXXXXXXXXXXXXXXXXXXXXXXXXXXXXX-------------------------------------------XXXXXXXXXXXXXX[]-XXXXXXXXXXXXXXXXXXXXXXXXXXXXX-XXXXXXXXXXXXXXXXXXXXXX----------------