----------------[]------X------XXX--XXXXXXXX--XXXXXXXX----------------------XXXXXXXXXXXXXXXXXXXXXXXXXXXXXXXXXXXXXXXXXXXXX---------------------------------------
----------------[]--XXXXX------XX--------------------X----------------------------XX]--------------------[]--[]---[]----X---------------------------------------
----------------<>-------------X---------------------------------------------------X]--------------------[]--[]---<>--------------------------------------------
------------------------------------------------------------------------------------]--------------------<>--[]-------------------------------------------------
--------------------------XX-------SSSSSSQQ?SSQQQQQQQQ------------------------------>------------------------<>-------------------------------------------------
----------------------------------------------------------XXEEXXXXXXX-------------------------------------------------------------------------------------------
-----------E---------------------------------------------------------XXXXXX------------------------------------------------------X-----------------X-X----------
-----------S--------------------------------------------------------------------------ooo-----------------------------------------------------------o-----------
-------------------------------------------QQQQ-----------------------------------------------------------------------------------X-----------------X-X---------
-----------?----------------------------------------------XXXEXXXXX---------------------------------------------------------------------------------------------
----------------------------------------------------------------------------------------------------------------------------------------------------------------
--------------------------------------------------------------E----------------------------------------------------------------------------?-Q------------------
-----------X----------------------------------------------------------------------------------------------------------------------------------------------------
-----------X---------------------------------------------------------------------------------------------------------------------------E----Q-Q-----------------
----E------X---------------------------------------------------------------------------------------------------------------X-X-X-X-X-X-X-X-X-X-X-X-X-X-X-X-X-X-X
XXXXXXXXXXXXX--------------------------------------------------------------------------------------------------------------X-X-X-X-X-X-XEX-X-X-X-X-X-X-X-X-X-X-X