-------------------XXXXXXXXXXXXXXXXX-XX-------------------------------------------------------------------------------------------------------------------------
------------------------------[]--------------------------------------------------------------------------------------------------------------------------------
------------------------------<>--------------------------------------------------------------------------------------------------------------------------------
----------------------------------------------------------------------------------------------------------------------------------------------------------------
--------XXXXXXXXXX----------------------------------------------------------------------------------------------------------------------------------------------
----------------------------------------------------------------------------------------------------------------------------------------------------------------
----------------------------------------------------------------------------------------------------------------------------------------------------------------
------------------------------------------------------------------SSS---------------------------<>--------------------------------------------------------------
------------------------------------------------------------------------------------------------[]--------------------------------------------------------------
---------------------------------------XXXXXXXXXXX----------------------------------ooo---ooo---[]--------------------X-----------------------------------------
-----------------------------------------------------------------------------QQQQQ--ooo---ooo--S[]-------------------XX--------------------------------------Q--
-----------------------------------------------------<>----------XXXXX--------------------------[]------------------XXX------------------------------S?S--Q-E---
-----------------------------------------------------[]----------X----X-------------------------[]-----------------XXXX-------------------------------------E---
-----------------------------------------------------[]----------X------------------------------[]----------------XXXXX----------------b------------------------
-----------------------------------------------------[]----------X----------XXXXXXXXXXXXXXXXXXXXXXXXXXXXXEXXXXXXXXXXXXX----------------BEE----------------------
X---------------------------------------------------XXX-XXXXXXXXXXXX--------XXXXXXXXXXXXXXXXXXXXXXXXXXXXXXXXXXXXXXXXXXXXXXXXXXXXXXXXXXXXXXXXXXXXXXXXXXXXXXXXXXXX