------------------XX--XX--XX--XX--XX--XXXXXXXXXXXXXXXXXXXXX---XXXXXXXXXXXXXXXXXXXXXXXXXXXXXXXXX-----------------------------------------------------------------
---------------------------------------------XXXXXXXXXXXXXX-----------[]-------------[]-------------------------------------------------------------------------
---------------------------------------------XXXXX--------------------[]-------------[]-------------------------------------------------------------------------
---------------------------------------------XXXXX--------------------[]-------------<>-------------------------------------------------------------------------
---------------------------------------------XXXXX--------------------<>----------------------------------------------------------------------oo----------------
----------------------------------------------XXXX--------------------------------------o-----------------------------------------------------------------------
-----oo----------------------------------------XXX-------------------------------------------------------------------------------------------XXXX---------------
------------------------------------------------XX--------------------------------------------------------------------------------------------------------------
----------------XXXXXXXXXXXXXXXXXXXXXX-----------X--------------------------------------------------------------------------------------------------------------
<>--------------------------------------------------------------------------------------------------------------------------------------------------------------
[]--------------------------------------------------------------------------------------------------------------------------------------------------------------
XXX-------<>---------------------------------------------------------------------------------------------------------QQQQQ--------XXXXXXX----E------------------
----------[]------------------------------------------------------------------------------------------------XXXXXXXXX-----------------------<>------------------
----------[]---------------------------------------------------------------------------------------------<>---------------------------------[]----------------X-
-----E----XX---------------------------------------------------------------------------------------------[]--------------------------------X[]XXXXXXXXXXXEEX--XX
XXXXXXX---XX-------------------------------------------------------------------------------------XXXXXXXXXXXXXXXXXXXXXX-XXXXXXXXXX----------------------------XX