-------------------------------------------------------------------------------------------------------------------------------XXXXXXXXX----------X-------------
-----------------------------------------------------------------------------------------------------------------------------X--------------------X-------------
--------------------------------------------------------------------------------------------------------------------------------------------------X-------------
----------------------------------------------------------------------------------------------------------------------------------------XXXXXXXXXXX-------------
-----------SSSSSSSSSSSSSSSSSSSSSSSSSSSSSSSSSSSSSSSSSSSSSSSSSSSSSSSSSSSSSSSSSSSSSSSSSSSSSSSSSSSSSSSSSSSS---------------------------------------------------------
-------------------------------------------------SS--SSSS--SS--SSSSSS--SSSS-------------------------------------------------------------------------------------
-------------------------------------------------SS--SSSS--SS--SSSSSS--SSSS--E----------------------------------------------------------------------------------
-----------------------------------------------SS---------S--------SS---S----SS---------------------------------------------------------------------------------
-----------------------------------------------SS--------SS--------SS---S----SS---------------------------------------------------------------------------------
-----------------------------------------------SS--------SS--------SS---S----SS---------------------------------------------------------------------------------
---------------------XXX-----------------------SS----ooooSS----ooooSS---So??-SS------XXX------------------------------------------------------------------------
---------------------------------------E-------SSSS--SSSSSSSS--SSSSSS---SSS--SS----------------------------------B---XXXX---------------------------------------
------------------------------E-------<>---------SS--------SS----------------------------------------------------b----------------------------------------------
--------------------------------------[]---------SS--------SS----------------------------------------------------B----------------------------------------------
------------------X------------X------[]------------------------------------------X-------------------E---E-----------------------------------------------------
XXXXXXXXXXXXXXXXXXX---------XXXX---XXXXXXXXXXXXXXXXXXXXXXXXXXXXXXXXXXXXXXXXXXXXXXXX--------XXXXXXXXXXXXXXXXXXXXXXXXXXX----------------------------------XXXXXXXX