----------------------------------------------------------------XXX-------------------------------XXXXXXXXXXXXX-XXXXXXX--XXXXXXXXXXXXXXXX--XXXXXXXXXXXXXXXXXXXXX
----------------------------------------------------------------ooo------------------------XXXXX--[]-XXXXXXXXXX----------XX---[]XXXXXXXXX--X--------------------
--------------------------------------------------------------------------------------------------[]---------------------X----<>-----------X--------------------
------------------------------------S-------------------------------------------------------------<>------------------------------------------------------------
-------------------------------------------------------------------XXEXXXXXXX----------------------E------------------------------------------------------------
---------------------------------------------------------------------E------XXXXXXXXXXEXEX----------------------------------------------?----------------SSS?---
----------------------------------XXXX---------------XXXXXXXXXX----------------------------------------------Q?-------------------------------------------------
----------------------------------XXX--------------------------------------E------------------------------------------------------------------------------------
---------XSSS----------------------------------------------------E----------------------------------------------------------------------------------------------
--------XXX--------------X--X----------------------------------------Q-?-Q----------XXXXXX----------------------------------------------------------------------
-------XXXS--------------XSSX-------------oooo------------------------------------------------------------------------------------------------------------------
------XXXXX-----------------------------------------------------------------------------------------------------------------------------------------------------
----EXXXXXX-S---------------------------------------------------------------------------------------------------------------------------------------------------
----XXXXXXX----------------------XX-----------------------------------------------------------------------------------------------------------------------------
X--XXXXXXXX-------XXXXXXXXXXXXXE-XXXXXX-------------------------------------------------------------------------------------------------------------------------
XXXXXXXXXXXXX---XXXXXXXXXXXXXXXX-XXXXXXXXXXXXXXXXXX-------------------------------------------------------------------------------------------------------------