-------------------------------------------------------------------------------------------------------------XXXXXXXXXXXXXX---XXXXXXXXXXXXXXXXXXXXXX----X-------
--------------------------------------------------------------------------------------------------------------------------------------------------------XXXXXXXX
-------------------------------------------------------------------------------------------------------------------------------------------E--------------------
----------------------------------------------------------------------------------------------------------------E-----------------------------------------------
---------------------------------------------------------------------------------------------------------XX---------SSSS------------------------o---------------
---------------------------------------------------------------------------------------------------------------------E----------------------------------E-------
--------------------E--------------------E-E--------------------------------------------------------------------------------------------------------------------
----SSSSSSSSSSSSSSSSSSSSSSSSS-----------<><>--------------------------------------------------------------------------------------------------------------------
----------------------------------------[][]----------------o---o---o---o---o---o-----------------------------------SSSS-----------------------------XX---------
----------------------------------------QQQQ---------------XXX-XXX-XXX-XXX-XXX-XXX----------------------oo------------------------------------------------------
---------------------------------------------------------o------------------------------------------------------------------------------------------------------
---X------------------------------------------------------------------------------------------------------------------------------------------------------------
---X---------------X---------<>-----<>----------------<>--------------------------------------------------------------------------------------------------------
---X---------------X---------[]-----[]----------------[]--------------------------------------------------------------------------------------------------------
---X---------X-----X---------[]E----[]--XXXXXXX-------[]-------------------------------------XXXXXXXXX----------------------------------------------------------
XXXXXXX------XXXXXXXXXXXXXXXXXXXXXXXXX--XXXXXXXXXXXXXXXXXXXXXXXXXXXXXXXXXXXXXXXXXXXXXX<>XXXXX-------------------------------------------------------------------