----------------------------------------------------------------------------------------------------------------------------------------------------------------
----------------------------------------------------------------------------------------------------------------------------------------------------------------
----------------------------------------------------------------------------------------------------------------------------------------------------------------
----------------------------------------------------------------------------------------------------------------------------------------------------------------
----------------------oo-------------------------------ooo------------------------------------------------------------------------------------------------------
------------o------------------------------------------XXXX----------------------------------------------------------oo-----------------------------------------
-----------------------------------------------------------------------------------------------------------XXXXXX----oo-----------------------------------------
----------------------XXX--XX---------------------SSS-----------------------------------------------------------------------------------------------------------
------------------XX-------------------oooo---------------------------------------------------------------------------------------------------------------------
----------------------------------------------------------------------------------------------------------------------------------------------------------------
------------------------------------------------------------XXXX--------------------------?-----------------------------?-XXXX----X----------------B------------
-------------------------XXX-XXXXX------------Q--XXXXX-----------------------------------------------X---------------------------------------------b-----------E
-------------------------------------------------X-----XXXXXX------------<>--------------------------X----------------------------------------?-B---------------
-------------------------------------------------X-----------------------[]---------------E----------X------------------------------------------b---------------
-------X-----------------------------------------X-----------------------[]--------------------------X----------------------------------------------------------
XXXXXXXX-----------XXX--------------XXXXXXXXXXXXXXXX-----------XXXXXXXXXXXXXXXXXXXXXXXXXXXXXXXXXXXXXXX------------------X--------------XXXXXXXXXXXXXXXXXXXXXXXXX