----------------------------------------------------------XXXXXXXXXXXXXXXX--XXXXXXXXXXXXX-----------------------------------------------------------------------
--------------------------------------------------------------X-------E-----------------------------------------------------------------------------------------
--------------------------------------------------------------X-------------------------------------------------------------------------------------------------
----------------------------------------------------XX--------X----------------------------------------------------------------------SSSSSSSSSSSSSSSSSS---?-----
----------------------------------------------------XXXX------E------------------SSS-------------------------------------------------SSSSSSSSS-------[]---------
----------------------------------------------------------------------------------E--------------------------------------------------SSSSSSSSS-------[]---------
-----------EX----------------oo------------------------------------------------------------------------XXXX------------------------SSSSSSSSSSS-------[]--XXXXXXX
----------------------------------------------------------------------------------------------------------------------------------S------------------[]---------
---------------------------------------------------------------------------------SSS---------------------------------------------SS------------------[]---------
--------------------------------------------------------------------------------------------------------------------------------SSS------------------[]---------
-------------------------------------------------------------------------------------------------------------------------------SSSS--SSS?-<><>-------[]---------
-------------------------XXX--XXXXX--XXXXXX-----------------------------------------------------------------<>----------------------------[][]-------<>---------
-------------------------XX-------------------<>----------------------------------------------------X-------[]------------E---------------[][]------------------
---------------------E------------------------[]----------------------------------------------------X-------[]-----------------B----------[][]------------------
-------------------X<>------------------------[]-------------------------------------------XX-XXX---X-------[]----------------XXXXXXXXXXXXXXXXXXEXXXXXXX--------
XXXX-XXXXXX-----XXXX[]-----------------------XXXXX-----------------------------------------X--------XXX-----XXXXXXXXXXXXXXXXXXXXXXXXXXXXXXXXXXXXXXXXXXXX--------