-------------------------------XX-XXXXXXXXXXXXXX--XXXX--------------------------------------------------------------------------------------XXXXXXXXX---------XX
-------------------------------[]---------------------------------------------------------------------------------------------------------------XXXXX-----------
-------------------------------<>----------------------------------------------------------------------------------------------------------------XXXXX----------
--------------------------------E-----------------------------------------------------------------------------------------------------------------XXXXE---------
-------------------------------------SS-----SSSSSSS------------------------------------------------------------------------------------------------XXX--XXX-----
---------------------------------------------E--E---------------------------------------------------------------------------------------------------------------
-----------------------------------------------------------------------------------------------------------------------------------XXX--------------------------
-----------------XXXXX-------------------------------------------------------------XXXX-------------------------------------------------------------------------
------------------------XXX-----------------SSSSSSS------E------------------------------------------------------------------------------------------------------
------------------------------------------------------------------------------B---------------------------------------------------------------------------------
----------oooo---------------o------------------------------------------------b------------------?------------------------------S-------------------------------
--------------------------------------------------------------------------SSSSXS-------------<>-----------------------------------------------------------------
---------------------------------------------------------------------------------------------[]-----------------------------------------------------------------
----------------------------------------------------------XX---------------------------------[]-----------------------------------o---o-------------------------
-------------------------------------------------------------------------------------------E-[]-----------------------------------X---X-------------------------
XXXXXXXXXXXXXXX---------------------------------------------------XXXXXXX--XXXXXXXXXXXXXXXXXXXXXXXX<>XXXXXXXXXXXXXXXXXXXXX--------------------------------------