----------------------------------------------------------------------------------------------------------------------X-----------------------------------------
----------------------------------------------------------------------------------------------------------------------X-----------------------------------------
----------------------------------------------------------------------------------------------------------------------X-----------------------------------------
----------------------------------------------------------------------------------------------------------------------X-----------------------------------------
------------------------------------------------------------------------SSSSSSSSSSSSSSSSSSSSSSSSSSSSS-------oo--------XX----------------------------------------
------------------------------------------------------------------------SSSS----------------------------------------EE------------------------------------------
------------------------------------------------------------------------SSSS-------------------------------------------------XXXX-------------------------------
-------------------------E----S----XXX---------------------------XX-----SSSS----oooo------------------?-----XXX--------XXXX-------------------------------------
-----------------------------------------------------------------XX-----------------------------------------------------XXX--------------------XXX--------------
---------o-----------------------------------------------------XXXX-------E---S-SSSS-S--------------------------------------------------------------------------
-----------------------------E-XX----------ooo-----------------XXXX-------E---SoS--SoS----------------XX-------------------------------XXXEXX-------------------
---------------------------------------------------------------XXXX------<>---SSS--SSS-------------------------XXX-----------------E----------------------------
------<>----<>--------------------------<>--------------------XXXXX------[]-------------------------------------------------------<>----------------------------
------[]----[]-------X------------------[]--------------------XXXXX------[]-------------------------------------------------------[]----------------------------
------[]----[]------XX------------------[]--------------------XXXXX------[]------------------------------------------------------X[]X---------------XXXXXXXXXXX-
XXXXXXXXXXXXXXXXXXXXXX------------------XXXXXXXXXXXXXXXXXXXXXXXXXXXXXXXXXXXXXXXXXXXXXXXXXX--XX--XX--XXXXXXXX----------------------------------------------------