-------------------------------------------------------------------------------------------------------------------SS--XXX-X---------------X-------------------X
--------------------------------------------------------------------------------------------------------------------S---XX-X---------------X-X------------------
--------------------------------------------------------------------------------------------------------------------S---XX--------------X-----------------------
--------------------------------------X-X-------S-S-S-S-S-S-S-S-S-S-S-S-S-S-S-S-S-S-S-S-S-S-S-S-S-S-S-S-S-S-------------XX--------------------------------------
------------------------------------X---E-------S-S-S-S-S-S---S-S-------------------------------------------------------XX------X-X-----------------------------
---------------------------------------X-------SSSSSSSSSSSSS-SSSSS-S-S-S-S-S-S-S-S-S-S-S-S-S-S-S-S-S-S-S-S--------------XX-----X--------------------------------
-----------------------------------X-----------SSSSSSSSS-SS--S-S--------------------------------------------------------XX-----X-X-X----------------------------
-----------------S----------------o------------S-S-S-S-S-SS--S-S--------------------------------------------------------XX----------------X-------X-----X-X-----
-----------------------------------------------S-S-S-S---SS-------------------------------------------------------X------X----------------------X---------------
----------o------------------------o-----------S?-o-o-o-oSS---E-----------------S----------------------------------------X-------------------------X-----X------
-----------E----S------------------------------S?-S-S-S-SSS---S-S------------->---------------------<-----X-----------------------------X------X-X--------------
--------SSSSS-------------X-X-X------------------o-o-o-o-S--E---------E-------]---<-----E---------X-[E-------------------------------------------------------o--
<>------E--------------XXE-----------------------?-S-S-S-S---S-S-------------<]---[E------------X-X-[>---X------------------------------------------------------
[]----------E----E----XXXX-X-X------------------------E------E---------------[]---[>------------XXX-[]----------------------------------------------------------
[]E------------------XXXX-----------------------X-X-X-X-X-X-X-X-X---X-X---X-X[X-X-X]X-X-X---X-X-XX--X]----------------------------------------------------------
XXXXXXXXXXXXXXXXXXXXXXXX----------------------X-X-X-X-X-X-X-X-X-----X-XX--X-X[X-X-X]X-X-XX--X-XXXX--X]----------------------------------------------------------