----------------------------------------------------------------------------------------------------------------------------------------------------------------
----------------------------------------------------------------------------------------------------------------------------------------------------------------
----------------------------------------------------------------------------------------------------------------------------------------------------------------
----------------------------------------------------------------------------------------------------------------------------------------------------------------
----------------------------------------------------------------------------------------------------------------------------------------------------------------
----------------------------------------------------------------------------------------------------------------------------------------<>----------------------
--------------------------------oooo-----------oo----------------------------------------------------------------------------------XXX--[]----------------------
----oo-------------------------XXXXX------------------------------------------?---------------------------XXXXXX-------E-----oo---------XX--------E-----------oo
---XX-------------------------------------E-------------------------------------------------------------------------------------------------------------------o-
-------------------------------------------------------X--------------------------------------------------------------------------------------------------------
--------------------------S------------SSSSSS---------XX----------------------X-----------S-----------------------------------XX--------------------------------
------XX---------------------------------------------XXX----------------------X----------------XXXXX---------------------XX-------------------------------------
--------------------------------------------o-------XXXX-------------------------------------------------------------------------------------------------XXXXX--
---------------------------------------------------XXXXX----X------------------------------------------------------XXX------------o---------<>------------------
--------------------------------------------oE-E--XXXXXX----X-------------------------XXXXXXE-------------------------------------X---------[]------------------
XXX-----XXXXXXXXXXXXXXXX--XXXXXXXXXX-XXXXXXXXXXXXXXXXXXX----XXXX<>XXXXXXXXXXXXXXXX----------------------------------------------------------[]-------XXX--------