----------------------------------------------------------------------------------------------------------------------------------------------------------------
----------------------------------------------------------------------------------------------------------------------------------------------------------------
----------------------------------------------------------------------------------------------------------------------------------------------------------------
----------------------------------------------------------------------------------------------------------------------------------------------------------------
----------------------------------------------------------------------------------------------------------------------------------------------------------------
----------------------------------------------------------------------------------------------------------------------------------------------------------------
----------------------------------------------------------------------------------------------------------------------------------------------------------------
---------SS-----------------------------------------------------------------------------------------------SQQSS-------------------------------------------------
----------------------------------------------------------------------------------------------------------------------------------------------------------------
-----------------------------------------------------------------------------------------------------------------E----------------------------------------------
---------------------E---o-----------------------------?-----------------------------B--------------------------<>--------------------SSS?------------------ooo-
------------<>------<>---------------XS------------<>--------------------------------b---------------------SS---[]----------------------------------------------
------------[]-----------------------X---E---------[]---------------------------?-B-----------------------------[]----------------------------------------------
---X--------[]--<>-------------------X-------------[]------------------------B----b-----------------------------[]----------------------------------------------
---X-EE-----[]--[]------------------EX-------------[]-----------------------------------------------------------[]----------------------------------------------
XXXXXXXXXXXXXXXXXXXXXXXXXXXXXXXXXXXXXXXXXXXXXXXXXXXXXXXXX<>XXXXXXXXXXXXXXXXXXXXXXXXXXXXXXXXXXXXXXXXXXXXXXXXXXXXXXXXXX-XXXXXXXXX--XXXXXXXXXXXXXXXXXXX-XXXXXX-----