--------------------------------------------------------------------------------------------------------------------XXX-----------------------XXXXXXXXXXXXXXXXXX
--------------------------------------------------------------------------------------------------------------------ooo--------------------------------------[]-
-------------------------------------------------------------------------------------------------------------------------------------------------------------[]-
------------------------------------------------------------------------------------------------------------------------------------------------------E------[]-
-----------------------------------------------------------------------------------------------------------------------XXXXXXXX------------X-----------------<>-
------------------------------------------------------------------------------o---------------------------------------------------------------------------------
--------------------------------XX-------------------------------------------XXX---------------------------------XX---------------------------------------------
--------------SS-----------------------------------------------------------------o------------------------------------------------------------------------------
------------------------------E---------------------------------------o---o------XXX---E-----------------------------E------------XX---E------------------------
--------------------------XXXXXX-------------------------------------XXX-XXX------------------------------------------------------------------------------------
-----------------------------------XXX--------------------------------------------------------------------------------------------------------------------------
----------------------------------------------X----------S?S----------------------------------SS----------------X-----------------------------------------------
--------------------XXXXXXX-------------------X-----------------------------------------------------------------X-----------------------------------------------
-------------------XXXXX----------------------X--------------------------------------------------------------X--X-----------------------------------------------
------------------XXXXXX----------------------X------E------------------------------------------------------XX--X-----------------------------------------------
XXXXXXXXXXXX--XXXXXXXXXX----------XXX---------X---XXXXXXXXXXXXXXXXXXXXXXXXXXXXXXX--------XXXXXXXXXXXXXXXXXXXXXXXX-----------------------------------------------