----------------------------------------------------------------------------------------------------------------------------------------------------------------
----------------------------------------------------------------------------------------------------------------------------------------------------------------
----------------------------------------------------------------------------------------------------------------------------------------------------------------
-------------------------------------------------------------------------------------------------------------------------------------------------------------S-S
----------------------------------------------------------------------------------------------------------------------------------------------------------------
-------------------------------------------------------X------------------------------------------------------------------------------------------------------S-
---------------------------------------------------S-------------S-S-S-S-------Q-X-----------------------------------------S------------------------------------
-----------------E---------------------------------------------------------------X------------------------------------------------------------------------------
----------------<>--------------------------------S-------------S-S-S-S---------QX----------------------------------------S-------------------------------------
----------------[]---------------------------------------X-X---------------------X------------------------------------------------------------------------------
----------------XXXQ-----------------------------X-X-----------X---------------?-X---------------X-------------X-S----------------------------------------------
-----------------------------------------------X-X--------X----X--------------------->-----------XX------------X-------------------X----------------------------
---------XX<>---------->-----------------E---X-X--X-X---------XX--------------E-QE---]-----------XX------------XS-S----------------XX---------------------------
--------XXX[]----------]-X-X-X-X-X-X-X-X->-X-XX-X-X-----------XX--------------------<]-----------XX------------X-----------------X-XX---------------------------
-------XXXX[]------>--<]-X-X-X-X-X-X-X-X-]-XX-X-X--X-----X----XXXX-X-X-X-X-X-X-X-X-X[X-X-X-X-X-X-XXX-X-X-X-X-X-X-X-X-X-X-X-X-X-X-XXXXX-X-X-X-X-X-X-X-X-X-X------
XXXXXXXXXX-XXXXXXX<[--[[XXXXXXXXXXXXXXXX<[XXXXX------X---X-X--XXXX-X-X-X-X-X-X-X-X-X[X-X-X-X-X-X-XXX-X-X-X-X-XEX-X-X-X-X-X-X-X-X-XXXXX-X-X-X-X-X-X-X-X-X-X------