--------------------------------------XXX------------------------------------------------------------------------------------------XX--XXXXXXXXXXXXXXXXXXXXXXXXX
--------------------------------------ooo------------------------------------------------------------------------------------------XX--XXX----------------------
-----------------------------------------------------------------------------------------------------------------------------------XXX-XXX----------------------
-----------------------------------------------------------------------------------------------------------------------------------XXX-XX-----------------------
-----------------------------------------XXXX-XXXXX--------------------------------------------------------------------------------XXX-XX-----------------------
------------------------------------------------------------------------------------------------------------------------------------------------o---------------
-----------------------------------XX---------------XXXXXXX--------------------------------------------XXXXE---------E------------------------------------------
--------------SS---------------------------------------------------ooo----------------SSS---oo-----------------E---------------------------------------oo-------
---------------------------------------E----XXX--------------------ooo---------------------XX-----------------------------XX-------------SSSS-------------------
------------------------------------------------------------------------------------------------------------------E---------------------------------------------
---XSSSSSSSSSS---------------------------------------------------XXX--------------------------------------------------------------------------------------------
--XX---------------XXXXX-------------------------------------E------------------------SS------XXXX------------------------------------------S-------------------
--XX-----------------------------E--------------------------<>--------------------------------------------------------------------------------------------------
--XX---------------------XXXXXX-<>--------------------------[]----------------------------------------------XX--------------------------------------------------
--XX----------------------------[]-------------------------X[]X------XXXXXXXXXXXXXEX----------------------------------------------------------------------------
XXXXXXXXXXXXXXX-X---------------XX---------------------------------------------------XXXXXX---------X-----------------------------------------------------------