----------------------------------------------------------------------------------------------------------------------------------------------------------------
----------------------------------------------------------------------------------------------------------------------------------------------------------------
----------------------------------------------------------------------------------------------------------------------------------------------------------------
----------------------------------------------------------------------------------------------------------------------------------------------------------------
----------------------------------------------------------------------------------------------------------------------------------------------------------------
----------------------------------------------------------------------------------------------------------------------------------------------------------------
------------------------------------------------------------------------XXXXXXX----------------------------------oo---------------------------------oooo--------
-------------------------------------------------XXX------------XXX-------------------------------------------------------E------------------------XXXXX--------
---------------------------------------------------------------------------------------------]X-----------------------------------------------------------------
----------------------------------------------------------------o-o----------------------XXX[]------XXXXXXXXXXX-------------------------------------------------
-------------------------------------------------------E--------o-o-XXX---------------------[]------------------------------------------------------------------
---------------------E-----------------------------XXXXX-------------------------E----------Q>------------------------E------E----------------------------------
-------------?QQQ---------------------------------------------------------------<>------------------------------------------------------------------------------
----------------------------------------------------------<>--------------------[]--------------------------------XXXXXX----------------------------------------
----------------------------------------------------------[]-------------------X[]X------------------------------------X-----XXXXXXXXXXX------------------------
XXXXXXXXXXXXXXXXXXXXXXXXXXXXXXXXXXXXXXXXXXXXXXXXXXXX------[]-----------------------------------------------------------X---------------X-XXXXXXXXXXXXXXX-XXXXXXX