------------------------------------------------------[]--XXXXXXXXXX<>XXXXXXXX----XXXXXXXXXXXXXXXXXXXXXXXXXX-XXXXXXXXXXXXXXXXXXXXXXXXXXXXXXXXXXXX-XXXX----------
------------------------------------------------------[]--X---[]-------------------------------------E-----------XX------oooooo------oooooooo-----XXXX----------
------------------------------------------------------<>--X---[]-------------------------------------------------XX--------------------------------XXXX---------
----------------------------------------------------------X---[]-------------------------------------------------XX------oooooo------oooooooo-------XXX---------
-------------------------------------------------XX-------X---<>-----------------------------SSSSS---------------XX----------------------------------X----------
----------------------------------------------------------X-------?-----------------------------------------------XSSSSSSSSSSSSSSSSSSSSSSSSSSSSS----------------
----------------------------------------------------------X-----------------------------------------------------------------------------------------------------
-------------------------------------------E--E-----------X------------------------------------------------------------E---------E-E--------------SS------------
----------------oo----------------------------------------X---------------------------------------------------------------E-----------E--------------------XX---
----------------------------------------------------------------------------------------------------------------------------------------------------------------
------------------------------X---------------------------------------------------------------------------------------------------------------------------------
-----------------------------XX-------X---------------------------------------------------------------------------------------------------------?----------?----
---E-------------------------XX------XXX------------------------------------------------------------------------------------------------------------------------
-----------------------------XX-----XXXX------------------------------------------------------------------------------------------------------------------------
-----------------------------XXXXXXXXXX-------------------------------------------------------------------------------------------------------------------------
XXXXXXXXXXXXXXXXXXXXXXXXX----XXXXXXXXXX-------------------------------------------------------------------------------------------------------------------------