--------------------------------XXX-----------------------------------------------------------------------------------------------------------------------------
--------------------------------ooo-----------------------------------------------------------------------------------------------------------------------------
----------------------------------------------------------------------------------------------------------------------------------------------------------------
----------------------------------------------------------------------------------------------------------------------------------------------------------------
-----------------------------------XXEXXX-----------------------------------------------------------------------------------------------------------------------
-------------------------------------E---------------------------------------XXXX-------------------------------------------------------------------------------
-----------------------------XX----------------E----------------------------------------------------------------------------------------------------------------
--------------------------E--------------E---------------------E------------------------------------------------------------------------------------------------
---------------------------------E--------------------------E------------------------------------X--------------------------------------------------------------
-------------------------------------Q-?-Q--------------------------------------------------------XX------------------------------------------------------------
-------------------------------------------------------XSSSSSSSSSSSSSSS?------------------------------------------------------------------------------------<>--
-X----------------------------------------------------XX---------------------------------------------------------------QQQQ------E----------------X---------[]--
-X--------------<>-----------------------------------XXX------oooooo------------------------------------------------------------<>----------------X---------[]--
-X--------------[]---<>-----------------------------XXXX---------------------------------------------------------------E--------------------------X---------[]--
-X--------------[]---[]-------------------------XXXXXXXX------oooooo-------------------------------------------------------------------------XXXX-X---------[]--
XXXXXXXXXXXXXXXXXXXXXXXXXXX---------------------XXXXXXXXXXXXXXXXXXXXXXXXXXXXXXXXXXXXXXXXXXXXX------------XX-XXXXXXXX<XXXXXXX<>XXXXXXXXXXXXXXX-----X---XXXXXXXXXX