--------------------------------------------------XXXXXXX<>XXXXXXX-XXXXXXXXXX-----------------X---------X-------------------------------------------------------
--------------------------------------------------[]--------------E-EE-XXXX-------------------X-----------------------------------------------------------------
--------------------------------------------------[]------------SS------XXX-------------------X-----------------------------------------------------------------
--------------------------------------------------<>------------SSS------XX----------XXXXXXXXXX-----------------------------------------------------------------
------------------------------------------------------?---------S?SS------XXXXXXX-------------------------------------------------------------------------------
--------------------------------o--------------------------------o--------------XXEX----------------------------------------------------------------------------
-------------------------------XXX--------------------------------------------------------------------------------------------------E---------------------------
----------------------XXX----------o-------------------------------------------E----------------------E-------------------------SSSSSS--------------------------
-------------------S--------o------XXXXoo-------------Q---------SSSS-------SSS---------------------E------------------------------------------------------------
---------------------------XXX----------------------------------SSSS---------------?----------------------------------------------------------------------------
----------------------------------------------------------------SSSS--------------------------------------------------------------------------------------------
----------------------------------------------------------------SSSSSS-----------------------------------------------------------SSSS--X--------------<>--------
-<>------------XXX--------------------------------------------------------------------------------------------------------------------XX--------------[]--------
-[]----------------X-----------------------------------------------------------------------------------------------------------------XXX--------------[]--------
-[]----------------X----------------------------------------------------------------------------------------X-----------------------XXXX--------------[]--------
XXXXXXXXXXXXXX-----X--X--XXXXXXXXXX----------------------------------------------------------------------------XX--XX-XXXXXXXXXXXXXXXXXXXXXXXXXXXXXXXXXXXXXXXX-X