--------------------------------------------XXXXXXXXXX--XXXXXXXXXXXXXXXXXXXXXX----------------------------XX--XXXXXXXXXXXXX]-XXXXXX-----------------------------
--------------------------------------------XXXXXXXXXX----[]-------------------------------------------------------XXXXXXXX>-XXXXXX-----------------------------
----------------------------------------------XXXXXXXX----[]-----SS--------------------------------------------------------E------------------------------------
-----------------------------------------------XXXXXXX----[]-----SS---------------------------------------------------------------------------------------------
------------------------------------------------XXXXXX----<>-----SS--------------XXXXXX-------------------------------------------------------------------------
-------------------------------------XXX---------XXXXX--------SSSSS---------XXX-------------------------------------------<>------------------------------------
--------------------------------------------------------------SSSSS-------------------------------------------------------[]------------------------------------
--------------------------------------------------------------SSSSS-------------------------------------------------------[]-----------------------S------------
--------------------------------------------------------------SSSSS--------------------oo--------------XXXXXXX------------[]------------------------------------
--X-----------------------------------------------------------SSSSS------------------------XXXX---------------------------QQQ-----------------------------------
-XX-----------------------------------------------------------SSSSS------------------------------o----o------------------------------------E------S-----?-------
XXX-----E---------------------------------SSSSSSSSSSS?SSSSSSSSSSSSS-------------------------------------------------------------------X---<>--------------------
XXX----<>-----------------------------------------------------------------------------------------------------------------------------XX------------------------
XXX-----------------------------------------------------------------------------------------------------------------------------------XX-----------E----E-------
XXX-----------------------------------------------------------------------------------------------------------------------------------XX------------------------
XXXXXXXXXXXXXXXXXXXXXX<>XXXXXXXX------------------------------------------------------------------------------------------------------XXXXXXXXXXXXXXXXXXXXXXXXXX