----------------------------------------------------------------------------------------------------------------------------------------------------------------
----------------------------------------------------------------------------------------------------------------------------------------------------------------
----------------------------------------------------------------------------------------------------------------------------------------------------------------
----------------------------------------------------------------------------------------------------------------------------------------------------------------
---------------------------------------------------------------------XXXXXXXXXXXXXXXXXX----------------------------------------------------XXXX-------------E---
---------------------------------------------------------------------XXXXXXXXXXXXXXXXXX----------------------------------------------------XXXX-----------------
-----------------------------------------E---------------------------XXXXXXXXXXXXXXXXXX----------------------------------------------------XXXX-----------------
-----S-----QQX------------------E------------------------------------XXXXXXXXXXXXXXXXXX-XX-------------------------------------------------XXXXX-------------XXX
-------------X-------------------------------------------------------XXXXXXXXXXXXXXXXXXXXX-------------------------------------------------XXXXX----------------
-------------X-----XX-----------------E------------------------------XXXXXXXXXXXXXXXXXXXXX-------------------------------------------------XXXXX----------------
-------------X-----XX------------------------------------------------XXXXXXXXXXXXXXXXXXXXX----Q------------------------------?-----------XXXXXXX----------------
-----S----E?QX-----XX--------------------------------<>--------------XXXXXXXXXXXXXXXXXXXXX-------------------------------<>-------------XXXXXXXX----------------
------------------XXX--------------------------------[]--------------XXXXXXXXXXXXXXXXXXXXX-------------------------------[]------------XXXXXXXXX-------XX<>-----
-------------E----XXX--------------------------------[]------<>-----EXXXXXXXXXXXXXXXXXXXXX---------------------E---------[]-----------XXXXXXXXXX------XXX[]-----
------------------XXX------------------------------E-[]------[]------XXXXXXXXXXXXXXXXXXXXX----------------XXXX<>XXXXXEE--[]----------XXXXXXXXXXX---XXXXXX[]-X---
XXXXXXXXXXXXXXXXXXXXX--XXXXXXX----------------XXXXXXXXXXXXXXXXXXXXXXXXXXXXXXXXXXXXXXXXXXXXXXXXXXX--XXXXXXXXXXX[]XXXXXXXXXXXXXXX<>XXXXXXXXXXXXXXX---XXXXX-XXXX---