----------------------------------------------------------------------------------------------------------------------------------------------------------------
----------------------------------------------------------------------------------------------------------------------------------------------------------------
----------------------------------------------------------------------------------------------------------------------------------------------------------------
------------------------------------------------------------------------------------------------------------------S---------------------------------------------
-------------------------------------------SSSSSSSSSSSSSSSSSSSSSSSSSSSSSSSSSSSSSSS?SSS?SSSS---------------------------------------------------------------------
-------------------------------------------------SSSS----SS--SS-------------------------------------------------------------------------------------------------
-------------------------------------------------SSSS--E-SS--SS--E----------------------------------------------XXXX---------------------XXX--------------------
----------------SQQSSS---------------SSSS---------S----SS--------SS-----oooo---oooooooo-------------------------XXX---------------------------------------------
--------------------------------------------------S----SS--------SS---------------------------------------------------------------------------------------------
--------------------------------------------------S----SS--------SS---S-SSSS-S-SSSSSSSS-------------------------------------------------------------------------
--------------------------------------E-----------So??-SS----o??-SS---SoS--SoS-SSSSSSSS--------------------------------------------------XXX--------------------
QQ-----<>--------SS------------------SSSS---------SSS--SSSS--SS--SS---SSS--SSS-------------------<>-------------------------------------------XX---------B------
-------[]------------------------------------------------SS--------------------------------------[]------------------------------------------------------b--?-B-
-------[]-------------------------------------XX---------SS-------------------------------X------[]------------XX-----------X----------------------------B----b-
-----E-[]-----------------------------------E-XX----------------------------------------E-X----E-[]----XXXXXXXXXXXXXXXXXX-XXX-XXXXXXX---------------------------
XXXXXXXXXXXXXXXXXXXXXXXXXXXXXXXXXXXXXXXXXXXXXXXXXXXXXXXXXXXXXXXXXXXXXXXXXXXXXXXXXXXXXXXXXXXXXXXXXXXXXXXXXXXXXXXXXXXXXXXXXXXXX-X---------------------XXXXXXXXXXXX