--------------------------------------------------------------------------------------------------[]-----XXXXXXXXXXXXXXXXXXXXXXXXXXXXXXXXXXXXX--XX--XXXXXXXXXXXX
--------------------------------------------------------------------------------------------------[]-------------------[]---------------------------------------
--------------------------------------------------------------------------------------------------[]-------------------[]---------------------------------------
--------------------------------------------------------------------------------------------------<]-------------------<>------E--------------------------------
--------------------------------------------------------------------------------------------------->------------>-----------------------------------------------
---------------------------------------------------------------------------------------------------EXXXXX-------------------------------------------------------
---E------------------------------------------------------------------------------------------------------------------------------------------------------------
---S-----------------------SSSSSSSSS-----------------------------------------S----------------------------------------------------------------------------------
--------E-------------------------------------------------------------------------------------------------------------------------------XXXXXXXXXXXX-------E----
---?------------------------------------------------------------------------------------------------------------------------------------------------------------
----------------------------------------------------------------X-----------S------------XXX--------------------------------------------------------------------
-------------------------------------------------QQQQQQ--------XX--QQQQ-----------------E-----------------------------------------------------------------------
---X---------------------------X------------------------------XXX-----------------------------------------------------------------------------------------------
---X---------------------------X--------------B--E--------XX-XXXX------------E---<>-----------------------------------------------------------------------------
---X----------------------E----X----------------------X---XXXXXXX----------------[]-----------------------------------------------------------------------------
XXXXXX---------XXXXXXXXXXXXXXXXXXXXXXXXXXXXXXXXXXXXXXXX---XXXXXXXXXXXXXXXXXXXXXXXXXXXXXXXXX---------------------------------------------------------------------