-------------------------------------------------------XXXXXXXXXXX------------------------XXXXXXXXXX--X-XXXXXXXXXXX<>XXXXXXXXXXXXXXXXXXXXXSSS-XXXX--------------
--------------------------------------------------------------[]---XXXX-------------------[]----E----------------------------[]-----E-----SSS-------------------
--------------------------------------------------------------<>--------------------------[]---------------------------------[]-----------SSS-------------------
------------------------------------------------------------------------------------------[]---------------------------------[]-----------SSS-------------------
----------------------------------------------------XXX-----------------------------------[]---S-----------------------------<>---------------------------------
------------------------------------------------------------------------XXX---------------<>----------------------------------------------------------E---------
--------------------------------------------------------------------------------------------------------------------------------------SXXX------------------ooo-
--QQQQ----------------------------------XXXXoo------------------------------XXXXX---------------------------------------------------------------------------XXXX
-------------------------------------------------E-----XXX------------------------------------SSSSSS-----------------------------------------------XX-----------
----------------------------------------------------------------------------------------------------------------------------------------------------------------
-----------------ooo----------------------------------------------------------------------------o---------------------------------------------------------------
QQ?SSQQQQQQ--------------------------------------------------------------------------------------------------------------------------------------------XX-------
--------------<>-------------------------------------------------------------------------------------------------------------------------------------------?----
--------------[]------------------------------------------------------------------------------------------------------------------------------------------------
----------X---[]---------------------------------------------------------------------X--------------------------------------------------------------------------
XXX--XXXXXX---XXXXXXX--XXXXXXXXXXXXXXX-------------------------------------------XXXXX---------------------------------------------------------------------XXXXX