----------------------------------------------------------------------------------------------------------------------------------------------------------------
----------------------------------------------------------------------------------------------------------------------------------------------------------------
----------------------------------------------------------------------------------------------------------------------------------------------------------------
----------------------------------------------------------------------------------------------------------------------------------------------------------------
----------------------------------------------------------------------------------------------------------------------------------------------------------------
----------------------------------------------------------------------------------------------------------------------------------------------------------------
--E-----------------------------------------------------------------------------------------------------------------------Eooo----------XXX---------------------
SSSS----------QQQ----------------------------SQSS---------------SSSS--------------------------------------S---------------XXXXX---------------------------------
----------------------------------------------------------------------------------------------------------------------------------------------------------------
-----------------------------------------------------------------------------------------------------------------------------------------------------------oooo-
-------Q------------------------------------------------------------------------------------------Q------E-EE----------------------XXXX---XXXXXXXXX--------oooo-
-------------QQQQ---------------------------SS?SS---------------S--------------------------------------------XX--XXX--XXXXXXXXXX--------------------------------
-E--------------------------------------------------------B-----------------------------Q?QQ--<>-------------XXE------------------------------------------------
------------------------------------X---------------------b------------------------<>---------[]-------------XX------------------o-----------------------XXXXXXX
------------------------------------X----------------------------EE----------------[]---------[]-------------X------------------XXX---------------XXX----X------
XXXXXXXXXXXXXXXXXXXXXXXXXXXXXXXX----X-XXXXXXXXXXXXXXXXXXXXXXXXXXXXXXXXXXXXXXXXXXXXXXXXXXXXXXXXXXXXXXXXXX-----X-------------------------------------------X------