------------------------------------------------------------------------------------------------XXXXXXXX---[]--XXXXXXXXXXXXXXXXXX-------------------------------
------------------------------------------------------------------------------------------------XXXXXXXX---[]--------[]-----------------------------------------
------------------------------------------------------------------------------------------------oooooooo---[]--------[]-----------------------------------------
------------------------------------------------------------------------------------------------oooooooo---[]--------[]-----------------------------------------
-----------------------------------------------------------------------------------------------------------[]--------<>-------ooo-------------------------------
-----------------------------------X-----------------------------------------------------------------------<>---------------------------------------------------
-----------------------------------X----------------E-----------------------------------------------------------------------------------------------------------
----------------XXXXXXX-----------XX-------SSSSSSSSSSSSS-----------------------------S------XXX---------------------------------------E-------------------------
-------------------------------E--XX----------------------------------------------------------------------------------------------------------------------------
-------------------------------XX-XX----------------------------------------------------------------------------------------------------------------------------
----------SS-------------------XX-XX-------------------------------<>-----------------S------------------------------------------------------QQQQQQQ?Q--------XX
--<>---------------------------XX-XX-------------------ES--------?-[]----------------------------------------------------------------------------------------XXX
--[]---------------------------XX-XX---------------X--<>------<>---[]---------------------------SSSSSSSSSSSSSS----------------------------------------------XXXX
--[]---<>----------------------XX-XX---------------X--[]------[]---[]--------------------------------------------------------------------------------------XXXXX
--[]---[]----------------------XX-XX---------X-----X--[]------[]---[]------------E----------------------------------------------------------XXXXXXXEXEXXXXXXXXXX
XXXXXXXXXXXXXXXXX--XX--XXXXXXXXXX-XXXXXX-----XXXXXXXXXXXXXXXXXXXXXXXX-XXXXXXXXXXXXXXXXXX----------------------------------------------------XXXXXXXXXXXXXXXXXXXX