------------------------------------------------------------------------------------------------------------------------------------------------X---[]----------
-------------------------------------------------------------------------------------------------------------------------------------------XX---X---[]----XXXXXX
------------------------------------------------------------------------------------------------------------------------------------------------X---[]----------
------------------------------------------------------------------------------------------S-----------------------------------------------------XXX-<>----------
----------------------------------------------------------------------------------------------------------------------------------XXXXX--------------E----------
----------------------------<>--------------------------------------------------------------------------------------------------------E---------------XXX-------
----------------------------[]----------------------------------------------------------XXXX----------------XXXXX-----------------------------------------------
----------------------------XX----------------------------------------------------------XXX---------------E---------------------------------------------ooo-----
--------------------------------------------------------------------------------------------------------------------------------------------------------ooo-----
-E--------------------------------------<>-------------------------------S----ooo-------------------------------------------------------------------------------
<>--S-----------------------------------[]----E-------------------------------ooo-------------------------------------------------------------------------------
[]---------------------<>--------------QQQQQQQQQ---------------B---------------------------------------------------E--------------------------------------------
[]---------------------[]--------------------------------------b---------S----------------------------------------<>--------------------------------------------
[]---------------------[]-------------------------X------------B---------S-------------XX-------------B-----------[]---<>-----X---------------------------------
[]------------E--------[]-------------------------XXXXXXXXXXXXXXXXXXX<>XXXXXXXXXXXXXXXXXXXXXXXXXXXXXXXX----------X[]X--[]-----X---------------------------------
XXXXXXXXXXXXXXXXXXXXXXXXXX------XXXXXXXXX-X-<><>--XXXXXXXXXXXXXXXXXXX[]XXXXXXXXXXXXXXXXXXXXXXXXXXXXXXXX----------------[]-----X---------------------------------