--------------------------------------------------------------------------------------------------------------------------------XXXXX--XXXXXXXXXXXXXXXXXXXXXXXXX
--------------------------------------------------------------------------------------------------------------------------------X-------------------------------
--------------------------------------------------------------------------------------------------------------------------------X----?--------------------------
--------------------------------------------------------------------------------------------------------------------------------X-----S-------------------------
--------------------------------------------------------------------------------------------------------------------------------X---------------XQQ-QQQQQ-------
------------------------------------------------------------------------------------------------E----------XXX---------------Q--X---------------XE-E------------
------------------------------------------------------------------------------------------SSSSSSSSSSSSSS-----------oooo---------X---------------X---------------
-------XX------------SS---SSS------------------------------oo----XXX---XX------------------------------------------oooo---------X---------------X---------------
--------------------------------------------------------------------------------------------------------------------------XXX---X---------------XQQ?QQQQQ-------
--------------------------------------------------------------------------------------------------E-------------------------------------------------------------
------------------------------------------X-----------------XX-------------------------------SSSSSS?SSSS--------------------------------------------------------
---------------------SS---SSS-----------QQX----------XXXX------XXX-XXXX--------------------<>---------------------XX--XX----------------------------------------
----------------B--------------------------------------------------------<>----------------[]---------------------------XXX-------------------------------------
---B-------X----b--------------------------------------------------------[]----------------[]-------------------------------------------------------------------
-----------X--------------------------EE---------------------------------XXXXXXXXXXXXXXXXXXXXXXXXXXXXXXX--------------------------------------------------------
XXXXXXXXXXXXXXXXXXXXXXXXXXXXXXXXXXXXXXXXXXXXXXXXXXXXXX-------------------XXXXXXXXXXXXXXXXXXXXXXXXXXXXXXX--------------------------------------------------------