---------------------------------------------------------XXXXXXXXXXXXXXXX-XXXXXXXXXXXXXXXXXXXXXXXXXXXXXXXXXXXXXX------------------------------------------------
---------------------------------------------------------XXXXXXXXXXXXXXXX---------------------------------------------------------------------------------------
-----------------------------------------------------------------[]---------------------------------------------------------------------------------------------
-------------------------------------------XXX-------------------<>---------------------------------------------------------------------------------------------
-SSSSSSSSSSSSSSSSSSSSSSSSSSSSSSSSSSS?SSSSS----------------------------------------------------------------------------XXX---------------------------------------
-------------------------SSSS-----------------------------QQQ?------------?-----ooo-----------------------------------------------------------------------------
-------------------------SSSS-------------------------------------------------------XXX-XXX-XXX-XXX-XXX-XXX-----------------------------------------------------
-------------------QQ------------oooo------------------------------------------------o---o---o---o---o---o------XXXX-----------XXX--------------------------SQQS
----------------------------------------------------------------------------------------------------------------o-----------------------------------------------
---------------------------------SSSS--------------XXX-------------------S----------------------------------XXX-------------------------------------------------
--------------------------E------SSSS------------------------------------------------------------------------o-------E-----oo----------o--------X---------------
-------------------QQ----SSSS-----------------------------------------------------------------------------------------------------------------QQX------------SS-
<>----------------------EE---------------XX-----------------------------------------------------------------------------------------<>--------------------------
[]--------------------------------------XXXXXX--------------------------------------------------------------------------------------[]-----------------<>-------
[]--------E----------------------------XXXX-----------------------------------------------------------------------------------------[]------EE---------[]-------
XXXXXXXXXXXXXXXXXXXXXXXXXXXXX---XXXXXXXXXX------------------------------------------------------------------------------------------XXXXXXXXXXXXXXXXXXXXXXXXXXXX