------------------XXX----------------------------------------------------------------------------------------------------------XXXXXXXXXXXXXXXXXXXXXXXXXXXXXXXXX
------------------ooo----------------------------------------------------------------------------------------------------------XXXXXXXXX------------------------
-------------------------------------------------------------------------------------------------------------------------------XXXXXXXXX------------------------
--------------------------------------------------------------------------------------------------------------------------------XXXXXXXX------------------------
---------------------XX--------------------------------------------------------------------------------E-------------------------XXXXXXX------------------------
---------------------------o---------------------------------------------------Q--------------------------------------------------XXXXXX-----------------?------
-------------XXXX------------------XXXXXXXXXXXX----------------XXXXXXXXXXE-------------------------XXXEXXXXX-----------------------XXXXX------------------------
----------------------------XXX-------------------------o-o-------------------------------------------------------------------------XXXX------------------------
-------------------E---------------------------------------------------------XX------------------------------------------------------XXX--------------SS--------
----------------------------------------------------------------------------------------------------------------------------------------------------------------
--------------------------------------------------------XXXX------------------------------------XXXXXEEXXXXXXX----------XXXX------------------------------------
-------------------------------------------------E-----------X--------------------------------------------------------------------------------------------------
------------------------------------------------<>-------------------------------------------------------------------XXX----------------------------------------
------------------------------------------------[]---XXX------------------XXXX----------------------------------------------------------------------------------
-----------------------------------------------X[]X---------------------------------XXXXXXXXXX---------------XXXXXXXXXXX----------------------------------------
XXXXXXXXXXX-----------------------------------------------------------------------------------------------------------------------------------------------------