---------------------------------------------------------------------------------?------------------------------------------------------------------------------
----------------------------------------------------------------------------------------------------------------------------------------------------------------
----------------------------------------------------------------------------------------------------------------------------------------------------------------
----------------------------------------------------------------------------------------------------------------------------------------------------------------
-----------------S-------------------------------------------------------SSSSSSSSS------------------------------------------------------------------o-----------
---------------------------------------------------------------------X-----SSSS---------S-S-S-S-------S-S-------------------S-S---------------------------------
---------------------------E-----------------------------------------X-----SSSS---------------------------------------------------------------------------------
-----SSSSSSSSSSSSS---SS?SSSSSSSS-----------------------------------XXX----------------------------------------------------------------------E-------X-----------
------------------------------------------------------------------XXXX----------------------------------------------------------<----------------o-o-o----------
-----------------------------------------------------------------XXXXX----------------?S-S-S-S-SS---SS-S-SS-------------<--?-S--[--------------------------E----
-----SSSSS-------------------E-----------------------<>---------XXXXXX------E-------X---------<---------<---------------[---<---[--------E----------------------
--------------------SSSSSSSSSSSS-----------------E-?-[]--------EXXXXXX-----SSSS-----X---------[---------[-----------E---[---[---[E-------------------X--X-------
---------------------------------------------E--<>---[]-------XXXXXXXX----EE------X-X---------[---------[---------------[---[---[>------------------------------
-----------------------------------------------------[]------XXXXXXXXX------------X-XXX-X-X-X-XEX-X-X-X-XEX-X-X-X-X-X-X-X>X-XEX-X]X-X-------------X-X-------X---
-------------------------------------E---------------[]-----XXXXXXXXXX--E---------X-XXX-X-X-X-X>X-X-X-X-X>X-X-X-X-X-X-X-X]X-X>X-X]X-X-----------X-X-------------
XXXX------------XXXXXXXXXXXXX--XXXXXXXXXXXXXXXXXXXXXXXX-XXXXXXXXXXXXXXXXXXXXXXX---XXXX--------]]--------]]--------------]]--]]--]]---------------------X-X------