------------------------XX-XXXXXXXXXXXX-------------------------------------------------------------------------------------------------------------------------
------------------------[]--------E-----------------------------------------------------------------------------------------------------------------------------
------------------------[]--------------------------------------------------------------------------------------------------------------------------------------
------------------------[]--------------------------------------------------------------------------------------------------------------------------------------
------------------------<>---------------XXXXXXXXX-------------------------------------------------------------SSSSSSSSSSSSSSSSSSSSSSSSSS-----------------------
----------------------------------------------------------------------------------------------------------------------------------------------------------------
--------------------------------------------------------------------------------------------------------------------------------------------------------XXXXX---
------------------------------------------------------XXXXoo------------------------------XX--------------------------------oooo---------------E----------------
------------------------------------------------------------------XX--------------------------------------------------------------------------------------------
--------------------------------------------------------------------------------<>----------------------------------------S-SSSS-S------------------------------
-----------------X------------------------------------------------------oo------[]----E-----XX----------------------------SoS--SoS-------S----------------------
-----------X-----X-----------------------------------------------------o-------QQQQQQQQQ---------------QQ----------QQQQQ--SSS--SSS-----XXX-------XXXX----------E
-----------X-----X--------------------------------------------------------------------------------------------------------------------EXXX--------------------<>
-----------X----EX-------------------------------------------------------------------------------------------------------------------XXXXX--XX----------------[]
XXXXXXXXXXXXXXXXXX------------------------------------------------------------------------------------------------------------------XXXXXX-------------------X[]
XXXXXXXXXXXXXXXXXX-------------------------------------------------XXXXXXXXXXXXXX-X-<><>------XXXXXXXXXXXXXXXXXXXXXXXXXXXXXXXXXXXXXXXXXXX-----------------------