----------------------------------------------------------------------------------------------------------------------------------------------------------------
----------------------------------------------------------------------------------------------------------------------------------------------------------------
----------------------------------------------------------------------------------------------------------------------------------------------------------------
----------------------------------------------------------------------------------------------------------------------------------------------------------------
----------------------------------------------------------------------------------------------------------------------------------------------------------------
----------------------------------------------------------------------------------------------------------------------------------------------------------------
-----------------------------------------------------------------------------------------------------------------------------------------E----------------------
----------------------------------------------------------------------------------XX---------Q-------------------------------------?SSS-SQS---------------------
----------------------------------------------------------------------------------XX----------------------------------------------------------------------------
--------------------------------------------------------------Q?----------------XXXX----------------------------------------------------------------------------
----------------------------------------------------X---------------------------XXXX-----------------------------------------?----------------------------QQ?-<>
----------------------------XX-------<>---------------------------------------XXXXXX---------?-----------XXX-------------<>----------E--SQS-------------------[]
B-------E------------------XXX-------[]--------------------------------E-----XXXXXXX-----<>------------------------------[]---------<>------------------------[]
b-------------------------XXXXX------[]----------<>-------------------------XXXXXXXX-----[]----------B-------------------[]---------[]------------------------[]
--------------E-------XXXXXXXXX----E-[]----------[]----------XXX-----------XXXXXXXXX-----[]------------------------------[]---------[]--------------XXXXXXXXXXXX
XXXXXXXXXXXXXXXXXXXXXXXXXXXXXXXXXXXXXXXXXXXXXXXXXXX---XXXXXXXXXX-XXXXXXXXXXXXXXXXXXXXXXXXXXXXXXXXXXXXXXXXX---XXXXXXXXXXXXXXXXXX<>XXXXXXXXXXXXXXXXXXXXXXXXXXXXXXX