-------------------------------------------------------------------XXXXXXXXXXXXXXXXXXXXXXXXX-X--XX--XXXXXXXXXXXXX-----------------------------------------------
-------------------------------------------------------------------XX-------------------------------[]-XXXXXXX--------------------------------------------------
-------------------------------------------------------------------X--------------------------------[]---XXXXX--------------------------------------------------
----------------------------------------------------------------------------------------------------<>----XXXX--------------------------------------------------
-----------------------------------------------------------------------------------------------------E------EX------XXXX----XXXXX-------------------------------
------------------------------------------------------------------------SSS-------------SSS------------------X------------------E-------------------------------
--------------------------------------E---------------------------------------------------------------------------------------------------oo--------------------
-------SSSSSSSSSQSSSSSSSSSSSSSSSSSSSSSSSSSSSSS-----------?-------------------------------------------------------------------------XXX----XX---------ooo--------
-----E--------------------------------------------------------------------SS---------------SS--------------------XXX----XXoo-----------------XXX-----ooo--------
--------------------------------------------------------------X-------------------------------------------------------------------------------------------------
-------------------------------------------------------------XX------------------------------------------------------------------------------------XXX----------
-----<>---------S----------------------------ES----------S--XXX--------------------------------------------------oo-------------------------------E-------------
-----[]------------------------------X------<>-------<>----XXXX----------------------------------------------------------------------------------<>-------------
-----[]------------------------------X------[]-------[]---XXXXX----------------------------------------------------------------------------------[]-------------
--E--[]----X-------------------X-----X------[]-------[]E--XXXXX----------------------------------------------------------------------------------[]----XXXXXXXXX
XXXXXXX----XXXXXXXXXX----------XXXXXXXXXXXXXXXXXXXXXXXXXXXXXXXX----------------------------------------------------------------------------------[]-------------