----------------------------------------------------------------------------------------------------------------------------------------------------------------
----------------------------------------------------------------------------------------------------------------------------------------------------------------
----------------------------------------------------------------------------------------------------------------------------------------------------------------
----------------------------------------------------------------------------------------------------------------------------------------------------------------
-------------------------------------------------------------------------------------------------------------------------------------SSSSSSSSSSSSSSSSSSSSSSSSSSS
----------------------------------------------------------------------------------------------------------------------------------------------------------------
-------------------------------------------------------------------------------?-------------------------------E------------------SSS---------------------------
----------------QQQ?QQQ?QQQ?QQQ?QQQ?QQQ?QQQ?QQQ?QQQ?QQQ?QQQ?QQQ?QQQ?QQQ?QQQ?QQQ?QQQ?QQQ?QQQ?QQQ?QQQ?QQQ?SQS?SSSSSSSS--------------------------------------------
----------------------------------------------------------------------------------------------------------------------------------------------------------------
------------------E---E---E---E---E---E---E---E---E---E---E---E---E---E---E---E---E---E---E---E---E---E---------------------------------------------------------
----Q-----------SSSSSSSSSSSSSSSSSSSSSSSSSSSSSSSSSSSSSSSSSSSSSSSSSSSSSSSSSSSSSSSSSSSSSSSSSSSSSSSSSSSSSSSS---------E--------------S-------------------------S-----
--------------------------------------------------------------------------------------------------------SSSSSSSSSSSS---------X--------------------------E----E--
------------------X---X---X---X---X---X---X---X---X---X---X---X---X---X---X---X---X---X---X---X---X---X----------------------X-----------------SS------<>---<>--
------------------X---X---X---X---X---X---X---X---X---X---X---X---X---X---X---X---X---X---X---X---X---X----------------------X-----------------SS------[]---[]--
---------------E--X---X---X---X---X---X---X---X---X---X---X---X---X---X---X---X---X---X---X---X---X---X----------------------X------------X----SS------[]---[]--
XXXXXXXXXXXXXXXXXXXXXXXXXXXXXXXXXXXXXXXXXXXXXXXXXXXXXXXXXXXXXXXXXXXXXXXXXXXXXXXXXXXXXXXXXXXXXXXXXXXXXXXXXXXXXXXXX--XXXXXXXXXXX--------XXXXX----XX--XXXXXXXXXXXXX