-----------------------------------------XXXXXXXXXXXXXXXXXXXXXXX--[]XXXX<>XXXXXXXXXXXXXXX-----XXXXXXXXXXXXXXXXXXXXXXXXXXXXX---------------------------------X---
------------------------------------------------------------------[]--------------------------[]---------[]-[]----------------------------------------------X---
-------------------------------------------------B------B---------[]--------------B-----------[]---------<>-[]----------------------------------------------X--X
------------------------------------------------------------------<>--------------------------[]----------E-[]----------------------------------------------X---
----------------------------------------------------------------------------------------------[]------------[]----------------------------------------------X---
----------------------------------------------------------------------?-----------------------<>------------[]--ooo--------------------Q--------------------X---
------------------------------------------------------------------------------------------------------------<>------------------------------------------oo--X---
-----------------------------XXX-X---------------------------------------------------------------------------E--------------------------------------o---XXX-X---
---------------------------------X---------------------------------------------------------------------------------------------------XX-----------ooo-------X---
--------------------XSS----------X------------------------------------------------------------------------------------------------------------------------------
--SS---------------XXX-----------X------------------------------------------------------------------------------------------------------------------------------
-------------------XXX-SS--------X-----------------------------------------------------------------------------------------------------------------X------------
-----------------XXXXX-----------X------------------------------------------------------------------------------------------------------------------------------
----------------XXXXXX--S-S------X----------------------------------------------------------------------------------------------XXXXXX--------------------------
-------------------XXX----S------X----------------------------------------------------------------------------------------------X---------XXXXXXXXX-------------
XXXXXXXXXXXXXXXXXXXXX-----XX-----X----------------------------------------------------------------------------------------------X-------------------------------