-------------------------------------------------------------------XXXXXXXXXXXXXXXXXXXXXXXXXXXXXXXXXXXXXXXXXXXXXXXXXXXXXXXXXXXXXXXXXX----XXXXX--XXXXXXXXXXXXXXXX
-------------------------------------------------------------------X------E-------X-XXX---X-XX--BEE-------------E---SSSSSSSSSSSSSSSSS-------------------[]------
-------------------------------------------------------------------X--------------X-XXX---XXXX--b-------------------SSSSSSSSSSSSSSSSS-------------------[]------
----------------------------------------------------------------------------------X-XXX----XXX--B-------------------SSSSSSSSSSSSSSSSS-------------------<>------
-----------SSSSSSS---------------------------------------------------SSS----------X-XXX-----XX----------QQ?--S------SSSSSSSSSSSSSSSSS---------------S?S---SSS---
------------------------------------------------------------------------SSSSS-------XXX-----XX----------------SSSSS-SSSSSSSSSSSSSSSSS---------------------------
------------------------------------------------------------------------------------XXX------X----------------------SSSSSSSSSSSSSSSSS-----------------E---------
------------------------------------------------QQQ----------XXXX-------------------XXX-----------------------------SSSSSSSSSSSSSSSSS---------------------------
----------------------------------------ooo--------------------------SSSSSSSSSSSSSSSXEX--------------------SSSSSSSSSSSSSSSSSSSSSSSSSS------------------SSSSS----
----------------------------------B------------------------------------------------E-EX-----------------------------SSSSSSSSSSSSSSSSS---------------------------
----------------------------------bS-----------------ooooo----------------------------XX----------------------------SSSSSSSSSSSSSSSSS---------------------------
-------------------------QQQQ------------------QQQQ-----------------------------------------------------------------SSSSSSSSSSSSSSSSS---------------------------
-----------------E----------------------------------------------------------------------------------------------------------------------------------------------
----------------<>----------------------------------------------------------------------------------------------------------------------------------------------
--------------E-[]--EE------------------------------------------------------------------------------------------------------------------------------------------
XXXXXXXXXXXXXXXXXXXXXXXXXXXXXXXXXXXXXXXXXXXXXXXXXXXXXXXXXXX-----------------------------------------------------------------------------------------------------