------------------------------------------------------------X------XXXXXX------------------------------------[]--XXXXXXXX------------------------XXXXXXXXXXXXXXX
-----------------------------------------------------X-------------------------------------------------------[]--[]---------------------------------------------
-------------------------------------------------------------------------------------------------------------[]--[]---------------------------------------------
-------------------------------------------------------------------------------------------------------------[]--[]---------------------------------------------
-------------------------------------------------------------------------------------------------------------[]--<>---------------------------------------------
-------------------------------------------------------------------------------------------------------------<>-------------------------------------------------
------------------oooooo--------------------------------------------------------------XXXXXXX-------XXX-------------------------------------------------XXX-XXX-
-----------------XXXXXXX---------------------------------------------------------------------------------------------------------------------------------o---o--
----------------------------------------------------------------------------------------------------------------------------------------------------------------
--------------------------------------------------------------XX----------------------------------------------------------------------XXXXXXXXXX----------------
-----------o----------------o----------------------------o----------------------------------XXX------------------------------XXX--------------------------------
---------------------------------------------XXXXXX------------------------XXXXXXXX-----------------------------------------------------------------------------
------------------------------------------------------------------------------------------------------------SSSS------------------------------------------------
-----------------------------------------B----------------------------------------------------------------------------------------------------------------------
----------------------------------------------------------------------------------------------------------------------------------------------------------------
XXXX-XXXXXXXXXXXXXXXXXXX-XXXXXXXXXXXXXXXXXXXXX----------------------------------------------------------------------------------X-------------------------------