---------------------------------------------------------------------------------------XXXXXXX------------------------------------------------------------------
--------------------------------------------------------------------------X[]X---------XXXXXXX-----------------------------------------X---------X--------------
---------------------------------------------------------------------------[]----------[]----X-------------------------------------X----------------------------
---------------------------------------------------------------------------<>----------[]-----------------------------------------------------------------------
----------------------------------------------------------------------------E----------[]--------------------------------------------------------------X-X------
-----------------------------------------------------E--------------------------XXX----[]------------------------------------------o---------X-----X------------
----------------------------------------------------<>--------SSSSSSSS-----------------[]-----------XX-------------------------------------------------------X--
-----------------------------------------XXXX-------[]---------------------------------[]-----------[]--------------------------------X-X-------X---------------
----------------------------------------------------[]---------------------------------[]-----------[]------------------------------X---------------------------
----------------------o-----------------------------[]------------------XX-------------<>-----------[]----------------------------------------------------------
----------------S------E-------------XX-------------[]-----------SSSSS------------------E-----------[]---------------------------oo-------------------X-X-------
-------S?S----------QSSSS-----------------------XX--[]---------<>-----------------------------------<>----------------------------o---------X-----X-------------
----------------------------------------------------[]---------[]-----------------------------------------------------<>------------------------------------X---
------------------------E---------------------------[]---------[]------------------------------------E----------------[]----------------------------------------
----------------------------------------------------XXXXXXX-XXXXXXXXXX-----------------------------XXXXXXXXXXXXXXXX-XXXXXXXXXXX---------------------------------
XXXXXXXXXXXXXXXXXXXXXXXXXXXXXXXXXXXX----------------XXXXXXXXXXXXXXXXXX-----------------------------XXXXXXXXXXXXXXXXXXXXXXXXXXXX---------------------------------