--------------------------------------------------------------XXXXXXXXXXX---XXXXXXXXXXXXXXX---------------------------------------------------------------------
---------------------------------------------------------------[]-------------------------X---------------------------------------------------------------------
---------------------------------------------------------------[]-----------------------------------------------------------------------------------------------
---------------------------------------------------------------[]-----------------------------------------------------------------------------------------------
---------------------------------------------------------------<>--------XXX------------------------------------------------------X---------------?-------------
------------------------------------------------------------------------------Q----------------XX---------------------------------------------------------------
-----------------------------------XXXXXX--------------XXXXXX--------------------------------------------oo-----------------------------------------------------
---------------------------------------------XXXX---E-------------XX------------------------------------------------E-------------------XXX-----XXX-------------
----------------------------------------------------------------------------------------------oo----------------------------------------------------------------
--------------------------------------------------------------------------------------------------------------XXXX----------------------o-o---------------------
-----------------------------o----------------------------------------------------------------------------------------------------------o-o-XXXXXXXXX---?-------
-----------------------------------------------------------------------------------------------------XXX--XX----------XX----------------------------------------
-----------------------------------------------------------------------------------------------------XX---------------------------------------------------------
-----------------<>-------------------------------------------------------------------------------------------------------------------------------------E---?---
-----------------[]------------------------------------------------------------------------------------------------ooo-------XXX--------------------------------
XXX--XXXXXXXXXXXXXXXXXXXXX-----------------------------------------------------------------------------------------XXX-------XXX---------------------XXXXXXX-XX-