--------------------------------------------------------------------------------------------------------------------------XXX-------XXXXXXXX--XXXXXXXXXXXXXXXXXX
--------------------------------------------------------------------------------------------------------------------------ooo-----------------------------[]---X
----------------------------------------------------------------------------------------------------------------------------------------------------------[]----
-----------------------------------------------------SSSS-------------------------------------------------------------------------------------------------[]----
-------------------------------------SS????SSSSSSSSSS---------------------------------------?--------------------------------XXX--------SSSSSSS------SS---<>----
-----------------------------------SS-------------------------------------------------------------------------------------------------------E---------E---------
--------------------------------SSS------------------------------------------------------------------------------XXXXXXXX---------------------------------------
--Q-----------------------------------------------------------------------------------------XX------------------------------------------------------------------
---------------------------------------------------------------------------------------------------------------------------E-------------SSSSSS------SS---------
------------<>-----------------S--------------------------------------------------------------------oooo--------------------------------------------------------
------------[]-----------------------XXXXX------------<>---------XX-----------------XXXXX-----------oooo--------------------------------------------------------
S?SQS-------XXX-------------<>------XXXXXX------------[]--------XXX------------------------------------------------------------------------------------SSSSSSSSS
----------------------------[]-----XXXXXXX------------[]-------XXXX---------------------------------------------------------------------------------------------
----------------------------[]----XXXXXXXX---XXX------[]-------XXXX------------------------------XXXXXXXXEXXXX--------------------------------------------------
----------------------------[]---XXXXXXXXX------------[]-------XXXX------------------------------------------X--------------------------------------------------
XXXXXXXXXXXXXXXXXXXXXXXXXXXXXXXXXXXXXXXXXXX---------X-[]------XXXXXXXXXXXXXXXXXXXXX--------------------------X--------------------------------------------------