--------------------------------------------------------------------------------------------------------------------------------------------------XXXXXXXXXXXXXX
------------------------------------------------------------------------------------------------------------------------------------------------------[]----XXXX
--------------------------------------------------------------------------------------------------------------------------XXX---XXXXXXXXX------XX-----<>--------
----------------------------------------------------------------------------------------------------------------------------------------------------------------
------------------------------------------------------------------oo-----------------------------------------------------------------ooo------------------------
-----------------------------------------------------------?-----XXXX-------------------------------------------------------------------------------------------
----------------XXX--------oo-----------------------------------------------------XXXXXX-----------------------------------------XXXXX--------------------------
---------------------------------E--------------------------------------------------------------------------------------------------E--------XXX----------------
----------------------------------------------------ooo------E--------XX----------------------------------------------XX-----XXXX-------------------------------
---------------------------------------------------------XXXXXX-----------------------------------------E---------------------oo--------------------------------
---------XXXXXX-----------------------------------------------------------XX--------------E----oooo----XXXXXX--o------------------?-----XXXX--------------------
---E-----------------E---XX--------XXXXX---<>--------XXXX-----ooo---------XXX-------------X---XXXX---------------------o-----------------oo---------------------
--------------------<>---------------------[]----------------------------------E----------X---------------------------------------------------------------------
--------------------[]------XXXX-----------[]-----------XXXXXXXXXX-------------X----------X---------------------------------------------------------------------
---XXXXX-----------X[]X--------------------XX--XXXXXX--------------------------X----------X----------XX---------------------------------------------------------
-----------------------------------------X-XX--X-------------------------------X----------X---------------------------------------------------------------------