----------------------------------------------------------------------------------------------------------------------------------------------------------------
----------------------------------------------------------------------------------------------------------------------------------------------------------------
----------------------------------------------------------------------------------------------------------------------------------------------------------------
------------------------------------------------------------------------------------------------------------------------------------------------------------E---
----------------------------------------------------------------------------------------------------------------------------------------------------------------
------------------------------------------------------------------------------------------------------S---------------------------------------------------------
--------------------------------------------------------------------------------------------------------------------------------------------------------------X-
--------S--------------XX---------X--------------------------S---------------X-----------------------S----------------------------------------------------------
---------------------------------XX--------------------------------------E---X------------X-S-------------------o-------------------------E------------------X-X
--------------------------------XXX------------------------------------------X------------X-----------------------------------S-------------X-------------------
-------------------------------XXXX-------------------------S----------------X----------X-XS-S--S-S-S-S-S-S-S-S-------------------------------------------------
-----QQQQQ--------------------XXXXX------------------------------------------X----------XXXX-----------------------------------------------X-X------E-----------
------------------------------XXXXX-------------------------------<>---------X--------X-XXXX-----S-S-S-S-S-S-S-S------------------------>-----------------------
-------------<>---------------XXXXX--------------------<>----E----[]---------X------X-XXXXXX--------------------------------------------]-------------------X---
-------------[]---------------XXXXXXXXX-XXX------------[]---------[]-XXXX----X------X-XXXXXX--X-X-X-X-X-X-X-X-X-X-X-X-X---X-X-X-X-X-X-X<X-----X-X-X-X-X-X-X-X---
XXXXXXXXXXXXXXXXXXXXXXXXXXXXXXXXXXXXXXXXXXXXXXXXXXXXXXXXXXXXXXXXXXXX---------XXXXXX-XXXXXX-XX-X-X-X-X-X-X-X-X-X-X-X-X---X-X-X-X-X-X-X-X[X---X-X-X-X-X-X-X-X-----