----------------------------------------------------------------------------------------XXXXXXXXXXXXXXXXXXXXXXXXXXXXXXXXXXXXXXXXXXXXXX<>XXXXXXXXXXXXXXXXXXXXXXXX
----------------------------------------------------------------------------------------[]--------------------------------------[]---------------XX---------BEE-
----------------------------------------------------------------------------------------<>--------------------------------------[]---------------XX---------b---
--------------------------------------------------------------------------------------------------------------------------------[]---------------X----------B---
------------------------------------------------------------------------------------------------Eo--------------QQQQ------------<>----------SSS--X--------------
------------------------------------------------------------------------------------------------------------------------------------?--------E------------------
------------------------------------SSSS-----?------------------------E-----------------------------------------------------------------------------------------
---SSS---------------------------------------E------------------------------------------------------------------------------------------------------------------
------------------------------------------------E-----------------------XXXoo-----------------------XX--------------------------------------SSS-----------------
-----------------------------------------------<>------------------------------XXXXXXXX-------------------------------------------------------------------------
----E------------------------------------------[]---------------------------------------------------------------------------------------------------------------
S--SSS------------QQQQQQQ------------<E--------[]------------XXXXXXXX-------------------------------------------------------------------------------------------
-------------------------------------[>--------[]---------------------------------------------------------------------------------------------------------------
----------------------------XX-------[]--------[]---------------------------------------------------------------------------------------------------------------
------------------------X---XXXXXXXXXXXXXXXXXXXXX---XXXXXXX-----------------------------------------------------------------------------------------------------
XXXXXXXXXXXXXXXXXXXXXXXXX---XXXXXXXXXXXXXXXXXXXXX---------------------------------------------------------------------------------------------------------------