----------------------------------------------------------------------------------------------------------------------XXXXXXXXXXXXXXXXXXXXXXXXXXXXXXXXXXX--XX-XX
--------------------------------------------------------------------------------------------------------------------------------X--------XXXXXXXXXX-------------
--------------------------------------------------------------------------------------------------------------------------------X---------XXX[XXXXX-------------
--------------------------------------------------------------------------------------------------------------------------------X----------XX[XXXXX-------------
--------------------------------------------------------------------------------------------------------------------------------X-----------E[XXXXX-------------
--------------------------------------------------------------------------------------------------------XXX---------------------X------------<XXXXX-------------
--------------------------------------------------------------X-----------------------------------------------------------------X-------------EXXXX-------------
----------------------------------------------------------------------------------------o-o-------------------XXXX---XX---------X--------------EXXX-------------
---------------------------------------XSSS--------------------------------------------------------XXXXX------------------------X---------------EXX-----SS------
--------------------------------------XXX-------------------------------------------------------------------X---------------------------------------------------
--?-------------oo-------------------XXXS----------------------------------E------------XXXXXXXXXX--------------------------------------------------------------
----------SS------------------------XXXXX-----------------------------------------------------------------------------------------------------------------------
---------------------E-------------XXXXXX-SSS-----XXXXXXXXXX----------------------------------------------------------------------------------------------------
-----B----------------------------XXXXXXX--------XXXXX-----X---------------------<>--XXX------------------------------------------------------------------------
---------------------------------XXXXXXXX-------XXXXXX-----X-------XXXXXXXXX-----[]-----------------------------------------------------------------------------
XXXXXXXXXXXXXXXXXXXXXXXXXX-XX-XXXXXXXXXXXXX---XXXXXXXX-----X-------XXXXXXXXX-----[]-----------------------------------------------------------------------------