-------------------------------------------------------------------------------------XXX--------XX-XXXXXXXXXXXXXXXXXXXXXXXX-------------------------------------
------------------------------------------------------------------------------------------------------------[]------XX------------------------------------------
------------------------------------------------------------------------------------------------------------<>---XXXXX------------------------------------------
------------------------------------------------------------------------------------------------------------------XXXX---S--------------------------------------
--------E----------------------------------------------------------------------------------XXX----------------------XX------------------------------------------
--------------------------------------------------------------------------------------XXX---------------------------XX------------------------------------------
----------------------------------------------------------------------------------o----------------------------------X------------------------------------------
------------E--XX---------------------------SSSSSSSSS-----SQQS--------------------o-------------------------------------------------------------------XXX-------
---------------XX-------------------------------------------------o---o---o---o---------------------------------------------------------------------------------
--------------XXX------------------------------------------------XXX-XXX-XXX-XXX-XXXX-----------------------------------------------------<>--------------------
-------------XXXX-------------------o----------------------------------------------------------------------------------------XXXXXX-------[]----E---------------
-----------<>XXXX---<>-------------------------------------SS----------------------------------------------------------------------------QQQQQQQQQ--------------
-----------[]XXXX---[]--------------------------------E---------------------------------------------------------------------------------------------------------
----------X[]XXXX---[]------------------------------------------------------------------------------------------------------------------------------------------
--------XXX[]XXXX---[]---------------------------X-----------------------------------------------------------------------------------------------------------E--
XXXXXXXXXXXXXXXXXXXXXXXXXXXXXXXXXXXXXXXXXXXX-----XXXXXXXXXXXXXXXXXXXXXXXXXXXXXXXXX-----------------------------------------------------XXXX-X-<><>-------XXXXXXX