-------------------XXXXXX---------------------------------------------------------------------------------------------------------------------------------------
-------------------XXXX-----------------------------------------------------------------------------------------------------------------------------------------
-------------------XXXX-----------------------------------------------------------------------------------------------------------------------------------------
--------------------XXX-----------------------------------------------------------------------------------------------------------------------------------------
---------------------XX--------------------------------------------------oo-----xxx----xxx----------------------------------------------------------------------
---------------------xXSS-x------------------------------------------------xxxxxx--xxxxx--x---------------------------------------------------------------------
--ooo---------------xxxxxx-x----------------------xxxxxxxx--------XXX-----xxXXXXX--XXXXX---x---------xxxxx------------------------------------------------------
-XXXXX-------------x-----E--xoo-----XXXX---XXoo--xxXXXXXX-x--------------xx-----------------x-----xxxx--X-x----------------XXXXXXXXXXXXXXXXXXXXXXXXXXXXXXXXXXXXX
------------------x------E---x------------------xx---------x------------xx-------------------x---xx--E--X--x----------------------------------------------------
---------------xxx------------xxx--xxxxx--xxxxxxx-------o---xx--------xxx---------------------x-xx---XX-X---x---------------------------------------------------
--------------xx--------------XX-xxx----xxx----x--------o-XXX-x------xxXXXXX-------------------xx----XX-X----x--------------------------------------------------
-------------xx------------------XXX---XXXX----XX--------------x----xx-------------------------<>----XX-X-----xxx-----------------------------------------------
------------xx--------------------------------------------------x--xx--------------------------[]----XX-X-----<>-x----------------------------------------------
-----------xxX---------------------------------------------------xxx---------------------------[]----XX-X-----[]--x---------------------------------------------
------E----xXX------------------------------------------------XXEXXXX--------------XXXXXXXX----[]----XX-X-----[]---xxxxxxxxxxxxxxxxxxxxxxxxxxxxxxxxxxxxxxxxxxxxx
XXXXXXXXXXXXXX----------------------XXXX-------------------------------------------------------XX-XXXXX-XXXXXXXXXXXXXXXXXXXXXXXXXXXXXXXXXXXXXXXXXXXXXXXXXXXXXXXX