----------------------------------------------------------------------------------------------------------------------------------------------------------------
-----------------------------------------------------------------------------------xxx--------------------------------------------------------------------------
-------------------------------------------xx------xx-----------------------------xx--x-------------------------------------------------------------------------
------------------------------------------xx-x----xx-x---------------------------xx----x------------------------------------------------------------------------
-------------------------------oo--------xx---x--xx---x-------------------------xx------x-ooxxx-----SSSS--------------------------------------------------------
---------------------------------xxxxxxxxx-----xxx-----xxxxxxxxxxxxxxxxxxxxxxxxxx--------xxxx--x----------------------------------------------------------E-----
-oo-----------------Eooo--------xxXXXXXXXX-----XXX-----XXXXXXXXXXXXXXXXXXXXXXXXXX--------XXXX---x----?---xxx-------------------------------------------SSSSSSSSS
--------------------XXXXX------xx----------------------------------------------------------------x--S??-xx--x---------------------------------------------------
------------------------------xx------------------------------------------------------------------x----xxX---x--------------------------------------------------
-------------------------xxxxxx--------------------------------------------------------------------x--xx------x-----------------------------ooo-------------E-E-
-------------xxxxxxxxxxxxx---XXXXX------------------------------------------------------------------xxx--------x-----ooo----------xxxx------ooo--------SSSSSSSS?
----?-------xxXXXXXXXXXXXX---------------------------------------------------------E-----E-------XX-SSSS--------x-------o----oo--xx---xx------------------------
-----------xxXXX------------------------------------------------------------------<>----<>-----------------------x--------------xx---<>-x-----------------------
-----------xXXX------------o------------------o-----------------------------------[]----[]------------------------x------------xx----[]--xxxxxxxxxxxxxxxxxxxxxxx
--------XXXXXXX-----------XXX-----------------X----------------------------------X[]X--X[]XXXXX--------------------xxxxxxxxxxxxx-----XXXXXXXXXXXXEXXXXXXXXXXXXXX
XXX-----XXXXXXX-------------------------------------------------------------------------------------XXXX--------XXXXXXXXXXXXXXXX-----XXXXXXXXXXXXXXXXXXXXXXXXXXX