----------------------------------------------------------------------------------------------------------------------------------------------------------------
----------------------------------------------------------------------------------------------------------------------------------------------------------------
----------------------------------------------------------------------------------------------------------------------------------------------------------------
-----------------------------------------------------------------------------------------------------------------------------------------------------------xx---
----------------------------------------------------------------------------------------------------------------------------------------------------------xx-x--
-----------------------------------------------------------------------------------------------------------------------------------------------------xx--xx---x-
-------------xxxxxxxxxx------------------------------------QQQ?QQQQQQQQ?QQQQ------------------------------------------------------------------xxx---xx-xxx-----x
-------------xSSSSSSSS-x-------------------------------------------------[]---------------------E--------------------------------------------xx--x-xx--SSS-----S
-------------x----------x------------------------------------------------[]-----------------E-----------------------------------------------xx----xx------------
-------------x-----------x------------------xxxx-------------------------[]-------------xxxxxxxxx----oooooo---------------xxxxx------------xx-----<>------------
------------xx------------x----------------xxXX-x-QQQQQQ-----SSSSSSSSSSS-<>----------Q--xXSSSSSS-x-----xx----------------xx----x----------xxX-----[]------------
o----------xxX----S----X---x--------------xxXXX--x------------------------------xxxx---xxX--------x---xx-x-------S?S----xx------xx-------xxEX-----XXX-----------
xx--------xx-X------E--X----x--E---------xxXXXX---x---E-----E---E--------xxx---xx<>-x-xx-X---------x-xx---x-----------xxx------<>-x----ExxXXX-----------E----E--
--x------xx--X---------X-----xxxxxxxxx--xxXXXXX----xxxxxxxxxxxxxxxxxxxxxxxE-xxxx-[]--xx--X----------xx-----xxx-------xx<>------[]--x---xxXXXX----------<>---<>--
---xxxxxxxE--X---------X------x----x--xxxXXXXXXXXXXXXXXXXXXXXXXXXXXXXXXXX<>-XXXXXXXX-XXXXX----------<>-----XX-xxxxxxxx-[]--E---[]---xxxxXXXXX----------[]---[]--
--XXXXXXXXXXXXXXXXXXXXXXXXXXX-X-XX-X--XXXXXXXXXXXXXXXXXXXXXXXXXXXXXXXXXXX[]-XXXXXXXX-XXXXXXXXXXX----[]------XXXXXXXXXXXXXXXXXXXXXXXXXXXXXXXXXXXXXXXXXXXXXXXXXXXX