----------------------------------------------------------------------------------------------------------------------------------------------------------------
----------------------------------------------------------------------------------------------------------------------------------------------------------------
----------------------------------------------------------------------------------------------------------------------------------------------------------------
----------------------------------------------------------------------------------------------------------------------------------------------------------------
----------------------------------------------------------------------------------------------------------------------------------------------------------------
----------------------------------------------------------------------------------------------------------------------------------------------------------------
---------------------E----------------------------------------------------------------------------------------------------------xxxxxx--------------------------
-----------------SSSSSS--------------------------------------------------------------------------------------------------------xx?SSS-x----------XX---oo--------
-------------------------------------------------------------------------------------------------------------------------------x-------x-------------XX---xxxxxx
--------------------------------------------xxx----------------------------------------------------------------------------xxxxx-------Ex----------------xxXXXXX
------------------E----------------xxxxxxxxxx--xx------------------------------------------------------------------------xxx--xE------<>-x-------------xxx------
x-------xxx------SSSSSS-----------xxXXXXXXEXX--X-x----xxx-----------Q--------------xxxx---------------------------------xx<>--<>---E--[]--x-----------xxXX------
-x-----xxX-x-------------xxx-----xx---------X--XX-x---xB-x------------------------xx<>-x-------------------------------xx-[]--[]--<>--[]---x---------xx---------
--x---xxXX--x-----------xx--x---xx----------X--XXX-x-xxb--x--------------------B-xx-[]--x--------------B--------------xx--[]--[]--[]--[]----x-------xx----------
---xxxxXXX---xxxxxxxxxxxxX---xxxx-----------X--XXXX-xx-BEE-xxxxxxxxxxxxxxxxxxxxxxx--[]---xxxxxxxxxxxxxxxxxxxxxxxxxxxxxx---[]--[]--[]--[]-----xxxxxxxx-----------
XXXXXXXXXXXXXXXXXXXXXXXXXX--XXXXX-----------X--XXXXXXXXXXXXXXXXXXXXXXXXXXXXXXXXXXXXXXXXXXXXXXXXXXXXXXXXXXXXXXXXXXXXXXXXXXXXXXXXXXXXXXXXXXX---XXXXXXXX-----------