----------------------------------------------------------------------------------------------------------------------------------------------------------------
----------------------------------------------------------------------------------------------------------------------------------------------------------------
----------------------------------------------------------------------------------------------------------------------------------------------------------------
----------------------------------------------------------------------------------------------------------------------------------------------------------------
----------------------------------------------------------------------------------------------------------------------------------------------------------------
------------------------------------------------------------------------------------------------------------------------------------------x-x-x-x-x-x-x-x-x-x-x-
--E---E-------------------------------X-X-X-X-X-X-X-X-X-X-X-X-X-X-X-X-X-X-X-X-X-X-X-X-X-X-X-X-X-----------------------------------------x---Q-Q-Q-Q-Q-Q-Q-Q-Q-Q-
----------------------------------------------------------------------------------------------------------------------------------------xx-x-x-x-x-x-x-x-x-x-x-x
------------E-------------x----------X-X-X-X-X-X-X-X-X-X-X-X-X-X-X-X-X-X-X-X-X-X-X-X-X-X-X-X-X------------o-------------------------x-x--x---QE?-QE?-QE?-QE?-QE?
------------<---------x-x---x-------------------------------------------------------------------------x-x---------------------S---x---<x----S-S-S-S-S-S-S-S-S-S-
------------[E------x---Xx-xX-x---------------------------------------------------------------------x-X-X-xo--------S-------------xx-x[x------------------------
------------[>------xx-xXx--Xx----------------------------------------------------------------------xxXxXx--------E-------------x--x--[>-----SXS-SXS-SXS-SXS-SXS
------------[]------Xx-X-X--X-X-x-----------------------------------------------------------------x-XxXXX---x-------x-x-x-x-x-x-xx----[]------X---X---X---X---X-
----------X-X]X-X-XxX--X----XXXx--x-x-x-x-x-x-x-x-x-x-x-x-x-x-x-x-x-x-x-x-x-x-x-x-x-x-x-x-x-x-x-x-xxXXXXX--x--x-x-x-x---X-X-X-X-Ex----[]------X---X---X---X---X-
X-X-X-X---X-X]X-X-XxX-------XXX-X-X-X-X-X-X-X-X-X-X-X-X-X-X-X-X-X-X-X-X-X-X-X-X-X-X-X-X-X-X-X-X-X-XxXXXX----X-X-X-X-Xx-x-x-x-x-x------X]X-X-X-X-X-X-X-X-X-X-X-X-
X-X-X-----XXXXXXXXXX--------XXXXXxXxXxXxXxXxXxXxXxXxXxXxXxXxXxXxXxXxXxXxXxXxXxXxXxXxXxXxXxXxXxXxXxXXXXXX--X-XxXxXxXx-----X-X-X-X------X]X-XEX-X-X-X-X-X-X-X-X-X-