----------------------------------------------------------------------------------------------------------------------------------------------------------------
----------------------------------------------------------------------------------------------------------------------------------------------------------------
----------------------------------------------------------------------------------------------------------------------------------------------------------------
----------------------------------------------------------------------------------------------------------------------------------------------------------------
-----------------------------------------------------------------------------ooo--------------------------------------------------------------------------------
-----------------------------------------------------------------------------XXXX-------------------------------------------------------------------------------
----------------------------------xxx------oo-----------------------xxxxxx--------------------------------------------------------------------------------------
---------------------------------xx--x-----------------------------xx-XXX-x--------------SQS--SSSSQ--SSSSSSSSS--------------------------------------------------
--------------------------------xx----x---------------------------xx-------x------------------------------------------------------------------------------------
-------------------------------xx-----ox--------------o--------xxxx---------x-----------------------------------------------------------------------------------
-----------------------------xxx--o-----x--------------E-----xxx-<>----------x----XXXX---------------------xxxx-------------------------------------------------
----------------------------xx<>---------x----------SSSSS--xxx-?-[]-------XX--xxxxxx-----S?S---E--S-------xx--xxx-xxx-xxx-xxx-----------------------------------
---------------------------xx-[]----------x---------E-----xx<>---[]----------XXXXXX-x--------------------xx------xx--xx--xx--xxx--------------xxx-------------E-
--------------------------xx--[]-----------x------------Exx-[]---[]------------------x------------------xx-------<>--<>--<>--<>-x-xxx--------xxX-x-------xxx----
-------xxxxxxxxxxxxxxxxxxxx---[]-----------Exxxxxxxxxxxxxx--[]---[]-------------------xxxxxxxxxxxxxxxxxxx--------[]--[]--[]--[]--xx-Exxxxxxxxx-X--xxxxxxxx--xxxx
XXXXXXXXXXXXXXXXXXXXXXXXXXXXXXXXXXXXXXXXXXXXXXXXXXXXXXXXXXXXXXXXXXX-XXX--------------XXXXXXXXXXXXXXXXXXXX------XXXXXXXXXXXXXXXXXXXX--XXXXXXXXXXXXXXXXXXXXX--XXXX