----------------------------------------------------------------------------------------------------------------------------------------------------------------
----------------------------------------------------------------------------------------------------------------------------------------------------------------
----------------------------------------------------------------------------------------------------------------------------------------------------------------
----------------------------------------------------------------------------------------------------------------------------------------------------------------
----------------------------------------------------------------------------------------------------------------------------------------------------------------
-------------------------------------------------------------------------------------------------------------------------------------xxxxx----------------------
---------------------------------------------------------------------------------------------------------------------------------xxxxx----x---------------------
-----------------?SS--------QS-----------xxxxx-----------------------------------------------------------------------------------xSSSS-----xxxx-----------------
----------------------------------------xx-<>-x----------------------------------------------------------------------------------x----------x--x----------------
---------------------------------------xx--[]--x---------------xxxxxx-----------------------------------------------xxx----------x---------<>---x-----o---------
-------------------------------------xxx---[]---x------------xxx--x--xx-------------------------------------------xxx--xx-------xx---------[]----x--------------
x------------B------------QQ?S------xx<>--QQQ?---x----------xxXX--X--X-x---------------------B-------------------xxXX--X-x-----xxX---ES----[]-----xSSS------S---
-x-----------b----B---E------------xx-[]----------x--------xxXXX--X--XX-x-------------xxx----b------------------xxXXX--XX-x---xx-X--<>---E-[]------x------E-----
--x----------B----b---------------xx--[]-----------x------xxXXXX--X--XXX-x-xxxxxxxxxxxxE-xxxxxxxxxxxxxxxxxxxxxxxxXXXX--XXX-x-xx--X--[]--<>-[]-------x-------xxxx
---xxxxxxxxxxxxxxxxxxxxxxxxxxxxxxxx---[]------E-----xxxxxxxXXXXX--X--XXXX-xxXXXXXXXXXX<>XXXXXXXXXXXXXXXXXXXXXXXXXXXXX--XXXX-xxE--X--[]--[]-[]--------xxxxxxxx---
---XXXXXXXXXXXXXXXXXXXXXXXXXXXXXXXXXXXXXX-----X-----XXXXXXXXXXXX--X--XXXXXXXXXXXXXXXXX[]XXXXXXXXXXXXXXXXXXXXXXXXXXXXX--XXXXXXXXXXXXXXXXXXXXXXXXXX--XXXXXXXXXX---