---------------------------------------XXX--------------------------------XXXXXXXXXXXXXXXXXXXXXXXXXXXXXXXXXXXXXXXXXXXX-XXX--XXXX--------------------------------
---------------------------------------XXX--------------------------------[]-XXXXXXXXXX---[]-----xxxxxxxxxxxxxxx----[]-------------XXXXXXX----------------------
--------------------------------------------------------------------------[]--XXXXXXXXX---[]----x--------------xx---[]------------X-----------------------------
--------------------------------------------------------------------------<>---XXXXXXXX---<>--------------------xx--[]------------------------------------------
----------XXX--------------------------------------------------------------E----XXXXXXX---------------------S----x--[]-----------------------XXXXXXEXXXXXXX-----
---------------------------------------------------------------------------------XXXXXX--------------------------xx-<>------------------------xxxxxE-xxxxxXXXXEX
---------------------------------oo-----------------XXXXX-----------XXX-----------XXXXX---------------------------xxxx---------XX------------x----xxx----xxxxx--
--E------------------------------------------XXXoo---------------------------------XXXX--------------oooo------------xx--------xx-----------x------------E---xxx
------------------------------------------------------------XXX---------------------XXX-------------------------------xx-XX---x-xx---------x--------------------
-----------------XXX-----------------------------------------------------------------XX--------------------------------xxxx-oxoooxxXXXX---x--------Q-?-Q----XXXX
------------------------------X-------------------------------------------------------XXXXXX------------------------------xxx-----xxxxx--x----------------------
-----XXX--------------XXXXX---------?-------------------------------------------------------------------------------------------------xxx-----------------------
----------------------------------------------------------------------------------------------------------------------------------------------------------------
----------------------------------------------------------------------------------------------------------------------------------------------------------------
----------------------------------------------------------------------------------------------------------------------------------------------------------------
XXX-----------------------------XXX-----------------------------------------------------------------------------------------------------------------------------