----------------------------------------------------------------------------------------------------------------------------------------------------------------
----------------------------------------------------------------------------------------------------------------------------------------------------------------
------------------------------------------------------------xxx-------------------------------------------------------------------------------------------------
------------------------------------------------------xxxxxxx--x------------------------------------------------------------------------------------------------
------------------------------------------------------xXXXXXX---x-----------------------------------------------------------------------------------------------
-----------------------------------------------------xxXXXXXX----x---------------------------------------------o-------------o-------------------------------xxx
----------------------------------------------------xx-XXXXXX-----x---------------------------------------------------------------xxxxxx-------------------xxx--
---------------------------------Q------------------xS-XXXXXX------x-----------------------------------------SSS-----------SSS---xx?SSS-x-----------------xxXX--
----------------------------------------------------x--XXXXXX-------x------------------------------------------------------------x-------x---------------xx-XX--
---------------------------------------------------xx--XXXXXX--------x--------------------------xxxxxx----xxxxxxxxxx----xxxxxxxxxx-------Ex-------------xxXXXX--
------------------?-------E-----------------------xxS--XXXXXX---------xxx----------------------xx-----x-xxx---x-----x-xxx---x---xE------<>-x-----------xx-XXXX--
xxx-------------------------xxxx-?----------------x----XXXXXX---------<>-x--------------------xx-------xx<>---S------xx<>---S---<>---E--[]--x---------xxXXXXXX--
<>-x-----------------------xx<>-x----------------xx----XXXXXX---------[]--x-----------------xxx-------E<>[]---------E<>[]-------[]--<>--[]---x-------xx-XXXXXX--
[]--x-------------E-------xx-[]--x----xxx-----B-xx---E-XXXXXX---------[]---x---------------xx<>------<>[][]--------<>[][]-------[]--[]--[]----x-----xx--XXXXXX--
[]---xxxxxxxxxxxxxxxxxxxxxx--[]---xxxxx--xxxxxxxx------XXXXXX---------[]----xxxxxxxxxxxxxxxx-[]--E---[][][]----E---[][][]----E--[]--[]--[]-----xxxxxx---XXXXXX--
XXXXXXXXXXXXXX<>XXXXXXXXXXXXXXXXXXXXXXX--XXXXXXXXXXXXXXXXXXXX--XXXXXXXXXXXXXXXXXXXXXXXXX<>XXXXXXXXXXXXXXXXXXXXXXXXXXXXXXXXXXXXXXXXXXXXXXXXXXXXXXXXXXXXXXXXXXXXXX