----------------------------------------------------------------------------------------------------------------------------------------------------------------
----------------------------------------------------------------------------------------------------------------------------------------------------------------
----------------------------------------------------------------------------------------------------------------------------------------------------------------
----------------------------------------------------------------------------------------------------------------------------------------------------------------
-------------------------?--------------------------------------------------------------------------------------------------------------------------------------
-------------------------------------------------------------------------------------------------------------------------------------------xxx------------------
--------ooo----------------------xxxxxx--------------------------------------------------------------------------------------------------xxx--x-----------------
----E--XXXXX--------------------xxXXX--x-----------------?SS-----XXXXXXXXXXXXXXXX-------------------------------------------------------xxXX---xxxx-------S-----
---------------------------SS--xxXXXX---x----------------------------------------------------------------------------------------------xx-XX----x--x------------
------------------------------xxXXXXX----x--------------------------------------------------------------------------------------------xx--XX---<>---x-----------
-----------------------SS----xxXXXXXX-----xxx------------------------------------------------xxxx-----------xxxx-?-------------------xxXX-XX---[]----x------X---
----------------------------xxXXXXXXX-----<>-x----------------------------------------------xx<>-x---------xx<>-x--------B--------xxxxXXX-XX---[]-----x---QQX---
--------------------B------xxXXXXXXXX-----[]--x-------E---B--------------------------------xx-[]--x-------xx-[]--x-------b------xxx--XXXX-XX---[]------x--------
--------------------b----xxxXXXXXXXXX-----[]---x----------b-------------------------------xx--[]---x---B-xx--[]---x------B-----xx<>-XXXXX-XX---[]-------x-------
------------E----xxxxxxxxx-XXXXXXXXXX-----[]---Exxxxxxxxxxxxxxxxxxxxxxxxxxxxxxxxxxxxxxxxxxx---[]---ExxxxxxE--[]----xxxxxxxxxxxxx-[]XXXXXX-XX---[]-------Exxxxxxx
XXXXXXXXXXXXXXXXXXXXXXXXXX-XXXXXXXXXXXXXXXXXXXXXXXXXXXXXXXXXXXXXXXXXXXXXXXXXXXXXXXXXXXXXXXXXXXXXXXXXXXXXXXXXXXXXXXX<>XXXXXXXXXXXXXXXXXXX--XXXXXXXXXXXXXXXXXXXXXX