----------------------------------------------------------------------------------------------------------------------------------------------------------------
----------------------------------------------------------------------------------------------------------------------------------------------------------------
----------------------------------------------------------------------------------------------------------------------------------------------------------------
----------------------------------------------------------------------------------------------------------------------------------------------------------------
------XXXX--XXX-------------------------------------------------------------------------------------------------------------------------------------------------
----------------------------------------------------------------------------------------------------------------------------------------------------------------
--------------------------------XXX-----------------------------------------------------------------------------------------------------------------------------
-------------------------XXXoo---------------------------------------XX----XXXXXXXXXXXXXXXXXXXXXXXXXXXXXXXXXXXXXXXXXXXXXXXXXXXXXXXXXXXXXXXXXXXXXXXXXXXXXXXX-----
---------------------------------------------------------------------XX-----------------------------------------------------------------------------------------
-----------------------------------------------------------------xxx-XX-----------------------------------------------------------------------------------------
----------------------------------------------------------------xxXx-XX-----------------------------------------------------------------------------------------
-------------------XXXX---------------XXXX--------E------------xxXX--XX-----------------------------------------------------------------------------------------
--------------------------------------------------------------xxXXX-xXX-----------------------------------------------------------------------------------------
-----------------------------------------------xxxxxxxxxxxxxxxxXXXX--x------------------------------------------------------------------------------------------
---E----------------------------------------XXXXXXXXXXXXXXXXXXXXXXX---xxxxxxxxxxxxxxxxxxxxxxxxxxxxxxxxxxxxxxxxxxxxxxxxxxxxxxxxxxxxxxxxxxxxxxxxxxxxxxxxxxxxxxxxxx
XXXXXX--------------------------------------XXXXXXXXXXXXXXXXXXXXXXXXXXXXXXXXXXXXXXXXXXXXXXXXXXXXXXXXXXXXXXXXXXXXXXXXXXXXXXXXXXXXXXXXXXXXXXXXXXXXXXXXXXXXXXXXXXXX