----------------------------------------------------------------------------------------------------------------------------------------------------------------
----------------------------------------------------------------------------------------------------------------------------------------------------------------
----------------------------------------------------------------------------------------------------------------------------------------------------------------
----------------------------------------------------------------------------------------------------------------------------------------------------------------
----------------------------------------------------------------------------------------------------------------------------------------------------------------
---------------------------------------------------------xxx----------------------------------------------------------------------------------------------------
-------------------------------------------------------xxx--x------------------E--------------------xxx---------------------------------------------------------
------------------------------------------------------xxXX---x----------------SQS------------------xx--x-----------------------------------------------XXX------
-----------------------------------------------------xx-XX----x-----------------------------------xx----x-------------------------------------------------------
-----------xxxx-------------------------------------xxXXXX-----x---------------------------------xx------x----------------------E-----------------xxx--xxx------
---------xxx---xx----------------------------------xx-XXXX------x------------------------------xxx--o-----x--------------------------------------xx--xxx--xxxxxx
--------xx<>--<>-x--------xxxx--------------------xxXXXXXX----X--x-----xxxx---SQS---xxx-------xx<>---------xxxxxxxxxxxxxxxxxxxxxxxxx------------xx---XXX-XXXXXXX
x------xx-[]--[]--x--E---xx<>-x------------------xx-XXXXXX----X---x---xx<>-x-------xxX-x-----xx-[]---------XXXXXXXXXXXXXXXXXXXXXXXX-x----------xx---------------
-x----xx--[]--[]---x----xx-[]--x-xxxx-----------xx--XXXXXX----XX---x-xx-[]--x-----xx-X--x---xx--[]--------------------------------X--xxxxxxxxxxx----------------
--xxxxx---[]--[]----xxxxx--[]---xx---xxxxxxxxxxxx---XXXXXX----XX----xx--[]--Exxxxxx--X---xxxx---[]--------------------------------X-XXXXXXXXXXXX----------------
XXXXXXXXXXXXXXXXXXXXXXXXXXXXXXXXXX--XXXXXXXXXXXXXXXXXXXXXXXXXXXXXXXXXXXXXXXXXXXXXXXXXXXXXXXXXXXXXXXXXXXXXXX-----------------------X-X---------------------------