----------------------------------------------------------------------------------------------------------------------------------------------------------------
----------------------------------------------------------------------------------------------------------------------------------------------------------------
----------------------------------------------------------------------------------------------------------------------------------------------------------------
----------------------------------------------------------------------------------------------------------------------------------------------------------------
----------------------------------------------------------------------------------------------------------------------------------------------------------------
-------------------------------------------------------------------------------------o--------------------------------------------------------------------------
------------------SSSS------------------------------------------------------------------------------------------------------------------------------------------
-------------------[]-----------SS-------------------------------------------------SSS-------------------------------------------------SSSS---------------------
-------------------[]-------------------------------------------------------------------------------------------------------------------------------------------
-------------S-----[]-------------------o---------------------------------------xxxxxxxxxxxxxxxxxxxxxx----------------------------------------------------------
-------------------[]---------xxxxxx------------?-------------------------oo--xxx---x-----x-----x---S-x------------------------------------xxxx-----------------
---xxxx-----xxx----<>------xxxxXXXX-xSSS---------------xxxx---SSS------------xx<>---S----SS----SS------xx-----------------------------S---xx<>-x---------------x
--xx<>-x---xxS-x---xxx--xxxxXXXXX----x----------------xx<>-x----------------xx-[]---------------------<>-x----E----------xxxx------------xx-[]--x-------------xx
xxx-[]--xxxx-S--xxxxE-xxxXXXXXX-------x---------E----xx-[]--x--------------xx--[]---------------------[]--x-------xxx---xx---x----------xx--[]---x-xxxxxxxxxxxx-
XXXXXXXXX<>XXXXXXXXXXXXXXXXXX----------xxxxxxxxxxxxxxx--[]---xxxxxxxxxxxxxxx---[]----E----------------[]---xxxxxxxx-ExxxxX----xxxxxxxxxxx---[]----xx----x----x--
XXXXXXXXX[]XXXXXXXXXXXXXXXX------XX--XXXXXXXXXXXXXXXXXXXXXXXXXXXXXXXXXXXXXXXXXXXXXXXXXXXXXXXXXXXXXXXXXXXXXXXXXXXXXX--XXXXX----XXXXXXXXXXXXXXXXXXXXXX--X-X-XX-XXX