----------------------------------------------------------------------------------------------------------------------------------------------------------------
----------------------------------------------------------------------------------------------------------------------------------------------------------------
----------------------------------------------------------------------------------------------------------------------------------------------------------------
----------------------------------------------------------------------------------------------------------------------------------------------------------------
----------------------------------------------------------------------------------------------------------------------------------------------------------------
-----------------------------------------------------------------------------------------------------XXXXXXXXXXXXXXXXXXX----------------------------------------
------------------------------------------------------------------E-----------------------------------xxxxxxxxxxxxxxxxxx---------------------------------xxxxxx-
----------------------------------------------------------------Q-Q------------------------------xxxxx-----------------xxxx-----E-SSSS----------------xxxx--X--x
------------------------------------------------------------------------------------------------xx---------XXX-------------x-E-----------------------xx--E--X---
-----------------------------------------------XXX------xx-------------------------------------xx---------------------------x-----------------------xx---XX-X---
-----------------------------------------------xxx-----xx-x---------------------------------xxxx-----------------------------x---------------------xx----XX-X---
--------------------------------------QQQQQxxxx--xxxxxxx---x----Q-Q------------------------xxXXX-------------?----------------x----SSSSSS--------xxx-----XX-X---
----------------Q?QQQ---------------------xx----------x-----x-----------------------------xx-----------------------------------x----------------xx<>-----XX-X---
-------------------------------xxx-------xx----------XX------x---------xxxxx-------------xx-------------------------------------x---------B----xx-[]-----XX-X---
E----xxxxxxxxxxxxxxxxxxxxxxxxxxx--xxxxxxxxX-------------------xxxxxxxxxx----xxxxxxxxxxxxxx---------------------------------------xxxxxxxxxxxxxxx--[]E----XX-X---
XXXXXXXXXXXXXXXXXXXXXXXXXXXXXXXX--XXXXXXXXX-----------------XXXXXXXXXXXX----XXXXXXXXXXXXXXXX-------------------------------------XXXXXXXXXXXXXXXXXXXXXXXXXX-XXXX