-----------------------------------------------XXXX-----------------------------X-X------------------------------------------------------Xx>xXxXxXxXxXxXxX[X-XEX
-----------------------------------------------xxXX-----------------------------------------------------------------------------------x-xX-<-X-X-X-X-X-XxX<X-X-X
----------------------------------------------x-xxX----------------------------X-E--------------------------------------------------x----x-x-x-x-x-x-x-x--x]----
-----------------------------------------xxxxx---xx---------------X-----------------------------------------------------------------xx-x----------<------x->x---
-------------------oo-------------xxx---xx--------xx--------------x---------------------------------------------------------------x--x-------------------x-xx---
---------------------xxxxxxxxxxxxxx--x--xQ---------xxXXXXX-----XXX-Xx-------------------X---------------------------------------x-xx--------------->-------x--x-
--------Eooo--------xxXXXXXXXXXXXXXE--xxx-----------xxxxxx---------xx---X-X-X---------------------------------------------------x-Xx---------------E---------x--
--------XXXXX------xx------------------x-----------------xx------x-x--x-x-x-x---------E--X------------------------------------x-XxX--------------------------x-x
------------------xx-------------------XX-----------------xxXXX-x----x-X-X-Xx-------X-X---------------------------------------xxXXX-----------------------------
-------------xxxxxx----------------------------------------xxxxx-----x-x-x-x--x-----x-x-----X-----------------S-------------x-XxXXX-----------------------------
-xxxxxxxxxxxxx---XXXXX-----------------------------------------------E-------xx------X-X------------------------------------xxXXXXX-----------------------------
xxXXXXXXXXXXXX---------------------------------------------------------------x--x-x--x--x--X-X----------x-x---------------x-XxXXXXX-----------------------------
xXXX---------------------------------------------------------------------------x---x---x----x-x---------x->-x-------------xxXXXXXXXS----------------------------
XXX------------o--------------------XXXX---------------------------------------x-x--------x-x---x-x-x-x--x]x--x-x-x-x-x-x-XxXXXXXXX-----------------------------
XXX-----------XXX------------------------------------------------------------------------xX-Xx-xX-X-X-XxX<X-X-X-X-X-X-X-XxXXXXXXXXX-X---------------------------
XXX---------------------------------------------------------------------------------------Xx----XxXxXxXxX[X-XxXxXxXxXxXxXxXXXXXXXXX-----------------------------