----------------------------------------------------------------------------------------------------------------------------------------------------------------
----------------------------------------------------------------------------------------------------------------------------------------------------------------
----------------------------------------------------------------------------------------------------------------------------------------------------------------
---------------------------------xx--------xx-------------------------------------------------------------------------------------------------------------------
--------------------------------xx-x------xx-x------------------------------------------------------------------------------------------------------------------
-------------------------xx----xx---x----xx---x----xxxx------------------------------------------------------------------------------------xxx------------------
-------------------xx---xx-xxxxx-----xxxxx-----xxxxx---x----------------------------------------------------------------------------------xxX-x-----------------
------------------xx-x-xx--SSSSS-----SSSSS-----SSSSS----x-------------------SS-------------------------------?SS-------------------------xxXE--x----------------
-----------------xx---xx---------------------------------x------------------------------------------------------------------------------xxEXX---x---------------
----------------xx----<>----------------------------------x----------------------------------oooooo------------------------------------xxEXXX----x--------------
--------------xxx-----[]-----------------------------------xo---------------------oo--xxxx-----xx-------------------------------------xxXXXXX-----x--ooo--------
-------------xx<>-----XXX--------------------------ES-S--E--x------QQQ---------------xx<>-x---xx-x-------------------------ooo-------xxXXXXXX---S--xx----------E
---------E--xx-[]-----------E------E---------E----<>-----X---x--B-------------------xx-[]--x-xx---x-------E---B---------------------xxXXXXXXX-----<>-x--------<>
-----------xx--[]----------<>-----<>--------<>----[]-----X----x-b--E---xxx-xxx-----xx--[]---xx-----xxx--------b--------------xxxx--xxXXXXXXXX-----[]--x---------
xxxxxxxxxxxxE--[]----------[]-----[]--------[]----[]-----X-----xxxxxxxxx--xx--xxxxxx---[]---<>-----XX-xxxxxxxxxxxxxxxxxxxxxxxx---xxxXXXXXXXXXX----[]---xxxxxxxxx
XXXXXXXXXXXXXXXXXXXXXXXXXXXXXXXXXXXXXXXXXXXXXXXXXXXXXXXXXXXXXXXXXXXXXXXX--XX--XXXXXXXXXXXX--[]------XXXXXXXXXXXXXXXXXXXXXXXXXX---XXXXXXXXXXXXXXXXXXXXXXXXXXXXXXX