----------------------------------------------------------------------------------------------------------------------------------------------------------------
----------------------------------------------------------------------------------------------------------------------------------------------------------------
----------------------------------------------------------------------------------------------------------------------------------------------------------------
----------------------------------------------------------------------------------------------------------------------------------------------------------------
----------------------------------------------------------------------------------------------------------------------------------------------------------------
---------------------------------xxx----------------------------------------------------------------------------------------------------------------------------
---------------------E---------xxx--x----------------------------------------------------------------------------------xxxx-------------------------------------
-----------------SSSSSS-------xxXX---x-----E---------------------------------------------------------------------------xSSSx------------------------------------
-----------------------------xx-XX----x---<>---------------xx----------------------------------------------------------x----x-----------------------------------
----------------------------xxXXXX-----x--[]--------------xx-x---------------------------------------------------------x-----x----------------------------------
------------------E--------xx-XXXX------x-XXX------------xx---x----------------------------ooo------------------------xx---E--x---------------------------------
-xxxx------------SSSSSS---xxXXXXXX-------x--------------xx-----xxx---------------------xxxx------------------xxx-----xxX--<>---x--------------------------------
xx<>-x------E------------xxXXXXXXX--------x-xxxxxx----xxx------<>-x-------------------xx<>-x----------------xxX-x---xx-X--[]----xx------------------------------
x-[]--x-----------------xxXXXXXXXX---------xx<><>-x--xx<>------[]--x------------xxxxxxx-[]--x--------------xx-X--x-xx--X--[]---<>-x---------------xxxx----------
--[]---xxxxxxxxxxxxxxxxxxXXXXXXXXX----------x[][]--xxx-[]------[]---xxxxxxxxxxxxx----x--[]---xxxxxxxxxxxxxxx--X---xxE--X--[]---[]--xxxxxxxxxxxxxxxx---xxxxxxxxxx
XXXXXXXXXXXXXXXXXXXXXXXXXXXXXXXXXXXXXXXXXXXXXXXXXXXXXXXXXXXXX--XXXXXXXXXXXXXXXXXX-XX-XXXXXXXXXXXXXXXXXXXXXXX--XXXXXXXXXXXXXXXXXXXXXXXXXXXXXXXXXXXXX---XXXXXXXX<>