----------------------------------------------------------------------------------------------------------------------------------------------------------------
----------------------------------------------------------------------------------------------------------------------------------------------------------------
----------------------------------------------------------------------------------------------------------------------------------------------------------------
----------------------------------------------------S-?-S-S-S-S-S-S---------------------------------------------------------------------------------------------
----------------XX----------------------------------------------S-S---------------------------------------------------------------------------------------------
---------------------------------------------------S-S-S-S-S-S-SSSSS--------------------------------------------------------------------------------------------
-------------------------------------------SSSSSQ-S------------SSSSS--S-S-S-S-S-S-S---------------------------------------------------------S-S-S-S-S-S---------
-----------XXX----------E-----------------------------x-x-x----SSSSS-------------------------------------------------------------------------------E------------
-------------------------------------------------S--x-x--------SSSSS---S-SxSxSxSxS----<------------------------------------------------------S-S-S-S-S----------
---------------------------X----------------------x-X-Xx-x--x--SSSSS----x-x-S-S-------[---------------------------------------------o---o-----------------------
---------------E---------------------------SSSSS--xxXxX----x>-xS-SSS--x-x-Sx-x-x--x---Q>Q-Q-------------------------------------------------x-x-----Q-Q---------
-----XXXX----------------------------B----------x-XxXXX-----]x-S-SSS--x->x-S-S-S-x-----]------------------------------------Q-Q-Q----o---ox--------E------------
-------------------------------------b---------xxxXXXXX----<]---x-SSx--x]S----------xQxQxQx-----------------------------------------------xx-x--x--Q-?-Q--------
---------------------------------xxxxxxxxxxxxxxxXxXXXXX----[]--x--xSxx-<]---------Ex--x-----x-x-x-x-x-x-x-x-x-x-x-x-x-x-x-x-x?xQx-x-x-x-x--x---x--x-x-x-x-x-x-x-
------------------------------XXXXXXXXXXXXXXXXXXXXXXXXX---X[X-X-X-XSXxX[X-X-X-X-X-X-X-XxXxX-X-X-X-X-X-X-X-X-X-X-X-X-X-XBX-X-X-X-X-X-X-X-Xx------X-X-X-X-X-X-X-X-
XXX---------------------------XXXXXXXXXXXXXXXXXXXXXXXX--X-X[X-X-XxXxX-X[X-X-XEX-XEX-Xx----XxXxXxXxXxXxXxXxXxXxXxXxXxXxXxXxXxXxXxXxXxXxXxXx------XxXxXxXxXxXxXxXx