----------------------------------------------------------------------------------------------------------------------------------------------------------------
----------------------------------------------------------------------------------------------------------------------------------------------------------------
----------------------------------------------------------------------------------------------------------------------------------------------------------------
----------------------------------------------------------------------------------------------------------------------------------------------------------------
----------------------------------------------------------------------------------------------------------------------------------------------------------------
---------------------------------------------------------------------------------------------------------------------------------------------------------------x
-------------------------------------------------------------------------------------------------------------------------------------------------------------xxx
---------------------------------------------------------------------------------E------EX------------------------------------------------------------------xxXX
-----------------------------------------------------------------------------------------X-----------------------------------------------------------------xx-XX
-----------------oooooo--------------------------------------------------------------X---X----------------XXXXXXXXXXXXXXXXXXXX---XXX---XXX------------xxxxxxX-XX
--------xxxxxx-----xx-----------------------------------------E------Q--xxx----------XSS?X----------------xxxxxxxxxxxxxxxxxxxx---xxx---xxx-----------xx---x-X-XX
-------xxXSSS-x---xx-x------------------------------------------xxxx---xxX-x-----------------------------x-------------------xxxx--xxxx--xx---------xx----X-X-XX
------xx-X-----x-xx---x-------------E--------------------------xx<>-x-xx-X--x---------------------xxxxxxx---------------------------------xx------xxx-----X-X-XX
-----xx--X------xx-----xxx---------------B-xxxxx--------------xx-[]--xx--X---xxxxxxxxxxxxxxxxxxxxxx>---------------------------------------xxx---xx<>---X-X-X-XX
xxxxxxE-EX------<>-----XX-xxxxxxxxxxxxxxxxxx--X-xxxxxxxxxxxxxxx--[XX-XXXXXXXXXXXXXXXXXXXXXXXXXXXXX<]------------------------------------------xxxx-[]---X-X-X-XX
XXXXXXXXXXXXXX--[]------XXXXXXXXXXXXXXXXXXXX--XXXXXXXXXXXXXXXXXXXXXX-XXXXXXXXXXXXXXXXXXXXXXXXXXXXX[]------------------------------------------XXXXXXXXX-X-X-X-XX