----------------------------------------------------------------------------------------------------------------------------------------------------------------
-------------------------------------------------------------------------------------------------------------------------------------------------------------X--
-------------------------------------------------------------------------------------------------------------------------------------------------------------o--
------------------------------------SS---------------XXXX-------------------------------------------------------------------------------------------------------
------------------------------------[]----------------[]--------------------------------------------------------------------------------------------------------
------------------------------------[]----------------[]--------------------------------------------------------------------------------------------------------
------------------------------------<>----------------[]----------Eoo--oo------------------------------------------oo-------------------------------------------
------------------------------------------------------[]----------XXX-------------------------------------------------------E-----E-SSSQSSSSSSSS----------------
-------------------------------------E----------------[]-----------------------------------------------------------------xxxxx----------------------------------
----------------------------------xxxx----------------[]--------------------xx------------------------------------------xx----x-------------------------------XX
--------------------xxxxxx-------xx<>-x-QQQQQQQQQQQQ--<>-----xxxxxxxxxx----xx-x--X----------------------xxxxxxxxxxxx---xx------x----------E--E----------------xx
xx-----------------xxX--X-x-----xx-[]--x--------------------xxXXXXXXXX-x--xx---x--------------oooooooooxxXXXXXXXXXX-x-xx--------x----SSSSSSSSSSS----xx-------x--
--x---------------xxXX--XX-xx--xx--[]---x---------E--------xxXXX--------xxx-----x---------------------xx-------------xx----------x-----------------xx-x-----x---
-X-x-------------xxXXX--XXXX-xxx---[]----xxxxxxxxxxxxxxxxxxxXXX---------XXX------xxxxxxxxxxxxxxxxxxxxxx-------------XXXX----------x---------xxx---xx---x-xxx----
-X--xxxxxxxxxxxxxxXXXX--XXXXXXXXXXXXXXXXXXXXXXXXXXXXXXXXXXXXXXX-----------------XXXXXXXXXXXXXXXXXXXXXXX----------------------------xxxxxxxxxx--xxxx-----xx------
XXXXXXXXXXXXXXXXXXXXXXXXXXXXXXXXXXXXXXXXXXXXXXXXXXXXXXXXXXXXXXX-----------------X---------------------X----------------------------XXXXXXXXXX--XXXX-----XX------