----------------------------------------------------------------------------------------------------------------------------------------------------------------
----------------------------------------------------------------------------------------------------------------------------------------------------------------
----------------------------------------------------------------------------------------------------------------------------------------------------------------
----------------------------------------------------------------------------------------------------------------------------------------------------------------
--------------------------------------------------------------------------------------------------------------------------XXXX----------------------------------
---------------------------------------xxx----------------------------------------------E-----------------------------------------------------------------------
---oo--------------------------------xxx--x--------oo---------------------------------------------------------o-o----------------------------------------------x
---XXX------------------------------xxXX---x-------------------?-----------------------------------XXXooXXoo--------------------------------------------------xx
-----------------------------------xx-XX----x---------------------------------------XXX----------------------------------------------------------------------xx-
----------------------------------xxXXXX-----x--------------------------------------------------------------------------------------------------------------xxXX
----------------E----------------xx-XXXX------xxx----------------------------------------------------------------------------------------------------------xx-XX
---------------?Q?--------------xxXXXXXX------<>-x----------Q--Q--------Q----------------XXXXXXXX-------------XXX-----------------------------------------xxXXXX
-------------------------------xx-XXXXXX------[]--x------------------------------------------------------------------------------------------------------xx-XXXX
---------------B-------x------xx--XXXXXX------[]---x-------------------------------------------------------------------------------------------xxx------xx--XXXX
------E---E----b-B------xxxxxxx---XXXXXX------[]-E-Exxxxxxxxxxxxxxxxxxxxxxxxxxxxxxx--------------------------------------------------E---xxxxxxx--xxxxxxx---XXXX
XXXXXXXXXXXXXXXXXXXXXXXXXXXXXXXXXXXXXXXXXXXXXXXXXXXXXXXXXXXXXXXXXXXXXXXXXXXXXXXXXX----------------------------------------------XXXXXXXXXXXXXXXX--XXXXXXXXXXXXXX