----------------------------------------------------------------------------------------------------------------------------------------------------------------
----------------------------------------------------------------------------------------------------------------------------------------------------------------
-----------------------------XXXX-------------------------------------------------------------------------------------------------------------------------------
-----------------------------xxx--------------------------------------------------------------------------------------------------------------------------------
-------------------------XX-x--xx----XXX------------------------------------------------------------------------------------------------------------------------
-------------------------xxx----xx---xxx-------------------------------------------------------------------------oo---------------------------------------------
------------------------x--------xx-x--xx-----------------XX-----------------------------------------------------oo---------------------------------------------
-----------------------x----------xx----xx-------------------------------------------xx-------------------------------------------------------------------------
----------------------x------------o-----xx-------------E---------------------------xx-x-------------xxxx---xxx-------------------------------------------------
--xx-----------------x--oo--oo------------xxXXXXXXXXXXXXXX-------------------------xx---x-----oo----xx---xxxx--x-----------------------------------------------x
-xx-x------------xxxx----------------------xxxxxxxxxxxxxx----XXX-----------------xxx-----x----oo---xx---XXXXX---x---?---xxx-------------oo---xxxx------------xxx
xx---x---------xxx---------------------------------------x----------------------xxXX------x-------xx-------------x-----xx--x-----------o--o-xx-X-x---------xxx-?
x-----x-------xx<>----------------------------------------x--------------------xxXXXX------xxxxxxxx---------------x---xx----x-----E--------xx--X--x--E----xx<>--
X------x-xxx-xx-[]-----------------------------------------x--xxxx-----xxxxxx-xxXXXXXX-----XXXXXXXXX---------------x-xx------x---<>-------xx---X---x-----xx-[]--
X-------xx--xx--[]------------------------------------------xxx---xxxxxx-----xxXXXXXXXX----X----------------XXX-----xx--------xxxxxxxxxxxxx----X----xxxxxx--[]--
X-------XX--XXXXXX------------------------------------------XXX---XXXXXX----XXXXXXXXXXXX---X------------------------XX------XXXXXXXXXXXXXXX--XXXXXXXXXXXXXXXXXXX