----------------------------------------------------------------------------------------------------------------------------------------------------------------
---------------------------------------------------------------------------------------------------------------------------------------------------------xxxx---
--------------------------------------------------------------------------------------------------------------------------------------------------------xx---x--
-------------------------------------------------------------------------------------------------------------------------------------------------------xx-----x-
------------------------------------------------------------------------------------------------------------------------------------------------------xx-------x
-------------------------------------------------------oo--------------------------------------------------------------------------------------------xx------E--
-------------------------------------------------------oo------------------------------------------------------------------------------------------xxx----------
----SSSSSSSSSSSSS----------------------------------------------------------------------------------------------?SS---------------------------?----xxXX----------
--------------------------------------------------xxx--------------------------------------------xx----------------------------------------------xx-XX----------
--------xxxxxxx-----------------xxx----------xxxxxx--x------------------------------------------xx-x-----------------------------------------xxxxxX-XX----------
------xxxSSSSS-x------X-------xxx--x--------xx-XXXX---x---?---xxxx-----------------------------xx---x-------------------------------------xxxx--x-X-XX----------
----xxxSS-------x--QQQX------xxXX---xE-----xx----------x-----xx---xxxxxxxxxxxxxxxxx-----------xx-----xxx--------------------------------xxx--S--X-X-XX----------
x--xx<>----------x---------ExxXXX----x----xx------------x---xx----XXXXXXXXXXXXXXXX-x--------xxx------<>-x---E---B----------------------xx<>-----X-X-XX----------
-xxx-[]-----------x--------xxXXXX-----xxxxx--------------x-xx-----------------------x------xx<>------[]--x------b---------------------xx-[]---X-X-X-XX----------
--x--[]----E---EE--xxxxxxxxxXXXXX----XXXXXX-------XXX-----xx-------------------------xxxxxxx-[]------[]---xxxxxxxxxxxxxxxxxxxxxxxxxxxxx--[]E--X-X-X-XX------XXXX
XXXXXXXXXXXXXXXXXXXXXXXXXXXXXXXXX-------------------------XX-------------------------XXXXXXXXXXXXXX--XXXXXXXXXXXXXXXXXXXXXXXXXXXXXXXXXXXXXXXXXX-X-X-XX------XXXX