---------------------------------------------------------------------------------------------------XX---------------X-----XXXXXXXXXXXXXXXXXXXXXX----XXXXXX------
---------------------------------------------------------------------------------------------------xx--XXXXX--------------XXXXXXXXXXXXXXXXXXXXXX----XXXXXX------
--------------------------------------------------------------------------------------------------x-xxxxxxxx----------------E-----B---xxxxxxxxxX----XXXXXX------
-------------------------------------------------------------------------------------------------x---------xx---------------------b--x--------xx----XXXXXX------
-------------------------------------------------------------XXX---------XXXXX----XX---------XX-x-----------xx-------------<>-----B-x----------xx---XXXXXX-----X
--------------------------------------------------------------xx----------xxxx----x----------xxx-------------xx------------[]-----xx------------xx--xXXXXX------
-------------------------------------------------------------x-xx--------x---xxxxxxx--------x-----------------xx-E---------[]----x---------------xxxxxXXXX-----x
-------------------------------Q----------------------------x---xx------x----------xx------x-------------------xxx---------[]---x--------------------xxXXX----x-
------------oo---------------------------------------------x-----xx----x------XXoo--xxXXX-x----------------------xx-E--E---[]--x----------------------xxXX---x--
-----------------------xxxx-------------------------------x-------xx--x--------------xxxxx--oo--------------------xx---x---XX-x------------------------xxx--x---
--------------oo-----xxx---x----------------------------xx---------xxx---------------------------------------------xxxxxxxxxxx---------------------------xxx----
--------------------xx<>----xx-?------S----------------xx-------------------------------------------------------------------------------------------------------
--------E----------xx-[]---<>-x-----------------E-----xx--------------------------------------------------------------------------------------------------------
x------<>---------xx--[]---[]--x---------------------xx---------------------------------------------------------------------------------------------------------
-xxxxxxxxxxxxxxxxxx---[]---[]---xxxxxxxxxxxxxxxxxxxxxx----------------------------------------------------------------------------------------------------------
XXXXXXXXXXXXXXXXXXXXXXXXXXXXXXXXXXXXXXXXXXXXXXXXXXXXXX----------------------------------------------------------------------------------------------------------