----------------------------------------------------------XX-XXXXXXXXXXXXXXXXXXX[]XXXXXX[]XXXXXX[]XXXXXX[]XXXXXX[]XXXXXX[]XXXXXX[]XXXXXX[]XXXXXX[]XXXXXX[]XXXXXX
----------------------------------------------------------[]----XXXXXXXXXXXXXXXX<>XXXXXX<>XXXXXX<>XXXXXX<>XXXXXX<>XXXXXX<>XXXXXX<>XXXXXX<>XXXXXX<>XXXXXX<>XXXXXX
----------------------------------------------------------[]----XXX------------xxxx-S--xxxx-S--xxxx-S--xxxx-S--xxxx-S--xxxx-S--xxxx-S--xxxx-S--xxxx-S--xxxx-S--x
----------------------------------------------------------[]----XXX-----------x---xxS-x---xxS-x---xxS-x---xxS-x---xxS-x---xxS-x---xxS-x---xxS-x---xxS-x---xxS-x-
----------------------------------------------------------<>----XXX----------x-----xxx-----xxx-----xxx-----xxx-----xxx-----xxx-----xxx-----xxx-----xxx-----xxx--
--------------------------------------o-o-----------------xx----XXX---------x-----------------------------------------------------------------------------------
-------------------------------------XXXXX---------------x-xx---XXXS-------x--------S-------S-------S-------S-------S-------S-------S-------S-------S-------S---
-------------------------------------------o------o-----x---xx--EXX-------x-------------------------------------------------------------------------------------
------------E-o---o---o---o---o---o--------XXXX-----xxxx-----xxxxEX------x--------------------------------------------------------------------------------------
-------------XXX-XXX-XXX-XXX-XXX-XXX-------------xxxx-----------xxXS----x---------------------------------------------------------------------------------------
------------------------------------------------xxXXX------------xxx---x----------------------------------------------------------------------------------------
--------xxx---------------------------------xx-xx------------------xxxx-----------------------------------------------------------------------------------------
-------xxX-x-------------------------------xx-xx----------------------------------------------------------------------------------------------------------------
------xx-X--x-----------------------------xx--XXXX--------------------------------------------------------------------------------------------------------------
---xxxx--X---xxxxxxxxxxxxxxxxxxxxxxxxxxxxxx---------------------------------------------------------------------------------------------------------------------
XXXXXXXXXX---XXXXXXXXXXXXXXXXXXXXXXXXXXXXXX---------------------------------------------------------------------------------------------------------------------