----------------------------------------------------------------------------------------------------------------------------------------------------------------
----------------------------------------------------------------------------------------------------------------------------------------------------------------
--------------------------------------------------------------------------------------------------------------------------------------------------------------xx
--------------------------------------------------------------------------------------------------------------------------xxxxxxxxxxxxxxxxxxxxxxxxxxxxxxxxxxxxx-
--------------------------------------------------------------------------------------------------------------------------xXXXXXXXXXXXXXXXXXXXXXXXXXXXXXXXXXXXX-
--------------------------E----------------------------------------xxx---------------------------------------------------xxXXXXXXXXXXXXXXXXXXXXXXXXXXXXXXXXXXXX-
---------------------SSSSSSSSSSSSS-------------------------------xxx--x-------------------------------------------------xx-XXXXXXXXXXXXXXXXXXXXXXXXXXXXXXXXXXXX-
----------------------------------------xxxxS-------SSS---------xxXX---x-------------E----------------------------------xS-XXXXXXXXXXXXXXXXXXXXXXXXXXXXXXXXXXXX-
---------------------------------------xx--xxx-----------------xx-XX----x-----------SSSS--------------------------------x--XXXXXXXXXXXXXXXXXXXXXXXXXXXXXXXXXXXX-
----------------------------E---------xx------x-xxx-----------xxXXXX-----x---------------------------------------------xx--XXXXXXXXXXXXXXXXXXXXXXXXXXXXXXXXXXXX-
--xxx----------------SSSSSSSS?SSSS-xxxx----E-EExx--xx--------xx-XXXX------xxx---X-E--E--------------------------------xxS--XXXXXXXXXXXXXXXXXXXXXXXXXXXXXXXXXXXX-
ExxX-x----------------------------xxXXX--------XX-XX-x------xxXXXXXX------<>-x--XS?SSSSS---X--------------------------x----XXXXXXXXXXXXXXXXXXXXXXXXXXXXXXXXXXXX-
xx-X--x--------------------------xx------------XX-XX--x----xx-XXXXXX------[]--x---------EE-X--------------B----------xx----XXXXXXXXXXXXXXXXXXXXXXXXXXXXXXXXXXXX-
x--X---xxxxxxxxxxxxxxxxxxxxxxxxxxx-------------XX-XXX--x--xx--XXXXXX------[]---xSSSSSSSSSSSX--------------b---------xx---E-XXXXXXXXXXXXXXXXXXXXXXXXXXXXXXXXXXXX-
XXXXXXXXXXXXXXXXXXXXXXXXXXXXXXXXXX-------------X--XXX--Exxx---XXXXXX------[]----xxxxxxxxxxxxxxxxxxxxxxxxxxxxxxxxxxxxx------XXXXXXXXXXXXXXXXXXXXXXXXXXXXXXXXXXXX-
XXXXXXXXXXXXXXXXXXXXXXXXXXXXXXXXXX-------------X--XXXXXXXXXXXXXXXXXXXXXXXXXXXXXXXXXXXXXXXXXXXXXXXXXXXX<>XXXXXXXXXXXXXXXXXXXXXXXXXXXXXXXXXXXXXXXXXXXXXXXXXXXXXXX-