----------------------------------------------------------------------------------------------------------------------------------------------------------------
----------------------------------------------------------------------------------------------------------------------------------------------------------------
----------------------------------------------------------------------------------------------------------------------------------------------------------------
----------------------------------------------------------------------------------------------------------------------------------------------------------------
----------------------------------------------------------------------------------------------------------------------------------------------------------------
----------------------------------------------------------------------------------------------------------------------------------------------------------------
-----------oo------------------------------------E--------------------------------------------------------------------------------------------------------------
------------------------------------------------SQS-----------------SSSS------------------------------------SQQS---------------Q--------------------------------
---------------------------------------------------------xxxxx---------------------------------------------------------------------------------------xxxx-------
--------------------------------------------------------xxXSS-xo------------------------------------------------------xxxxx-------------------------xx---x------
-----xxxx---------xxxx---------------------------------xxXXX---x------------------oooooo-----------------------------xx----x------------E----------xx-----x-----
----xx<>-x-------xx<>-x-------------------------SQS---xxXXXX-SS-x----E-----------o---------------------------SS-----xx------xx-?-------<>--------xxx-------x----
x--xx-[]--x-----xx-[]--x-----------------------------xxXXXXX-----x---E---------------------E----------------------xxx------<>-x-----------------xx<>--------x---
-xxx--[]---x---xx--[]---x------------------xxxx-----xxXXXXXX--SSS-x----------------------------------------------xx<>------[]--x-------------B-xx-[]---------x--
--x---[]-E-Exxxx---[]----xxxxxxxxxxxxxxxxxxxEEExxxxxxXXXXXXX-------xxxxxxxxxxxxxxxxxxxxxxxxxxxxxxxxxxxxxxxxxxxxxxx-[]--E---[]---xxxxxxxxxxxxxxxx--[]-E--------xx
XXXXXXXXXXXXXXXXXXXXXXXXXXXXXXXXXXXXXXXXXXXXXXXXXXXXXXXXXXX------XXXXXXXXXXXXXXXXXXXXXXXXXXXXXXXXXXXXXXXXXXXXXXXXXXXXXXXXXXXXXXXXXXXXXXXXXXXXXXXX-XXXXXXXXXXXXXX