----------------------------------------------------------------------------------------------------------------------------------------------------------------
----------------------------------------------------------------------------------------------------------------------------------------------------------------
----------------------------------------------------------------------------------------------------------------------------------------------------------------
----------------------------------------------------------------------------------------------------------------------------------------------------------------
-------------------------------------------------------------------------------------------------------------------------------xxxx-----------------------------
------------------------------------------------------------------------------------------------------------------------------xx---x----------------------------
-----------------------------------------------------------------------------------------------------------------------------xx-----x----xxxxx------------------
---------XQQ?QQX-------------------------------------------------------------------------------------------------------?----xx-------x--xxXXX-x-----------------
---------X-----X-----------------------------------------------------------------------------------------------------------xx---------xxxXXXX--x----------------
---------X-----X------------------xxxxx--------------------------------------------------------------------------------xxxxxX----------xEXXXX---x---------------
EXXX-----XE-E--X-----------------xx----x-----------------------------<>---------------------------------------------xxxx--x-X----------XXXXXX----x--------------
xx-------XQQ-QQX----------------xx------xx-------xxxxx---------------[]-------------------------------------------xxx--S--X-X---------XXXXXXX-----x-------------
--x---------------------------xxx------<>-x-----xx----x--------------[]---------------------------B--------------xx<>-----X-X-------EXXXXXXXX------x-----------x
---x-----------E-------------xx<>------[]--x---xxX---X-x-------------[]---------------------------b------xxx----xx-[]---X-X-X-------XXXXXXXXX-------x---------xx
----xxxxxxxxxxxxxxxxxxxxxxxxxx-[]--E---[]---xxxx-X-E-X--xxxxxxxxxxxxx[]----xxxxxxxxxxxxxxxxxxxxxxxxxxxxxxx--xxxxx--[]E--X-X-X------XXXXXXXXXX--------xxxxxxxxxx-
---XXXXXXXXXXXXXXXXXXXXXXXXXXXXXXXXXXXXXXXXXXXXXXXXXXXXXXXXXXXXXXXXXXXXXXXXXXXXXXXXXXXXXXXXXXXXXXXXXXXXXXX--XXXXXXXXXXXXX-X-X---XXXXXXXXXXXXXXXXXX---XXXXXXXXXX-