----------------------------------------------------------------------------------------------------------------------------------------------------------------
-------------------------XXEXXXX--------------------------------------------------------------------------------------------------------------------------------
----------------------------xxx------------------------------------------------------------------------------------------------------------------------xxx------
---------------------------x--xx--------------------------------------------------------------------------------------------------------?-------------xx--x-----
--------------------------x----xx--------------------------------------------------------------------------------------------------------------------xx----x--xx
-----------------o-o-XXX-x------xxXX--------XXXX----------------------------------------------------------------------------------------------------xx------xxx-
-----------------o-o---xx--------xx---------xxxx-------------------------------------oooo--------------oooo--oo-------------Q-?-Q------S----------ExxX------XXXE
----------------------x-----------xx-------x---xxxx----------------------------------oooo--------------oooo------------------------------------xxxxx------------
-----------------XXX-x-------------xx-----x--------xxx-------------------------------------------------------------xxxxxx---------E-----------xx--x-------------
--xxx------------xxxx--------XXX----xxXX-x----------x-x---------oo----oooooo---------xxx---------------xxx--------xx-----x-xxx----xxxxxxxxx--xx---X-------------
xxx--xx---------x--------------------xxxx-----------S--x--------oo----oooooo--------xx--xxx-----------xx--xxx----xx-------xxE-xxxxxXXXXXXX-xxx------------------
xXX--X-x-------x----------------------------------------x-------------------------Exx---XX-x--------Exx---XX-x--xx-------XXXEXXXXXXX-------XXX------------------
XXX--XX-x-----x------------------------------------------xxxxxxxxxxxxxxxxxxxxxxxxxxx--------xxxxxxxxxx--------xxx-----------------------------------------------
XXX--XXX-x-xxx------------------------------------------XXXXXXXXXXXEXXXXXXXXXEXXXXXX--------XXXEXXXXXX--------XXXX----------------------------------------------
XXX--XXXX-xx--------------------------------------------X--------------------------X--------X--------X----------------------------------------------------------
XXX--XXXXXXX--------------------------------------------X--------------------------X--------X--------X----------------------------------------------------------