----------------------------------------------------------------------------------------------------------------------------------------------------------------
----------------------------------------------------------------------------------------------------------------------------------------------------------------
----------------------------------------------------------------------------------------------------------------------------------------------------------------
----------------------------------------------------------------------------------------------------------------------------------------------------------------
----------------------------------------------------------------------------------------------------------------------------------------------------------------
----------------------------------------------------------------------------------------------------------------------------------------------------------------
--ooo-----------------------------------------------------------------------------------------------------------------------------------------------------------
-XXXXX-----------------------------------------------------------------------------------?SS-----------------------------------XX-------?-------------------QS--
-------------------------------------------------------------------------------------------------------------------------------XX---------------xx--------------
---------------------------------------------------------------------------------------------------------------------------xxx-XX------------xxxx-x-------------
---------------------------------------------------------------------------------ooo-------------------B------------------xxXx-XX-----------xxXSS--x-------xxxx-
----------------------------------------------S--------------------------------------------------------b-----------------xxXX--XX----------xxXXX----x-----xx--xx
--------------------------------------------E-----------------------------xxxx--------E---B---------B-------------------xxXXX-xXX-----E---xxXXXX-----x---xx-----
-----------x------------xxxxxx------xxxx------xxxx---------xxxxxxx-------xx<>-x-----------b----xxxx-b------------------xxXXXX--x---------xxXXXXX------xxxx------
------E-----xxxxxxxxxxxxxE-EE-xxxxxxxEE-xxxxxxx---xxxxxxxxxxEE-EE-xxxxxxxx-[]--xxxxxxxxxxxxxxxxxEE-xxxxxxxxxxxxxxxxxxxxxXXXXX---xxxxxxxxxxXXXXXX----XXXXXX------
XXXXXXXXXXXXXXXXXXXXXXXXXXXXXXXXXXXXXXXXXXXXXXX---XXXXXXXXXXXXXXXXXXXXXXXXXXXXXXXXXXXXXXXXXXXXXXXXXXXXXXXXXXXXXXXXXXXXXXXXXXXXXXXXXXXXXXXXXXXXX----------------X