----------------------------------------------------------------------------------------------------------------------------------------------------------------
----------------------------------------------------------------------------------------------------------------------------------------------------------------
----------------------------------------------------------------------------------------------------------------------------------------------------------------
----------------------------------------------------------------------------------------------------------------------------------------------------------------
----------------------------------------------------------------------------------------------------------------------------------------------------------------
---------------------------------------------------------------------------------------------------------------------xxx----------------------------xxx---------
-----------------------------------------------------XX------------------------------------------------------------xxx--x------oo-----------------xxx--x--------
-----------------------------------------------------[]------------------------------------SSSSSS-----------------xxXX---x-----------------------xxXX---xoo-----
-----------------------------------------------------[]------------------------S---------E-----------------------xx-XX----x---------------------xxXXX----x------
----------xxxx-----------------S-------S-------------[]-----------------------------------xxxxx-------------xxxxxxX-XX-----x-------------------xxXXXX-----xxx--x
----------xXX-x-------------------------------xxx----<>SSSSSS-----------------------oo--xxx----xx----------xx---x-X-XX------x-----------------xxXXXXX-----XX-xxx
---------xxXX--x-----xxxx-----xxx-----xxx----xxX-x-------------------------------------xx<>---<>-x--------xx----X-X-XX----X--x-------XXXX----xxXXXXXX--------XXX
--------xxXXX---x---xx<>-x---xxS-x---xxS-x--xx-X--x---Exxx----------------xxxxxxx-----xx-[]---[]--x-----xxx-----X-X-XX----X---x-------------xxXXXXXXX-----------
-------xx-XXX----xxxx-[]--xxxx-S--xxxx-S--xxx--X---xxxxxE-xxxxxxxxxxxxxxxxxE---X-x---xx--[]---[]---x---xx<>---X-X-X-XX----XX---x-----xxx---xxXXXXXXXX-----------
---xxxxx--XXXXXXXXXXXXXXXXX<>XXXXXX<>XXXXXXXXXXXXXXXXXX<>XXXXXXXXXXEXXXXXX<>---X--xxxx---[]---[]----xxxx-[]---X-X-X-XX----XX-E-Exxxxxx--xxxxXXXXXXXXX-----------
XXXXXXXXXXXXXXXXXXXXXXXXXXX[]XXXXXX[]XXXXXXXXXXXXXXXXXX[]XXXXXXXXXXXXXXXXX[]---X--XXXXXXXXX---XX--XXXXXXXXXXX-X-X-X-XXXXXXXXXXXXXXXXXX--XXXXXXXXXXXXX-----------