----------------------------------------------------------------------------------------------------------------------------------------------------------------
----------------------------------------------------------------------------------------------------------------------------------------------------------------
----------------------------------------------------------------------------------------------------------------------------------------------------------------
------------xxxx---------------------------------------------------------------------------------------xx-------------------------------------------------------
-----------xx<>-x-------------------------------------------------------------------------------------xx-x------------------------------------------------------
----------xx-[]--x-----------------------------------------------------------------------------xx----xx---x-----------------------------------------------------
---------xxXX[]X--xxxx----------------------------------?--------------------------------xx---xx-xxxxx-----xxxxxxxxx--------------------E----------------E------
--------xx---------x--xoo-----oo--------------------------------------------SQQS--------xx-x-xx--SSSSS-----SSSSSSSSxSSSSSSSSSSS-------QQQQQQQQQ------SSSSSS--S--
-------xx--------XXX---x--------------------------------E------------------------------xx---xx----------------------x-------------------------------------------
----xxxx----------------xxx--xxx---------------------xxxx-----xx----------------------xx----<>-----------------------x------------------------------------------
---xxXEXXX--------------XX-xxx--xxx--E----------S---xx---x---xx-x-------------------xxx-----[]------------------------x------------------E------------E---------
--xx-----------------------XXX--XX-x----E----------xx-----x-xx---x-----------SS----xx<>-----XXX---------------S--------x----SSSS-----QQQQQQQQQQ------SSSSSS--S--
xxx---------------------------------x-------------xx-------xx-----x-------E-------xx-[]-----------E------E--------------x---------------------------------------
-x-----------------------------------xxxxxxxxxxxxxx-------XXX------x-------------xx--[]----------<>-----<>---------------xx-------------------------------------
EXEXX--------------------------------XXXXXXXXXXXXXE-----------------xxxxxxxxxxxxxx-E-[]----------[]-----[]---------------X-xxxxxxxxxxxxxxxxxxxxxxxxxxxxxxxxxxxxx
-------------------------------------X------------------------------XXXXXXXXXXXXXXXXXXXXXXXXXXXXXXXXXXXXXXXXXXXXXX-------XXXXXXXXXXXXXXXXXXXXXXXXXXXXXXXXXXXXXXX