----------------------------------------------------------------------------------------------------------------------------------------------------------------
----------------------------------------------------------------------------------------------------------------------------------------------------------------
----------------------------------------------------------------------------------------------------------------------------------------------------------------
-----------------------------------------------------------------------------------------------------------------------------------------XXXX-------------------
------------------------------------------------------------------------------------------------------------------------------------------[]--------------------
------------------------------------------------------------------------------------------------------------------------------------------[]--------------------
-----------------------------xx--oo-------------------------------SSSSSS------------------------------------------------------------------<>--------------------
----------------------------xx-x--------------------------------------------------------------------------------------------------------------------------------
---------------------------xx---x-----XXX--------------------------------------------------------------------------------------------------E------xxx--------E--
-----------------------xxxxx-----x----------------------------------xxxxx--------S-------S-------S-------S-------S-------S-----------E---------xxxx--xx-----<>--
----------------------xx-XXX------xxx-------------------xxxx---Q--xxxSSS-x---------------------------------------------------------------xxxx-xxXSS-SQ-x----[]--
---------------------xx-----------XX-x-----------------xx---xx---xx<>-----x-----xxx-----xxx-----xxx-----xxx-----xxx-----xxx------oo-----xx---xxXXX------x---XX--
--------------------xx----------------x---------------xx---<>-x-xx-[]------x---xxS-x---xxS-x---xxS-x---xxS-x---xxS-x---xxS-x-----oo----xx---<>XXXX-------x------
-------------------xxX-----------------x-----xxxx----xx----[]--xx--[]-------xxxx-S--xxxx-S--xxxx-S--xxxx-S--xxxx-S--xxxx-S--xxxxxxxxxxxx----[]XXXX--------x----B
---xxxxxxxxxxxxxxxxxXX------------------xxxxxx---xxxxx-----XXX-XXXXXXXXXXXXXX<>XXXXXX<>XXXXXX<>XXXXXX<>XXXXXX<>XXXXXX<>XXXXXXXXXXXXXXXXX----[]XXXX--SSSSS--xxxxx
XXXXXXXXXXXXXXXXXXXXXX-----------------XXXXXXX--XXXXXX-----XXX-XXXXXXXXXXXXXX[]XXXXXX[]XXXXXX[]XXXXXX[]XXXXXX[]XXXXXX[]XXXXXXXXXXXXXXXXX----[]XXX-------XX-XXXXX