----------------------------------------------------------------------------------------------------------------------------------------------------------------
----------------------------------------------------------------------------------------------------------------------------------------------------------------
------------------------------xxx-------------------------------------------------------------------------------------------------------------------------------
----xxxxxxxxxxxxxxxxxxxxxxxxxxx--x------------------------------------------------------------------------------------------------------------------------------
----xXXXXXXXXXXXXXXXXXXXXXXXXXX---x-----------------------------------------------------------------------------------------------------------------------------
---xxXXXXXXXXXXXXXXXXXXXXXXXXXX----x----------------------------------------------------------------------------------------------------------------------------
--xx-XXXXXXXXXXXXXXXXXXXXXXXXXX-----x---------------------XX---------------------------------xxx---------------------------------xxxxxxxxx---------E------------
--xS-XXXXXXXXXXXXXXXXXXXXXXXXXX------x----------------------------------------Q-----------E-xxX-x--------------------------------xSSSSSSSxSSSSSSSSSSSSS---------
--x--XXXXXXXXXXXXXXXXXXXXXXXXXX-------x-----------------E----------------------------------xxXX--x-------------------------------x--------x---------------------
-xx--XXXXXXXXXXXXXXXXXXXXXXXXXX--------x------------XXXXXX--------------------------------xxXXX---x-----------------E------------x---------x--------------------
xxS--XXXXXXXXXXXXXXXXXXXXXXXXXX---------x-----------xxxxx----XXX------------------------xxxXXXX--E-x----------------->----------xx----------x------E-----------x
x----XXXXXXXXXXXXXXXXXXXXXXXXXX----------xxxxxxxxxxxx----x--------------------Q--------xx<>XXXX-<>--x--------------------------xxX--S--------x-----QQ?QQ-----xxx
x----XXXXXXXXXXXXXXXXXXXXXXXXXX----------XXXXXXXXXXXX-----x---------------------------xx-[]XXXX-[]---x------------------------xx-X------------x-------------xx<>
---E-XXXXXXXXXXXXXXXXXXXXXXXXXX---------------XXXX---------x--xxxx-------------------xx-X[]XXXX-[]----x--------xxxxxxxxxxxxx-xx--X-------------xx----------xx-[]
-----XXXXXXXXXXXXXXXXXXXXXXXXXX----------------XXX----------xxx---xxxxxxxxxxxxxxxxxxxx-XX[]XXXXXXX-E---xxxxxxxxx--XXXX--x---xxE--X-------------X-xxxxxxxxxxx--[]
XXXXXXXXXXXXXXXXXXXXXXXXXXXXXXX--XXXXXXX-------XXX----------XXX---XXXXXXXXXXXXXXXXXXXXXXXXXXXXXXXXXXXXXXXXXXXXXX-------XX---XXXXXXXXXXXX-------XXXXXXXXXXXXXX-XX