--------------------------------------------------------------------------------------------------------------------------------------------------------------X-
--------------------------------------------------------------------------------------------------------------------------------------------------------------X-
--------------------------------------------------------------------------------------------------------------------------------------------------------------X-
--------------------------------------------------------------------------------------------------------------------------------------------------------------X-
----------------------------------------------------------------------oo----------------------------------------------------------------------------XXXXXX----X-
--------------------------------------------------------------------------------------------------------------XXX--------------------------------------xxx----X-
------------------------------------------------------------------------------------------------------------------------------------------------------x--xx---X-
---------------------------?SS----------------------------------------XXX-------xxxxS-------SSS------------------------------------------------------x----xx--xx
---oooo------------------------------------------------------------------------xx--xxx---------------------------------XX-----XX--------------------x------xxx--
------------------------------------------------------------------------------xx------x-xxx-------------------XXX------xx-----xx----XXX-----XXX----x------------
--------------------X------------------------------------ooooo----------xxxxxxx----E-EExx--xx--------------xxxxxx-----x-xx---x-xx---xxx-----xxx---x-------------
xxx-----------------------------------------------------------o--------xxXXXXXX--------XX-XX-x------------xx----xx---x---xx-x---xx-x--xx---x--xxxx--------------
xX-x------------------------B-----------------B----E------------------xx---------------XX-XX--x----------xx------xx-x-----xx-----xx----xx-x---------------------
xX--x------------xxx--------b------xxx--------b----------------------xx----------------XX-XXX--x-----xxxxx--------xx--------------------xx----------------------
XX---xxxxxxxxxxxxx--xxxxxxxxxxxxxxxx--xxxxxxxxxxxxxxxxxxxxxxxxxxxxxxxx-----------------X--XXX--ExxxxxxXXXX------------------------------------------------------
XXXXXXXXXXXXXXXXXX--XXXXXXXXXXXXXXXX--XXXXXXXXXXXXXXXXXXXXXXXXXXXXXXXX-----------------X--XXXXXXXXXXXXXXXX------------------------------------------------------