----------------------------------------------------------------------------------------------------------------------------------------------------------------
----------------------------------------------------------------------------------------------------------------------------------------------------------------
----------------------------------------------------------------------------------------------------------------------------------------------------------------
----------------------------------------------------------------------------------------------------------------------------------------------------------------
----------------------------------------------------------------------------------------------------------------------------------------------------------------
----------------------------------------------------------------------------------------------------------------------------------------------------------------
----------------xxx--------------------------------------------------------------------------------------------QQQ?QQQQQQQQQQ?QQQQ---SSSSS----------------------
---------------xx--x-------------------------------SSS-------------------------------------------------------------------------[]-----------------------oooo----
--------------xx----x----------------------------------------------------------------------------------------------------------[]-----------------------oxxo--xx
-------------xx------x---------------------------------------------------------------------------------------------------------[]-----------------------xx-xxxx-
-----------xxx--o-----x----------------------------SSS----------------------------------------xxx----------------SSSSSSSSSSSSS-<>----SSSSS-xxx---------xx--XXXX-
----------xx<>------X--x-------------------QQQQQ---------------------------------------------xx--x----------------------------------------xx--xxxxxxxxxx--------
---------xx-[]------X---x-------------------------------------------E-----------------------xx----xx----xxx-----E---E----------xxx-------xx---XXXXXXXXXX--------
--------xx--[]------XX---x------xxx--------------xxxxx--xxx------------------xxxx-xxxxxxxx-xx-----X-xxxxxE-xxxxxxxxxxxxxxxxxxxxxE-xxxxxxxx----------------------
-xxxxxxxx---[]------XX----xxxxxxxE-xxxxxxxxxxxxxxx----xxxE-xxxxxxxxxxxxxxxxxxx---xx----x--xx------XXXXXX<>XXXXXXXXXXXXXXXXXXXXX<>-XXXXXXXX----------------------
XXXXXXXXXXXXXXXXXXXXXXXXXXXXXXXXXXXXXXXXXXXXXXXXXX----XXXXXXXXXXXXXXXXXXXXXXXX--XXX-XX-X--XX------XXXXXX[]XXXXXXXXXXXXXXXXXXXXX[]-XXXXXXXX----------------------