----------------------------------------------------------------------------------------------------------------------------------------------------------------
----------------------------------------------------------------------------------------------------------------------------------------------------------------
----------------------------------------------------------------------------------------------------------------------------------------------------------------
----------------------------------------------------------------------------------------------------------------------------------------------------------------
----------------------------------------------------------------------------------------------------------------------------------------------------------------
----------------------------------------------------------------------------------------------------------------------------------------------------------------
-------------------------------------------------------------xxxxx--------------------------xxxxx---------------------------------------------------------------
-------------------XX--------------------------?----------xxxx--X-x-------------SSS--XXoo--xxXXX-xx-------------------------------------------------------------
-------------------XX------------------------------------xx--E--X--x----------------------xx-------xxx--XX--o---o---o---o---o---o---o---o---o---o---o---o---o---
---------------xxx-XX--------------------------xxxxx----xx---XX-X---x---------------xxxxxxx---------x-x----XXX-XXX-XXX-XXX-XXX-XXX-XXX-XXX-XXX-XXX-XXX-XXX-XXX-X
-----------xxxxxXx-XX-----------------------xxxx----x--xx----XX-X----x--------xxxxxxx----x----------S--x--------------------------------------------------------
----------xxXXEXX--XX---------------------xxx--S-----xxx-----XX-X-----x------xxXXXXXX----XX-------------x-------------------------------------------------------
---------xxXXX-XX-xXX--------------------xx<>---------x------XX-X------x----xx-X-------------------------x------------------------------------------------------
--------xxXXXXXXX--x-------------B-xxxx-xx-[]---X----<>------XX-X-------x--xx--X--------------------------x-----------------------------------------------------
xxxxxxxxxXXXXXXXX---xxxxxxxxxxxxxxxxEE-xx--[]E--X----[]-E----XX-X-------Exxx---X---------------------------xxxxxxxxxxxxxxxxxxxxxxxxxxxxxxxxxxxxxxxxxxxxxxxxxxxxx
XXXXXXXXXXXXXXXXXXXXXXXXXXXXXXXXXXXXXXXXXXXXXXXXX----XXXXXXXXXX-XXXXXXXXXXXXXXXXXX-------------------------XXXXXXXXXXXXXXXXXXXXXXXXXXXXXXXXXXXXXXXXXXXXXXXXXXXXX