----------------------------------------------------------------------------------------------------------------------------------------------------------------
----------------------------------------------------------------------------------------------------------------------------------------------------------------
----------------------------------------------------------------------------------------------------------------------------------------------------------------
----------------------------------------------------------------------------------------------------------------------------SS----------------------------------
-------------------------------------------------------------------------------------------S--------------------------------[]----------------------------------
---------------------------------------------------XXXXXXXXXXXX-------------------------------------------------------------[]----------------------------------
-------------------------------------------------------E-xxx----------------------------------------------------------------<>-------------------------------xxx
---------------------------?--------S------------------xx--xx----------------o------o-ooSSSS------QQ?--------------------------------------------------------x<>
------------------------------------------------------x-----xx---------------XXXX--------------------------------------------E-------------------------------x[]
-----------------------------------------------XXX---x-------xxXXXX----------------xxxx------------------------------E----xxxx------------------------------xx[]
x--------------oo------------------------------xxx--x---------xxxxx---------------xxXX-x----------SSS--------------------xx<>-x-QQQQQQQQQ-------xxx--------xxS[]
-xxxxxxxxxx-------------Q--Q------QQQQ--------x--xxx--------oo----xx----------xx-xx-----x--------xxxx------------oo-----xx-[]--x---------------xxX-x------xx--[]
-XXXXXXXXX-x---------------------------------x---------------------xx--------xx-xx-------x------xx---x-----------oo----xx--[]---x-------------xx-X--x----xx---[]
------------xxxxxxx----------------------xxxx-----------------------xxxx----xx--XXXX------x---Exx-----xxxxxxxxxxxxxxxxxx---[]----xxxxxxxxxxxxxx--X---xxxxx----[]
-------------x-----xxxxxxxxxxxxxxxxxxxxxxx------------------------------xxxxx--------------xxxxx------XXXXXXXXXXXXXXXXXXXXXXXXXXXXXXXXXXXXXXXXXXXXXXXXXXXXXXXXXX
-------------X----XXXXXXXXXXXXXXXXXXXXXXXX------------------------------XXXXX-------------XXXXXX------XXXXXXXXXXXXXXXXXXXXXXXXXXXXXXXXXXXXXXXXXXXXXXXXXXXXXXXXXX