---------XXXX-----XXXXXXXXXXXXXXXXXXXXXXXXXXXXXXXXXX--XXXXXXXXXXXXXX----XX--XX--XXXXXXXXXXX-XXXX----XXXXXXXXXXXXXXXXXXXXXXXXXXXXXXXXXXXXXXXXXXXXXXXXXXXXXXXXXXXX
---------XXXX-----[]-XXXXXXXXXX---[]-----xxxxxxxxxxx--xxxxxxx-BEE-xx----xx--xx--xxxxxxxxxxx-------------xxxxxxxxxxxxxxxxxxxxxxxxxxxx---[]-[]--xxxxxxxxxxxxxxxxxx
------------------[]--XXXXXXXXX---[]----x----------xxx------xxb--x-xxxxx-xxx-xxx----------xx-----------x-------------b-------------xx--[]-<>-x------------------
------------------<>---XXXXXXXX---<>-------------------------xB-x--------------------------xx---------x--------------B----E-----E---xx-[]--xx-------------------
-------------------E----XXXXXXX------------------------------xxx--------------------S-------xx--XXXX-x-----SS-SXSS-------------------xx<>-x---------------------
------------E------------XXXXXX----------------------------------------------------------ooooxxxxxxxx-ooo----E-b----------------------xxxx---SSSSSSSSSSSSSSSSSSS
--------------------------XXXXX--------------------------------------------------------------------------------B------------------------------------------------
---------------------------XXXX---------------------------------------------------------------------------------------------------------------------------------
----------------------------XXX--------------------------------------XXXXXXXXXXX----------------------------S-------?SS--------SSSSSSS--------------------------
-----------------------------XX--------------------------------------------------------------------------------------------------E-E----------------------------
------------------------------XXXXXX----------------------------------------------------------------------------------------------------------------------------
---X------------------------------------------------------------------------------------------------------------------------------------------------------------
----------------------------------------------------------------------------------------------------------------------------------------------------------------
----------------------------------------------------------------------------------------------------------------------------------------------------------------
----------------------------------------------------------------------------------------------------------------------------------------------------------------
X---------------------------------------------------------------------------------------------------------------------------------------------------------------