----------------------------------------------------------------------------------------------------------------------------------------------------------------
----------------------------------------------------------------------------------------------------------------------------------------------------------------
----------------------------------------------------------------------------------------------------------------------------------------------------------------
----------------------------------------------------------------------------------------------------------------------------------------------------------?-----
------------------------------------------------------------------------------------------------------------------------------------------------------?---------
----------------------------------------------------------------------------------------------------------------------------------------------------------------
-o---------------------------------------------------------------------------------------------------------------oo--------------------------------------S------
----E----------------------Q-----S------------------------------------------------------S-----------------------------------------------------------XXX---------
----------------------------------------------------------------------Q---------------------------oo------------------------------------------------------------
---------------------------------------------------------------------------------------------------------------------------------------------xxxxxxxxxxxxxxxx-xx
------------------------------E---xxxxx--------------B-----------------------------------------------------xxxx-------------oo---xx---xxx---xx-XXXXXXXXXXXXX-xx-
----------------------xxxx-?----xxx-XX-x-------------b----------------Q---------------QQQQQQQ-------------xx<>-x-----------o----xx-xxxx--x-xx----------------XX-
----------------xxx--xx<>-x----xx<>-XX--x---------B------------------------------------------------------xx-[]--x--------------xx--XXXX---xx--------------------
-------------B-xxX-xxx-[]--x--xx-[]-XXX--x--------b--------------------------B--------------------------xx--[]---x------------xx---X------<>--------------------
-E------xxxxxxxx-X--x--[]---xxx--[]-XXX---xxxxxxxxxxxxxxxxxxxxxxxxxxxxxxxxxxxxxxxxxxxxxxxxxxxxxxxxxxxxxxx---[]-E-Exxxxxxxxxxxxx----X------[]--------------------
XXXXXXXXXXXXXXXXXXXXXXXXXXXXXXXXXXXXXXXXXXXXXXXXXXXXXXXXXXXXXXXXXXXXXXXXXXXXXXXXXXXXXXXXXXXXXX<>XXXXXXXXXXXXXXXXXXXXXXXXXXXXXXX----X------[]--------------------