---------------------------------------------------------------------------------------------------------------------------------------------------------------X
---------------------------------------------------------------------------------------------------------------------------------------------------------------x
--------------------------------------------------------------------------------------------------------------------------------------------------------------x-
------------------------------xx-----------------------------------------------------------------------------------------------------------------------------x--
-----------------------------xx-xxx----------------------------------------------------------------------------------------------------------------xx-------x---
----------------------------xx--XX-x--------------------------------------------------------------------------------------------------------------xx-xxxxxxx----
---------------------------xx---XX--x---------------------------------------------------------------------------------------------------E--------xx--XXXXXXXX---
----------------------xxx--xS---XX---x-------------------------------------------------------------------------------XXXXXXXX---oo---xxxxxxxxxxxxx---------E----
---------------------xx--x-x----XX----x----------------------------------------------------------------------------------------XX---xx--x-XXXXXXXX--------------
--------------------xxX---xx----XX-----x----------------------E---------------------------------------------oo---------------------xx------------------------XX-
--------xxx--------xxXX----x----XX------xxx--------------------XXX-------------------------------------xxxxx---------------------xxx----------------------------
--------xX-x------xxXXX----SS---XX------<>-x----------------------------------------------------------xxXXX-x-------------------xxXX----------------------------
B------xxX--x----xxXXXX---------XX------[]--x--------------------------------------------------------xxXXXX--x-----------------xx-------------------------------
xxxxxxxx-X---xxxxxXXXXX---------XX------[]---x------------------------------------------------------xxXXXXX---x---------------xx--------------------------------
XXXXXXXXXXXXXXXXXXXXXXX---------XX------[]----xxxxxxxxxxxxxxxx-----------xxxxxxxxxxxxxxxxxxxxxxxxxxxxXXXXXX----xxxxxxxxxxxxxxxx---------------------------------
XXXXXXXXXXXXXXXXXXXXXXXXXXXXXXXXXXXXXXXXXXXXXXXXXXXXXXXXXXXXXX--------XXXXXXXXXXXXXXXXXXXXXXXXXXXXXXXXXXXX---XXXXXXXXXXXXXXXXXX---------------------------------