----------------------------------------------------------------------------------------------------------------------------------------------------------------
---------------------------------------------------------------------------------------------------------xxx----------------------------------------------------
--------------------------------------------------------------------------------------------------------xx--x---------------------------------------------------
----------------------------------------------------------------xx-------------------------------------xx----x--------------------------------------------------
---------------------------------------------------------------xx-xxx--------------------------xxxxxxxxx------x-----------XXX-----------------------------------
--------------------------------------------------------------xx--XX-x------------------------xx------x--------x-------XX-xxx-----------------------------------
-----------------------------------------E-------------xxx---xx---XX--x----------------------xxX------E---------x------xxx--xx----------------------------------
--E------------------------------------SSSS---------E-xxX-x--xS---XX---x----------SS--------xxXX-----<>----------x----x------xx---------E-SSS?SSS---XXX---SSS?SS
-----------------------------------------------------xxXX--x-x----XX----x------------------xxXXXXX---[]-----------xxxx--------xxxxx-----------------------------
----------------------------------------------------xxXXX---xx----XX-----x----------------xxXXXX-----[]------------x---------------x----------------------------
--------------------oo----------X-----------------xxxXXXX----x----XX------x--------------xxXXXXX-----[]------------?--oo------------xx--------------------------
-------------------xx-------QQQQX------SSSS------xx<>XXXX----SS---XX-------x------------xx-XXXXX-----[]----------------------------->-x----SSSSSS---------SSSSSS
------------------xx-x--------------------------xx-[]XXXX---------XX--------x----------xxXXXXXXX-E---[]----------------------------<]--x------------------------
-----------------xx---xxxxxxx------------------xx-X[]XXXX---------XX---------x---xxxxxxxXXXXXXXX<>---[]------E---------------------[]---x-----xxxxxxxxx---------
-------xxxxxxxxxxx-----x--EE-xxxxxxxxxxxxxxxxxxx-XX[]XXXXX--------XX----------xxxx----x----XXXXX[]---XXXXXXX<>XXXXXX---------------[]----xxxxxx---x----xxxxxxxxx
XXXXXXXXXXXXXXXXXX-----X--XXXXXXXXXXXXXXXXXXXXXXXXXXXXXXXXXXXXXXXXXXXXXXXXXXXXXXXX---XXXXXXXXXXX[]---XXXXXXX[]XXXXXX---------------[XX---XXXXXX-X-X----XXXXXXXXX