----------------------------------------------------------------------------------------------------------------------------------------------------------------
----------------------------------------------------------------------------------------------------------------------------------------------------------------
----------------------------------------------------------------------------------------------------------------------------------------------------------------
------------------------------------------------------------------------------------------------------------xx------------------------------------------xx------
------XX---------------------------------------------------------------------------------------------------xx-xxx--------------------------------------xx-xxx---
--------------E-------------------------------------------------------------------------------------------xx--XX-x------------------------------------xx--XX-x--
--------------------------o-o--------ooo---------------------------------------------------------xxxxx---xx---XX--x------oo------------------xxxxx---xx---XX--x-
-XXX---------------XXX---------XXX-------------------------SQ----------S---Q------------------xxxx--X-x--xS---XX---x----------SQQS--------xxxx--X-x--xS---XX---x
----------XXX--------------------------------------------------------------------------------xx--E--X--x-x----XX----x--------------------xx--E--X--x-x----XX----
--------------------------------------------------------------------------------------------xx---XX-X---xx----XX-----x------------------xx---XX-X---xx----XX----
-----E--------------------------------------------------------------E----------------------xx----XX-X----x----XX------x----------------xx----XX-X----x----XX----
---------------XX---------XXX-----------------------------SS?---------xxxx-?-------------xxx-----XX-X----SS---XX----X--x-------SS----xxx-----XX-X----SS---XX----
---------------------------------------------------------------------xx<>-x-------------xx<>-----XX-X---------XX----X---x-----------xx<>-----XX-X---------XX----
-----------------------------------------------------xxxx-----------xx-[]--x-----------xx-[]-----XX-X---------XX----XX---x---------xx-[]-----XX-X---------XX----
-------------------------------------------xxxxxxxxxxx---xxxxxxxxxxxx--[]---xxxxxxxxxxxx--[]E----XX-X---------XX----XX---Exxxxxxxxxx--[]E----XX-X---------XX----
---------------------------------------XXXXXXXXXXXXXXX--XXXXXXXXXXXXXXXXXXXXXXXXXXXXXXXXXXXXXXXXXXX-XXXXXXXXXXXXXXXXXXXXXXXXXXXXXXXXXXXXXXXXXXX-XXXXXXXXXXXXXXXX