----------------------------------------------------------------------------------------------------------------------------------------------------------------
----------------------------------------------------------------------------------------------------------------------------------------------------------------
----------------------------------------------------------------------------------------------------------------------------------------------------------------
--------------------------------------------------------------------------------------------------------------------------------------SS----------------SS------
--------------------------------------------------------------------------------------------------------------------------------------[]----------------[]------
---------------------------------------------------------xxx--------------------------------------------------------------------------[]----------------[]------
-------------------------------------------------------xxx--x-------------------------------------------------------------------------<>----------------<>------
------------------------------------------------------xxXX---x---------QQQQQQQ----------------------------------------------------------------------------------
-----------------------------------------------------xx-XX----x------------------------------------------------------------------------E-----------------E------
----------------------------------------------------xxXXXX-----x--------------------------------------oo----------------------------xxxx--------------xxxx------
----------------------------------------E----------xx-XXXX------xxx---------------------ooooxxx-xxxxxx-----------------------------xx<>-x-QQQQQQ-----xx<>-x-QQQQ
------------------------------------------xxxx----xxXXXXXX------<>-x--E?QQQQQQQQQ----------xx--xx-XXX-x----------------B----------xx-[]--x----------xx-[]--x----
x---------------------------xxxx---------xx<>-x--xx-XXXXXX------[]--x---------------------xx---<>-XXX--x---------------b---------xx--[]---x---E----xx--[]---x---
-xxxxx---------xxx---------xx<>-x-------xx-[]--xxx--XXXXXX------[]---x-------------------xx----[]-XXX---x------xxxxxxxxxxxxxxxxxxx---[]----xxxxxxxxx---[]----xxx
--x---xxxxxxxxxx--xxxxxxxxxx-[]--xxxxxxxx--[]---x---XXXXXX------[]----xxxxxxxxxxxxxxxxxxxx-----[]-XXX----xxxxxxxXXXXXXXXXXXXXXXXXXXXXXXXXXXXXXXXXXXXXXXXXXXXXXXX
--X---XXXXXXXXXX--XXXXXXXXXXXXXXXXXXXXXXXXXXXXXXXXXXXXXXXXXXXXXXXXXXXXXXXXXXXXXXXXXXXXXXXX-XXXX-XXXX---XXXXXXXXXXXXXXXXXXXXXXXXXXXXXXXXXXXXXXXXXXXXXXXXXXXXXXXXX