----------------------------------------------------------------------------------------------------------------------------------------------------------------
----------------------------------------------------------------------------------------------------------------------------------------------------------------
---------------------------------xxxxxx------------------------------------------------xxxxxx--------------------------------------------------xxxxxx-----------
-------xxxxxxxxxxxxxxxxxxxxxxxxxxx-XXX-xxxxxxxxxxxxxxxxxxxxxxxxxxxxxxxxxxxxxxxxxxxxxxxxx-XXX-xxxxxxxxxxxxxxxxxxxxxxxxxxxxxxxxxxxxxxxxxxxxxxxxxxx-XXX-xxxxxxxxxxx
-----SSSSSSSSSSSSSSSSSSSSSSSSSSSSS-----SSSSSSSSSS????SSSSSSSSSSSSSSSSSSSSSSSSSSSSSSSSSSS-----SSSSSSSSSSSSSSSSSSSSSSSSSSSSSSSS????SSSSSSSSSSSSSSS-----SSSSSSSSSSS
---------------------------------------SSSSSSSS----------------------------------------------SSSSSSSSSSSSSSSSSSSSSSSSSSSSSS--------------------------SSSSSSSSSSS
---------------------------------------SSSSSSSS----------------------------------------------SSSSSSSSSSSSSSSSSSSSSSSSSSSSSS--------------------------SSSSSSSSSSS
--E------------------------------------SSSSSSSS----------------------------------------------SSSSSSSSSSSSSSSSSSSSSSSSSSSSSS--------------------------SSSSSSSSSSS
---------------------------------------S-----------------------------------------------------S-------------------------------------------------------S----------
---------------------------------------S-----------------------------------------------------S-------------------------------------------------------S----------
--------S---S------------E--------------?oo-----XXXX------------------------------------------?oooooooooooooooooooooooo-----XXXX----------------------?ooooooooo
----------E----E--------<>--------------??S----XXXXX------------------------------E-----------??SSSSSSSSSSSSSSSSSSSSSSS----XXXXX----------------------??SSSSSSSS
---------<>---<>-----XX-[]-------XX-----------XXXXXX------XX--<>-----------------<>----XX---------------------------------XXXXXX-------E-------XX---------------
---------[]---[]----XXX-[]------XXXXXX-------XXXXXXX---XXX----[]------<>---------[]---XXXXXX-----------------------------XXXXXXX------<>------XXXXXX------------
---------[]---[]---XXXX-[]-----XXXX---------XXXXXXXX----------[]------[]---------[]-E-XXX----------EE----EE----EE--EE---XXXXXXXX------[]----E-XXX----------EE---
XXXXXXXXXXXXXXXXXXXXXX--XX--XXXXXX-----XXXXXXXXXXXXXX---------XX------XX--XXXXXXXXXXXXXX-----XXXXXXXXXXXXXXXXXXXXXXXXXXXXXXXXXXXX--XXXXXXXXXXXXX-----XXXXXXXXXXX