-------------XXXXXXXXXXXXXXXXXXXXXXXXXXXXXXXXXXXXXXXXXXXXXXXXXXXXXXXXXXXXXXXXXXXXXXXXXXXXXXXXXXXXXXXXXXXXXXXXXXXXXXXXXXXXXXXXXXXXXXXXXXX<>XXXXXXXXXXXXXXXXXXXXXX
-------------XXXXXXXXXXXXXXXXXXXXXXXXXXXXXXXXXXXXXXXXXXXXXXXXXXXXXXXXXXXXXXXXXXXXXXXXXXXXXXXXXXXXXXXXXXXXXXXXXXXXXXXXXXXXXXX-xxE--[]----xxxxxxxxxxxxxxxxxxxxxx--
----------------xxxxxxxxxxxxxxxxxxxxxxxxxxxxxxxxxxxxxxxxxxxxxxxxxxxxxxxxxxxxxxxxxxxxxxxxxxxxxxxxxxxxxxxxxxxxxxxxxxxxxXXXXX--x-xx--[]---x---------------------xx-
--------------------------------------------------------------------------------------------------------------------xxXXX--x---xx-[]--x-----------------------xx
-------------------QQQQQQQQQQQQQQQQQQQQQQQQQQQQQQQQQQQQQQQQQQQQQQQQQQQQQQQQQQQQQQQQQQQQQQQQQQQQQQQQQQQQQQ------------xxXX-x-----xx<>-x-------------------------x
-----------------------------------------------------------------------------------------------------------<>---------xxxx-------xxxx-?-------------------------
------o-o--------------------------------------------------------------------------------------------------[]---------------------------------------------------
-XXX-------------------------------------------------------------------------------------------------------[]---------------------------------------------------
-----------------------------------------------------------------------------------------------------------[]--------------------------------------------------S
-----------------------------------------------------------------------------------------------------------[]---------------------------------------------------
-----------------------------------------------------------------------------------------------------------[]---------------------------------------------------
--------X--------------------------------------------------------------------------------------------------[]---------------------------------------------------
------XX--------------------------------------------------------------------------------------------------XXXX--------------------------------------------------
----------------------------------------------------------------------------------------------------------------------------------------------------------------
----------------------------------------------------------------------------------------------------------------------------------------------------------------
----------------------------------------------------------------------------------------------------------------------------------------------------------------