----------------------------------------------------------------------------------------------------------------------------------------------------------------
----------------------------------------------------------------------------------------------------------------------------------------------------------------
----------------------------------------------------------------------------------------------------------------------------------------------------------------
----------------------------------------------------------------------------------------------------------------------------------------------------------------
----------------------------------------------------------------------------------------------------------------------------------------------------------------
----------------------------------------------------------------------------------------------------------------------------------------------------------------
-------------------------------------------------------------------------------------------------------------------------------------------xx-------------------
----------------xxx------------------------------SQS------------Q-----------------------------XXX------------?SS--------------------------xx-x------------------
---------------xx--x---------------------------------------------------------------------------------------------------------------------xx---x-----------------
--------------xx----x-------------------------------------------------------------------------------------------------------------------xx-----x----------------
-------------xx------xo----o---xxxxx-----------------------------------xxxx--------------------------ooo------------------------------xxx-------x--------------x
--------E--xxx--o-----x-------xxXXX-x------------S?S----------S?SQS---xx<>-x----------------------------------------E--S-------------xx<>-----X--x------------xx
--------E-xx<>---------x-----xx------x-------------------------------xx-[]--x-----------------------------E---B----<>---------------xx-[]-----X---x----------xxX
---------xx-[]----------x---xx--------x--xxxx-----------------------xx--[]---x--------------xxxxx-------------b--------------------xx--[]-----XX---x--------xxXX
E----xxxxx--[]E----------xxxx-------E--xxx---xxxxxxxxxxxxxxxxxxxxxxxx---[]-E--xxxxxxxxxxxxxxx----xxxxxxxxxxxxxxxxxxxxxxxxxxxxxxxxxxxE--[]-----XX---ExxxxxxxxxXXX
XXXXXXXXXXXXXXXXXXXXXXXXXXXXXXXX---XXXXXXX--XXXXXXXXXXXXXXXXXXXXXXXXXXXXXXXXXXXXXXXXXXXXXXXXX----XXXXXXXXXXXXXXXXXXXXXXXXXXXXXXXXXXXXXXXXXXXXXXXXXXXXXXXXXXXXXXX