-------------XXXXXXXXXXXXXXXXXXXXXXXXXXXXXXXXXXXXXXXXXXXXXXXXXXXXXXXXXXXXXXXXXXXXXXXXX[]-XXXXXX-----------------------------------------------------------------
--------------XXXXXXXXXXXXXXXXXXXXXXXXXXXXXXXXXXXXXXXXXXXXXXXXXXXXXXXXXXXXXXXXXXXXXXXX<>-XXXXXX-----------------------------------------------------------------
---------------XXXXXXXXXX---xxxxxxxxxxxxxxxxxxxxxxxxxxxxxxxxxxxxxxxxxxxxxxxxxxxxxxxxxxxE-xxxxxx--------xx---------XXXXXXXXXXX-----------------------------------
----------------XXXXXXXXX-------b------------------------------------------------E----xxx-----xxxx----xx-x--------xxxxxxxxxxx-----------------------------------
-----SSSSS-------XXXXXXXX-------B-----------------------------------------------------------------x--xx---x--xxxxx----E-----xx--XX------------------------------
-----SSSSS-----X--XXXXXXX-----------SSSSSS?SSSSS?SSSSS?SSSSS?SSSSS?SSSSS?SSSSS?SSSSSS-<>-----------xxx-----xxx---------------xx-xx--XXXXEXEEXXXXXXXXXXXXXXXXXXXX
-----SSSSS--------EXXXXXX----------------E-----E-----E-----E-----E-----E-----E--------[]-----Q?---XXXX-----XXX----------------xx-xxxxxxx----xxxxxxxxxxxxxxxxxxxx
--E--SSSSS---------EXXXXX-------------------------------------------------------------[]-----------------------------------------------xxxxx--------------------
-----SSSSS----------EXXXX-------------------------------------------------------------[]--------------------------------------E---------------------------------
-----SSSSS-------------XX-----------SSSSSSSSSSSSSSSSSSSSSSSSSSSSSSSSSSSSSSSSSSSSQQQQ?QQQQ---------------------------------------------XXXXXEXXXXXXXXXXXXXXXXXXXX
-----SSSSS-----------------------------E-----E-----E-----E-----E-----E-----E------------------------------------------------------------------------------------
-----SSSSS----------------------------------------------------------------------------------------------------------------------------------E-------------------
-----SSSSS------------------------------------------------------------------------------------------------------------------------------------------------------
-----SSSSS------------------------------------------------------------------------------------------------o-----------------------------------------------------
-----SSSSS------------------------------------------------------------------------------------------------X-----------------------------------------------------
XXXXXXXXXX------------------------------------------------------------------------------------------------------------------------------------------------------