----------------------------------------------------------------------------------------------------------------------------------------------------------------
----------------------------------------------------------------------------------------------------------------------------------------------------------------
----------------------------------------------------------------------------------------------------------------------------------------------------------------
----------------------------------------------------------------------------------------------------------------------------------------------------------------
-----------------------------------------------------------------------------------------------------------S----------------------------------------------------
----------------------------------------------------------------------------------------------------------------------------------------------------------------
------------------------------?------------------------------------------xxxxxx--------oo-------------------------------------------------E-E--------oo---------
-----------------------------------------------SSSSSSS------------------xxXXX--x----------------------SSSSSS--------Q-------------------SSSSSSS----------------x
------------------------------EE---------------------------------------xxXXXX---x-----------------------------------------------------------------------------xx
-------------------------xxxxxx----oooooo-----------------------------xxXXXXX----x-------------------------------------------xxxxx-------------------------xxxx-
-----------------------xxx-----x-----xx---------E--E-----------------xxXXXXXX-----xxx-------------X------------------------xxx--S-x------------xxxx-------xx-<>-
----------------------xx<>------x---xx-x-------SSSSSSS--------------xxXXXXXXX-----<>-x---------ESSX--xxxx---------S?SQS---xx<>-----xx---------xx<>-x------x--[]-
---------------------xx-[]-------x-xx---x---------------------------xXXXXXXXX-----[]--x-------------xx---x---------------xx-[]----<>-x---E---xx-[]--x----xx--[]-
--------------------xx--[]--------xx-----xxx------xxx--------------xxXXXXXXXX-----[]---x----------xxx-----x-------------xx--[]----[]--x-----xx--[]---x--xx---[]-
-----xxxxxxxxxxxxxxxx---[]--------<>-----XX-xxxxxxx--xxxxxxxxxxxxxxxXXXXXXXXX-----[]-E-Exxxxxxxxxxx--------xxxxxxxxxxxxxx---[]----[]---xxxxxx---[]-E-Exxx----[]-
XXXXXXXXXXXXXXXXXXXXXXXXXX--------[]------XXXXXXXXX--XXXXXXXXXXXXXXXXXXXXXXXXXXXXXXXXXXXXXXXXXXXXXX-------XXXXXXXXXXXXXXXXXXXXXXXXXXXXXXXXXXXXXXXXXXXXXXXXXXXXX-