----------------------------------------------------------------------------------------------------------------------------------------------------------------
----------------------------------------------------------------------------------------------------------------------------------------------------------------
----------------------------------------------------------------------------------------------------------------------------------------------------------------
----------------------------------------------------------------------------------------------------------------------------------------------------------------
----------------------------------------------------------------------------------------------------------------------------------------------------------------
-------------------xx-------------------------------------------------------------------------------------------------------------------------------------------
---------xxxxxx---xx-xxxxxxxxxxxxxx-----------------------------------------------------------------------------------------------------------------------------
------xxxx--X--x-xx--SSSSSSSSSSSSS-x-------------------------------------------------------------------------------------------------xxxxx----------------------
-----xx--E--X---xx------------------x----------------------------------E------------------------------------------------------------xx-<>-x---------------------
x---xx---XX-X---<>-------------------x--------------------E------------------------------------------------------oooooo------------xx--[]--x--------------------
-x-xx----XX-X---[]--------------------x--------------------------------xx-------------xxx--E-----------------------xx------------xxx---[]---x------E------------
--xx-----XX-X---XXX-----------S----X---x---------------xxxxxxx--------xx-xxxxxxxxxxxxxx--x----------------xxxxx---xx-x----------xx<>--QQQ?---x----<>------------
--<>-----XX-X---------E---------E--X----x--E----------xxXXXXX-x------xx--XXXXXXXXXXXXXX---x--------------xxXXX-x-xx---x--------xx-[]----------x-----------------
--[]-----XX-X--------<>------------X-----xxxxxxxxxx--xx-----X--xxxxxxx---------------------xxxxxxxxxxxxxxx------xx-----xxx----xx--[]-----------x--------------xx
--[]E----XX-X--------[]------------X------x----x---xxx------X-XXXXXXXX---------------------XXXXXXXXXXXXXXX------<>-----XX-xxxxx---[]------E-----xxxxxxxxxxxxxxxE
XXXXXXXXXXX-XXXXXXXXXXXXXXXXXXXXXXXXXXXXX-X-XX-X---XXX------X-X------X---------------------X--------------------[]------XXXXXXXXXXXXX-----X-----XXXXXXXXXXXXXXXX