----------------------------------------------------------------------------------------------------------------------------------------------------------------
----------------------------------------------------------------xxx---------------------------------------------------------------------------------------------
---------------------------------------------------------------xx--x--------------------------------------------------------------------------------------------
--------------------xxx-----xxxx------------------------------xx----x-----xx------------------------------------------------------------------------------------
-------------------xx--x---xx---x----------------------------xx------x---xx-x------------------------------------------------------SSSSSSSSSSSSSSSSSSSSSSSSSSSSS
------------xxx---xx----x-xx-----xxxxxxxxxxxxxxxxxxxxxxxxxxxxx--------x-xx---xxxxxxxxxxxxxxxxxxxxxxxxxxxxxxxxxxxxxx-o-o-----------------------------------------
----------xxx--x-xx------xx-----XXXXXXXXXXXXXXXXXXXXXXXXXXXXXX---------xx----XXXXXXXXXXXXXXXXXXXXXXXXXXXXXXXXEXXXX-xo-o----------SQ-----------------------------
---------xxXX---xx-------XX--------------------------------------------XX-------------------------------------------x-----------S-------------------------------
--------xxXXX---XX---------------------------------------------------------------------------------------------------x----XXX---------------------------------xx
-------xxXXXX---------------------------------------------------------------------------------------------------------xx-----------------------------------xxxx-
------xxXXXXX--------------------------------------------------------------------------------------------------------XX-x-------XE------------------------xxXXX-
-----xxXXXXXX-------XX---------------------------------------------------------------------------------------------------x------XSS--QQQQQQQQQQQQQQQQQ---xxXXXX-
----xxXXXXXXX-------------------------------------------------------------------------------------------------------------x-----------------------------xxXXXXX-
---xxXXXXXXXX--------------------------------------------------------------------------------------------------------------x---------------------------xxXXXXXX-
---xXXXXXXXXX----------------------------------------------------XXX--------------------------------------------------------xxxxxxxxxxxxxxxxxxxxxxxxxxxxXXXXXXX-
XXXXXXXXXXXXX--------------------------------------------------------------------------------------------------------------XXXXXXXXXXXXXXXXXXXXXXXXXXXXXXXXXXXX-