----------------------------------------------------------------------------------------------------------------------------------------------------------------
---------------------------------------xxxxx--------------------------------------------------------------------------------------------------------------------
--------------------------------------xx---xxxxxxxxxxxxxxxxxxxxxxxxxxxxxxxxxxxxxxxxxxxxxxxxxxxxxxxxxxxxxxxxxxxxxxxxxxxxxxxxxxxxxxxxxxxxxxxxxxxxxxxxxxxxxxxxxxxxx
-------------------------------------xx------SSSSSSSSSSSSSSSSSSSSSSSSSSSSSSSSSSSSSSSSSSSSSSSSSSSSSSSSSSSSSSSSSSSSSSSSSSSSSSSSSSSSSSSSSSSSSSSSSSSSSSSSSSSSSSSSSSS
------------------------------------xx--------------------------------------------------------------------------------------------------------------------------
-----------------------------------xx---------------------------------------------------------------------------------------------------------------------------
---E---------------------------xxxxx----------------------------------------------------------------------------------------------------------------------------
---S------------------------E-xxXXXX------X---------------------------------------------------------------------------------------------------------------------
-----------------------------xxXXXXX----------------------------------------------------------------------------------------------------------------------------
---?------------------------xxXXXXXX----------------------------------------------------------------------------------------------------------------------------
--------------------------xxxXXXXXXX------------------<>--<>--<>--<>--<>--<>--<>--<>--<>--<>--<>--------------------<>--<>----<>--<>--<>--<>--<>--<>--<>--<>--<>
--xxx--------------------xx<>XXXXXXX------------------[]--[]--[]--[]--[]--[]--[]--[]--[]--[]--[]--------------------[]--[]----[]--[]--[]--[]--[]--[]--[]--[]--[]
-xxX-x------------------xx-[]XXXXXXX---------oooooo---[]--[]--[]--[]--[]--[]--[]--[]--[]--[]--[]--------------------[]--[]----[]--[]--[]--[]--[]--[]--[]--[]--[]
xx-X--x--xxx---------B-xx-X[]XXXXXXX---------oooooo---[]--[]--[]--[]--[]--[]--[]--[]--[]--[]--[]--------------------[]--[]----[]--[]--[]--[]--[]--[]--[]--[]--[]
x--X---xxx--xxxxxxxxxxxx-XX[]XXXXXXX---------XXXXXX---[]--[]--[]--[]--[]--[]--[]--[]--[]--[]--[]--------------------[]--[]----[]--[]--[]--[]--[]--[]--[]--[]--[]
XXXXX-XXXX--XXXXXXXXXXXXXXXXXXXXXXXX------X--XXXXXX---[]--[]--[]--[]--[]--[]--[]--[]--[]--[]--[]XXXXXXXXXXXXXXXXXXX-[]--[]----[]--[]--[]--[]--[]--[]--[]--[]--[]