---------------------------------------------------------------------------XXXXXXXXXXXXXXXXXXXXXXXXXXXXXXXXXXXXXXXXXXXXXXXXXXXXXXXXXXXXXXXXXXXXXXXXXXXXXXXXXXXXX
---------------------------------------------------------------------------xxxxxxxxxxxxxx-XX[]XXXXXX---------XX----XX---Exxxxxxxxxxx-b--xxxxxxxxxxxxxxxxxxxxxxxx
----------------------------------------------------------------------xxxxx-------------xx-X[]XXXXXX---------XX----XX---x----------xxB-x---------b--------------
---------------------------------------------------------------------xx------E-----------xx-[]XXXXXX---------XX----X---x------------xxx----------B--------------
--------------------------------------------------------------------xx-------SSS----------xx<>XXXXXX----SS---XX----X--x-----------------------------------------
-------------------------------------------------------------xxxxxxxx---SSS----------------xxxXXXXXX----x----XX------x--------------------ooo-------S-----------
----------------------------------------------?-------------xx?QQQQQQ------------------------xxXXXXX---xx----XX-----x-------------------------------------------
--------------------------------------SSS------------------xx---------------------------------xxXXXX--x-x----XX----x-----------------------------------oo-------
----------------------------------------------E-----------xx------------SSS---SS-------------E-xxXXX-x--xS---XX---x---------------------------------------------
------------------------------------------xxxxx-----xxxxxxx-------------------------------------xxxxx---xx---XX--x----------------------------------------------
------------------------------------xxxxxxx----x---xx--QQQ?---S------------------------------------------xx--XX-x-----------------------------------------------
-----------------------------------xxXXXXXX-----x-xx------------------------------------------------------xx-xxx------------------------------------------------
----------------------------------xx-X-----------xx--------------------------------------------------------xx---------------------------------------------------
---------------------------------xx--X----------XXX------------EE-----------------------------------------------------------------------------------------------
xxxxxxxxxxxxxxxxxxxxxxxxxxxxxxxxxx---X----------------XXXXXXXXXXXX----------------------------------------------------------------------------------------------
XXXXXXXXXXXXXXXXXXXXXXXXXXXXXXXXXXXXXXXX--------------XXXXXXXXXXXX----------------------------------------------------------------------------------------------