-----------------------------------------XXXXXXXXXXXXXXXXXXXXXXXXXXXXXXXXXXXX-----------------------------------------------------------------------------------
-----------------------------------------XXXXXXXXXXXXXXXXXXXXXXXXXXXXXXXXXXXX-----------------------------------------------------------------------------------
--------------------------------------------xxxxxxxxxx--X---xxxx--X-------EE------------------------------------------------------------------------------------
-----------------------------------------------------xx-X--x---xx-----------------------------------------------------------------------------------------------
--------XXXXX--------------------SSS------------------xxX-x-----xx----------------------------------------------------------------------------------------------
---------------------------------SSS-------------------xxx-------xxQQ?---S---------XX----XXXEX------------------------------------------------------------------
-oo------------------------------SSS------------------------------xxxx-----------------------------------------------------------------------------E------------
---------------------------------SSS---------------------------------xx-----------------------------------------------------------------------Q----SS----------S
---------------------------------SSS----------------------------------xx-------------------------------------------------------------------------------------E--
--------------------------ooo----SSS-----------------------------------xx?QQQQQQ-------XXX---?---XXX----------------------------------------------------------xx
-------------------------EXXX----SSS------------------------------------xxxxxxxx-------xxx---x---xxx--------------------------------------------------------xxx-
----?----------X----XXX----------SSS-------------------------------------------xx-----x--xxxxxxxx--xx-----xxx-------------------------------S?SQS--SS------xx<>-
---------------------------------SSS--------------------------------------------xx---x--------------xx----xB-x--------------------------------------------xx-[]-
---------------------------------BSS---------------------------------------------xxxx----------------xxx-xxb--x---------------------xxxx-----------------xx--[]-
---------------------------------SSS--------------------------------------------------------------------xx-BEE-xxxxxxxxxxxxxxxxxxxxxxEE-xxxxxxxxxxxxxxxxxx---[]-
XXX---------------------------XXXXXX--------------------------------------------------------------------XXXXXXXXXXXXXXXXXXXXXXXXXXXXXXXXXXXXXXXXXXXXXXXXXXXXXXX-