----------------------------------------------------------------------------------------------------------------------------------------------------------------
----------------------------------------------------------------------------------------------------------------------------------------------------------------
----------------------------------------------------------------------------------------------------------------------------------------------------------------
----------------------------------------------------------------------------------------------------------------------------------------------------------------
----------------X----------XXX----------------------------------------------------------------------------------------------------------------------------------
------------------------------------E---------------------------------------------------------------------------------------------------------------------------
------o-o-------------------------------------------------------------------------------------------------------------------------------------------------------
-XXX-------XXX--------------------------------------------------------------------------------------------------------------------------------------------------
----------------------XXX-------XXX-----------------------------------------------------------------------------------------------------------------------------
---------------------------o-o-----------------------------------------------S-------S-------S-------S-------S-------S-------S-------S-------S-------S-------S--
---------------E------------------------------------------------------------------------------------------------------------------------------------------------
------XXX-------XX-------------------XXX------------------------------------xxx-----xxx-----xxx-----xxx-----xxx-----xxx-----xxx-----xxx-----xxx-----xxx-----xxx-
------------------------------------------------------------xxx------------xxS-x---xxS-x---xxS-x---xxS-x---xxS-x---xxS-x---xxS-x---xxS-x---xxS-x---xxS-x---xxS-x
-----------------------------------------------------xxxxxxxxE-xxxxxxxxxxxxx-S--xxxx-S--xxxx-S--xxxx-S--xxxx-S--xxxx-S--xxxx-S--xxxx-S--xxxx-S--xxxx-S--xxxx-S--
------------------------------------------XXXXXXXXXXXxXXXXXX<>XXXXXXXXXXX<>XXXXXX<>XXXXXX<>XXXXXX<>XXXXXX<>XXXXXX<>XXXXXX<>XXXXXX<>XXXXXX<>XXXXXX<>XXXXXX<>XXXXX
------------------------------------------XXXXXXXXXXXXXXXXXX[]XXXXXXXXXXX[]XXXXXX[]XXXXXX[]XXXXXX[]XXXXXX[]XXXXXX[]XXXXXX[]XXXXXX[]XXXXXX[]XXXXXX[]XXXXXX[]XXXXX