----------------------------------------------------------------------------------------------------------------------------------------------------------------
----------------------------------------------------------------------------------------------------------------------------------------------------------------
----------------------------------------------------------------------------------------------------------------------------------------------------------------
----------------------------------------------------------------------------------------------------------------------------------------------------------------
----------------------------------------------------------------------------------------------------------------------------------------------------------------
------------------------------------------------------------------------------------------------------------------------------xxxxxxxxxxx-----------------------
------------------------------------------------------E-------------------------------------------------E--------------------xx---x---XX-x----------------------
-------SSSS--------------------------SSSSSS-------SSS--------------------------------------XQQ?QQX----QQQQQQQ---------------xx-E--E---[]--x---------------------
---------------------oooo----------E-------------------------------------------------------X-----X-------------------------xx---------[]---x--------------------
------------------------------------xxxxx--------------------------------------------------X-----X--------------------xxxxxx----------[]----x-------------------
----------------------------------xxx----xx------------------------------------------------XE-E--X-------E-----------xx---x-----------[]-----xx-----xxx---------
-------SSS--------xxx---------E--xx<>---<>-x------SS--------------Q------------------------XQQ-QQX---QQQQQQQQ-------xx----X-----------<>-----B-x---xxX-x-------o
xx----------E----xxX-x--------E-xx-[]---[]--x--E------------------------------------------------------------------xxx-----X------------------b--x-xx-X--x------o
B-x-------------xx-X--x--------xx--[]---[]---x--------------Exxx------------xxx------------------E---------------xx<>---X-X------------E-----B---xx--X---xxxxxxx
b--xxxxxxxxxxxxxx--X---xxxxxxxxx---[]---[]----xxxxxxxxxxxxxxxx--xxxxxxxxxxxxxE-xxxxxxxxxxxxxxxxxxxxxxxxxxxxxxxxxxx-[]---X-X----------XXXXXXXXXXXXXXXXXXXXXXXXXXX
XXXXXXXXXXXXXXXXXXXXXXXXXXXXXXXXXXXXX---XX--XXXXXXXXXXXXXXXXXX--XXXXXXXXXXXXXXXXXXXXXXXXXXXXXXXXXXXXXXXXXXXXXXXXXXXXXXX-X-X----------XXXXXXXXXXXXXXXXXXXXXXXXXXX