----------------------------------------------------------------------------------------------------------------------------------------------------------------
-----------------------------------------------------------xxx--------------------------------------------------------------------------------------------------
----------------------------------------------------------xx--x------------------------------------------------------------------------------------------------x
---------------------------------------------------------xx----x--------------------xxxxxx--------------xxxxxxxxxxxxxxxxxxxxxxxxxxxxxx--------------xxxxxxxxxxxx
-----------------------------------------------oo-------xx------x-ooxxx-----SSSS---xxSSSS-x-----SSSS---xxSSSSSSSSSSSSSSSSSSSSSSSSSSSS-x-----SSSS---xxSSSSSSSSSSS
-------------------------------------------------xxxxxxxx--------xxxx--x----------xx-------x----------xx-------------------------------x----------xx------------
------------------------------------Eooo--------xxXXXXXXX--------XXXX---x----?---xx---------x----?---xx---------------------------------x----?---xx-------------
------------------------------------XXXXX------xx------------------------x--S??-xx-----------x--S??-xx-----------------------------------x--S??-xx--------------
----------------------------------------------xx--------------------------x----xxXXX----------x----xxXXX----------------------------------x----xxXXX------------
-----------------------------------------xxxxxx----------------------------x--xx---------------x--xx---------------------------------------x--xx----------------
-------------------B---------xxxxxxxxxxxxx---XXXXX--------------------------xxx-----------------xxx---------S--------------------E----------xxx-----------------
-------------------b--------xxXXXXXXXXXXXX-----------------E-----E-------XX-SSSS------------XXX-SSSS-----------E--------E-------<>------XXX-SSSS----------------
----------------B----------xxXXX--------------------------<>----<>----------------------XXX-------------------<>---E---<>----XX-[]--XXX------------------E-----X
----------------b---------xxXXX------------o--------------[]----[]----------------------XXX-------------------[]--<>---[]---XXX-[]--XXX-----------------<>----XX
---xxxxxxxxxxxxxxxxxxxxxxxxXXXX-----------XXX------------X[]X--X[]XXXXX----------------XXXX-------------------[]--[]---[]-E-XXX-[]--XXX-----------------[]---XXX
XXXXXXXXXXXXXXXXXXXXXXXXXXXXXXX---------------------------------------------XXXX------XXXX------XXXX------XXXXXXXXXXXXXXXXXXXX--XX--XX------XXXX------XXXXXXXXXX