----------------------------------------------------------------------------------------------------------------------------------------------------------------
----------------------------------------------------------------------------------------------------------------------------------------------------------------
----------------------------------------------------------------------------------------------------------------------------------------------------------------
------------------------------------------------------------------------------------S---------------------------------------------------------------------------
-------------------------------SSSSSSSSSSSSSSSSSSSSSSSSSSSSSSSSSSSSSSSSS----------------------------------------------------------------------------------------
-------------------------------SSSS-------SSSSSSSSSSSSSSSSSSS---------------------------------------------------------------------------------------------------
---------------------------xxx-SSSS-------SSSSSSSSSSSSSSSSSSS-------------XXXXXXXXXX-----------------------------------------------------------XX---------------
--------------------------xx--xSSSS-------SSSSSSSSSSSSSSSSSSS--QQ--QQ----xxxxxxxxxxx-----------------------------------------------------------XX---------------
-------------------------xx----x----------------------------------------xx----------xx-----------------------------------------------------xxx-XX---------------
------------------------xx------x-------------xxx-----------xxx-xxx-xxxxx-------------x-----------xxxx------------------------------------xxXx-XX---------------
----------------------xxx--o----oxxx------xxxxx?-xxxxxxxxxxxx--xx--xx--x-------------S-x---------xx<>-x--------------------------E-------xxXX--XX------xxxxx----
-----xxx-------------xx<>------S?SS-x----xx-SSS??SSSSSSSSSSSS--QQ--QQ--Q----------------x-------xx-[]--x--------------------------------xxXXX-xXX-----xx-<>-x---
---xxx--xxx----E----xx-[]------SSS---x--xx--SS---SSSSSSSSSSSS----------------------------x--Exxxx--[]---x----------------------------B-xxXXXX--x----Exx--[]--x-x
--xx<>--<>-x-------xx--[]------SS-----xxx---SS---SSSSSSSSSSSS-----------------------------xxx--x-E-[]----xxxxxxxxxxxxxxxxxxxxxxxxxxxxxxxXXXXX---xxxxxx---[]---xx
xxx-[]--[]--xxxxxxxx---[]--------E-EE--x------oooSSSSSSSSSSSS-------------------------SSS--x--XXXXXXXXXXXXXXXXXXXXXXXXXXXXXXXXXXXXXXXXXXXXXXXXXXXXXXXX--XXXXXXXX
XXXXXXXXXXXXXXXXXXXXXXXXXXXXXXXXX-XXXXXX---XXXXXXXXXXXXXXXXXXXXXXXXXXXXX----------------XX-X--------------------------------------------------------------------