----------------------------------------------------------------------------------------------------------------------------------------------------------------
----------------------------------------------------------------------------------------------------------------------------------------------------------------
----------------------------------------------------------------------------------------------------------------------------------------------------------------
----------------------------------------------------------------------------------------------------------------------------------------------------------------
----------------------------------------------------------------------------------------------------------------------------------------------------------------
----------------------------------------------------------------------------------------------------------------------------------------------------------------
---------------------------------------xxxxxx--------------------------------------------------------------------------xxxxx----------------------E-------------
--------------------------------------xx?SSS-x----------------------------------------------------SQS-----XXXXX-------xxXXX-x-------------------QQQQQQQ---------
----------------------------------x---x-------x-------------------------------------oooo-----------------------------xxXXXX--x----------------------------------
---------------------------------xxxxxx-------Ex--------------------------------------------------------------------xxXXXXX---x---------------------------------
------------oo------------------xx---xE------<>-x----------------------B--------xxxx-------------------------------xxXXXXXX----xxxxxxo-------------E------------
----------------------S-------xxx----<>---E--[]--x---------------------b-------xx<>-x-------------S?S-------------xxXXXXXXX---SSSSSS-x---------QQQQQQQQ-------QQ
-------------------E---------xx<>----[]--<>--[]---x-----------------B---------xx-[]--x---------------------------xxXXXXXXXX-----------x-------------------------
-------------xxxxxx---------xx-[]----[]--[]--[]----x-xxx--xxx-------b--------xx--[]---x-----xxxx----------------xxXXXXXXXXX------------x-------------------B----
xxxxxxxxxxxxxx-----xxxxxxxxxx--[]-E--[]--[]--[]-----xx--xxx--xxxxxxxxxxxxxxxxxE--[]----xxxxxx---xxxxxxxxxxxxxxxxxXXXXXXXXXX-------------xxxxxxxxxxxxxxxxxxxxxxxx
XXXXXXXXXXXXXX-X-XXXXXXXXXXXXXXXXXXXXXXXXXXXXXXXXXXXXX--XXX--XXXXXXXXXXXXXXXXXXXXXXXXXXXXXXXX--XXXXXXXXXXXXXXXXXXXXXXXXXXXXXX--XXXXXXXXXXXXXXXXXXXXXXXXXXXXXXXXX