----------------------------------------------------------------------------------------------------------------------------------------------------------------
----------------------------------------------------------------------------------------------------------------------------------------------------------------
----------------------------------------------------------------------------------------------------------------------------------------------------------------
----------------------------------------------------------------------------------------------------------------------------------------------------------------
-------------------------------------------------------------xx-------------------------------------------------------------------------------------------------
------------------------------------------------------------xx-x------------------------------------------------------------------------------------------------
-----------------------------------------------------------xx---x-----------------------------------------------------------------------------------------------
-------------------------------------------------------xxxxx-----x----------------SSS---------------------SSSSS?SSS------------------------------xxx--XX--------
------------------------------------------------------xxXSSS------x-----------------------------------------------------------------------------xx--x-----------
-----------------------------------------------------xxXXX---------x---------------------------------------------------------------------------xx----x----------
---------ooooooooooooooooooooooooooo----------------xxXXXS----------xxx------xxxx--------------------------E----------------------------------xx------x---------
------------------------------------o--------------xxXXXXX----------<>-x----xxXX-xSSS----------E----------SSSSSSSSS--------------------------xxX-------x--------
--E-----------------------------------------------xxXXXXXX-SSS------[]--x--xxXXX--x-----------<>--------------------------------------------xxXXX-------x-------
-------------------------------------------------xxXXXXXXX----------[]---xxxXXXXX--x----------------xxxxx-------xxxxxxxxxxxxx------B-----B-xxXXXX--------x-xxxxx
xxxxxxxxxxxxxxxxxxxxxxxxxxxxxxxxxxxxxxxxxxxxxxxxxxXXXXXXXX----------[]----xXXXXXX---xxxxxxxxxxxxxxxxx--X-xxxxxxxx---x-----x--xxxxxxxxxxxxxxxXXXX----------xx----
XXXXXXXXXXXXXXXXXXXXXXXXXXXXXXXXXXXXXXXXXXXXXXXXXXXXXXXXXXXX---XXXXXXXXXXXXXXXXXXXXXXXXXXXXXXXXXXXXXX--XXXXXXXXXX-X-X---X-X--XXXXXXXXXXXXXXXXXXX---------XXX----