----------------------------------------------------------------------------------------------------------------------------------------------------------------
----------------------------------------------------------------------------------------------------------------------------------------------------------------
----------------------------------------------------------------------------------------------------------------------------------------------------------------
------------------------------------------------------------------------ooo-------------------------------------------------------------------------------------
------------------------------------------------------------------------o-o-------------------------------------------------------------------------------------
-----------------------------------------------------------------------xxxxx-o-o-----------------------------------------------------------------xxxxx-o-o------
-------------------------------------------------------xxxxx----------xxXXX-xo-o-----------------------------------------------------Q-?-Q------xxXXX-xo-o------
------------------------------------------------XXoo--xxXXX-x--------xx------x-----------------------------------------------------------------xx------x--------
-----------------------------------------------------xx------x------xx--------x------------------------------------------------------------E--xx--------x-------
-----xxxxxxxx----xxxxxxxx----------------xxxx-xxxxxxxx--------xxxxxxx----------xx-----xxxxxxxx----oooooo----------------------------xxx----xxxx----------xx-----
---xxx-------x-xxx-----S-x--------------xx---xx-----x------XXXXXXXXXX---------XX-x---xx--x----x-----xx---------------------------xxxxE-xxxxxXXX---------XX-x---o
--xx<>--------xx<>--------xx-----------xx----XX-----XX----------------------------x-xx---X-----x---xx-x-------------------------xxXXXEXXXXXXX---------------x--o
-xx-[]-------E<>[]-------<>-x---------xx-------------------------------------------xx----X------x-xx---x-----------------------xx----------------------------xxx
xx--[]------<>[][]-------[]--x-------xx--------------------------------------------<>----X-------xx-----x---------------------xx----------------------------XXXX
x---[]------[][][]-------[]---xxxxxxxxX--------------------------------------------[]----X-------<>------xxxxxxxxxxxxxxxxxxxxxx-----------------------------XX--
XXXXXXXXXXXXXXXXXXXXXXXXXXXXXXXXXXXXXXX--------------------------------------------[]----X-------[]----XXXXXXXXXXXXXXXXXXXXXXXXXXX--------------------------XX--