----------------------------------------------------------------------------------------------------------------------------------------------------------------
----------------------------------------------------------------------------------------------------------------------------------------------------------------
----------------------------------------------------------------------------------------------------------------------------------------------------------------
----------------------------------------------------------------------------------------------------------------------------------------------------------------
----------------------------------------------------------------------------------------------------------------------------------------------------------------
----------------------------------------------------------------------------------------------------------------------------------------------------------------
------------------------------------------oo---------------------------------------------------------------E-E--------------------------------------------------
---SQQS----------------------------------------------------------------------------------------SSSSSS----SSSSSSS----xxxxx-----------------------------?--------S
---------------------------------------------------------------------------------------------E---------------------xx-<>-x-----xxx------------------------------
---------------------------------------------------------o------------------------------------xxxxx---------------xx--[]--x---xx--x-------------------------xxxx
-----------------------B------------xxxx------------------E---------------------------------xxx----xx-----------xxx---[]---x-xx----x----------------------xxx---
----SS-----------------b-----------xx<>-x--------QQ----SSSSSS-xxxx-------------------------xx<>---<>-x---------xx<>--QQQ?---xx------x--------------------xx<>---
--------E-----------B-------------xx-[]--x-------------E-----xx<>-x-----------------E-----xx-[]---[]--x---E---xx-[]---------<>-------x--------------E---xx-[]---
--------------------b------------xx--[]---x----------------Exx-[]--x------------B--------xx--[]---[]---x-----xx--[]---------[]--------x-------B--------xx--[]---
xxxxxxxxxxxxxxxxxxxxxxxxxxxxxxxxxx---[]-E-Exxxxxxxxxxxxxxxxxx--[]---xxxxxxxxxxxxxxxxxxxxxx---[]---[]----xxxxxx---[]---------[]-E-------xxxxxxxxxxxxxxxxx---[]---
XXXXXXXXXXXXXXXXXXXXXXXXXXXXXXXXXXXXXXXXXXXXXXXXXXXXXXXXXXXXXXXXXXXXXXXXXXXXXXXXXXXXXXXXXXXXXXX---XX--XXXXXXXXXXXXXX-----XXXXXXXXXXXXXXXXXXXXXXXXXXXXXXXXXXXXXXX