----------------------------------------------------------------------------------------------------------------------------------------------------------------
----------------------------------------------------------------------------------------------------------------------------------------------------------------
----------------------------------------------------------------------------------------------------------------------------------------------------------------
---------------------------------------------------------------------------------------xxxx-------------------xxxxxxxxxxxxxxxxxxxxxxxxxx--------------xxxxxxxxxx
SSSSSSSSS---[]SSS---------------------------------------------------------------------xx---xx---------SSSS---xxSSSSSSSSSSSSSSSSSSSSSSSS-x-----SSSS---xxSSSSSSSSS
------------[]SSS--------------------------------------------------------------------xx---<>-x-xxx----------xx---------------------------x----------xx----------
------------[]SSS--------------------------------------------------------------------xx---[]--xx--x----?---xx-----------------------------x----?---xx-----------
------------[]SSS-------------------------------xx------------------------xx---------Sx---XX--XX---x--S??-xx-------------------------------x--S??-xx------------
------------[]SSS------------------------------xx-x----------------------xx-x------xxxx-------------x----xxXXX------------------------------x----xxXXX----------
------------[]SSS-----------------------------xx---xxx------------------xx---x----xx--x--------------x--xx-----------------------------------x--xx-------------E
-------------]SSS----------------------------xx----<>-x------------xxxxxx-----x--xx---S---------------xxx------------------E------------------xxx-------------<>
----xxxxxxxx-]SSS-------?-------------------xx-----[]--x----------xxXSSS?------xxx-----------------XX-SSSS----------------<>--------------XXX-SSSS------------[]
--Exx-SSSSSSSSSSS--------------------------xxE-----[]---x--------xx-X-----------x--------------------------------------XX-[]--<>--<>--XXX---------------------[]
--xx---SSSSSSSSSS-------------------------xx-X-----[]----x------xx--X---S------<>-------------------------------------XXX-[]--[]--[]--XXX-----------------<>--[]
xxxX---SSSSSSSSSS---------------xxxxxxxxxxx--X-----[]-----xxxxxxxE-EX----------[]---E-------------------------------E-XXX-[]--[]--[]--XXX-----------------[]--[]
XXXX---XXXXXXXXXX----------XXXXXXXXXXXXXXXX--X-----XXXXXXXXXXXXXXXXXXXXXXX-----XXXXXXXXX--------------XXXX------XXXXXXXX--XX--XX--XX--XX------XXXX------XXXX--XX