----------------------------------------------------------------------------------------------------------------------------------------------------------------
----------------------------------------------------------------------------------------------------------------------------------------------------------------
----------------------------------------------------------------------------------------------------------------------------------------------------------------
----------------------------------------------------------------------------------------------------------------------------------------------------------------
---------------------------------------------------SSSSSSSSSSSSSSSS?SSSSSSSSSSSS?SSSSSSSSSSSSSSSSSSSSSSSSSSSSSSSSSSSSSSSSSSSSSSSSSSSSSSSSSSSS?SSSSSSSSSSSSSSSSSS
---------------------------------------------------SSSS------------------------------SS--SSSSSSSSSS--SSSSSS--SSSS------SSSSSSSS--SSSS---------------------SSSSSS
----------------------E------------------------xxx-SSSS------------------------------SS--SSSSSSSSSS--SSSSSS--SSSS--E---SSSSSSSS--SSSS---------------------SSSSSS
----Q---------------SSSSSS--------------------xx--xSSSS---------oooo---------oooo--SS------------SS------SS---S----SS--------SS---------oooooo------------SSSSSS
---------------------------------------------xx----x-------------------------------SS------------SS------SS---S----SS--------SS---------------------------------
-------------------E------------------------xx------x-----------SSSS---------SSSS--SS------------SS------SS---S----SS--------SS---------SSSSSS-----------------x
----------------------E---------Q---------xxx-------oxxx--------SSSS---------SSSS--SS----ooooooooSS--ooooSS---So??-SS--ooooooSS---E-----SSSSSS------------xxxxxx
--S?SQS-------QQ-S?S--QQ?QQQQQ-E------E--xx<>------S?SS-x--------------------------SSSS--SSSSSSSSSS--SSSSSS---SSS--SS--SSSSSSSS--SSSS--------------------xx-SSSS
-------------------------------E------E-xx-[]------SSS---x---------------------------SS-----------------------------------------EE----------------------xx--SSS-
---------------------------------------xx--[]------SS-----x-xxxx---------xxxx--------SS---------------------------------------------xxxx-----------xxxxxx---SSS-
xxxxxxxxxxxxxxxxxxxxxxxxxxxxxxxxxxxxxxxx---[]--------E-EE--xx---xxxxxxxxxx---xxxxxxxxxxxxxxxxxxxxxxxxxxxxxxxxxxxxxxxxxxxxxxxxxxxxxxxx---xxxxxxxxxxxx---x-------o
XXXXXXXXXXXXXXXXXXXXXXXXXXXXXXXXXXXXXXXXXXXXXXXXXXXXX-XXXXXXX--XXXXXXXXXXX--XXXXXXXXXXXXXXXXXXXXXXXXXXXXXXXXXXXXXXXXXXXXXXXXXXXXXXXXX--XXXXXXXXXXXXX--XX---XXXXX