----------------------------------------------------------------------------------------------------------------------------------------------------------------
----------------------------------------------------------------------------------------------------------------------------------------------------------------
----------------------------------------------------------------------------------------------------------------------------------------------------------------
----------------------------------------------------------------------------------------------------------------------------------------------------------------
--------------------------------------------------------------------------------------------------------------------------------------------ooo-----------------
---------------------------------------------------------------------------------------------------------------------------xxx-------xxx----XXXX----------------
--------------xxxx------------------------------------------------------------------------------------------------------xxxx--x-----xx--x-----------------------
-------------xxXX-x------------------------------------------------------------------------------------SS--------------xxXXX---xoo-xx-E--x----------------------
------------xxXXX--x------------------------------------------------------------QQQ-----------------------------------xx--------x-xx------x--------------------x
-----------xxEXXX---x-------------------------------------------------ooo-------------------------------------------xxx----------xx--------x------------------xx
--o-------xxXXXXX----x---------o----------ooooxxxx-------xxxx---------ooo------------QQQQQ-----------xxxxxx--------xxXX----------XX--------------XXXX--------xxX
---------xxXXXXXX--S--xx---------------------xx-X-x-----xx---xx-----------------------------------xxxxXXXX-x------xx---------------------XX-xxxxxxx---------xxXX
--------xxXXXXXXX----<>-x-------------------xx--XX-x---xx---<>-x------------------xxxx--E------xxxxXXXXX----x----xx--------------------------XXXXX-x-------xxXXX
-------xxXXXXXXXX----[]--x---xxxxxxx-------xx---XXX-xxxxX---[]--xxxxxxxxxxxxxxxxxxxB--xxxxxxxxxxXXXXXX-------xxxxx--------------------------X-------x-----xxXXXX
xxxxxxxxXXXXXXXXX----[]---xxxx------xxxxxxxx----XXXXXXXXX---XXXXXXXXXXXXXXXXXXXXXXXX-XXXXXXXXXXXXXXX---------XXXXXXX---------------------------------xxxxxxXXXXX
XXXXXXXXXXXXXXXXXXXXXXXXXXXXXX---XX-XXXXXXXX-XXXXXXXXXXXX---XXXXXXXXXXXXXXXXXXXXXXXX-XXXXXXXXXXXXX------XX------------------------------------------XXXXXXXXXXXX