----------------------------------------------------------------------------------------------------------------------------------------------------------------
----------------------------------------------------------------------------------------------------------------------------------------------------------------
----------------------------------------------------------------------------------------------------------------------------------------------------------------
----------------------------------------------------------------------------------------------------------------------------------------------------------------
----------------------------------------------------------------------------------------------------------------------------------------------------------------
----------------------------------------------------------------------------------------------------------------------------------------------------------------
----------------------------------------------------------------------------------------------------------------------------------------------------------------
---------------------------------------------XX-----------------------------------------------------------------------------------------------------------------
---------------------------xxx--------------------------oooooooooooooooooooooooooooooooooooooooooooooooooooooooooooooooooooooooooooooooooooooooooooooooooooooooo
------------------------xxxx--xx--------------------------------------------------------------------------------------------------------------------------------
------xxxx-------------xxXSS-SQ-x------o------------------------------------------------------------------------------------------------------------------------
-----xx<>-x-----------xxXXX------x----------------Q-------------------------------------------------------------------------------------------------------------
----xx-[]--xx--------xxXXXX-------x-----------------------------------------------------------------------------------------------------------------------------
---xx--[]-<>-x----B-xxXXXXX--------x-xxxxx----------------------------------------------------------------------------------------------------------------------
xxxx---[]-[]--xxxxxxxXXXXXX--SSSS---xx----xxxxxxxxxxxxxxxxxxxxxxxxxxxxxxxxxxxxxxxxxxxxxxxxxxxxxxxxxxxxxxxxxxxxxxxxxxxxxxxxxxxxxxxxxxxxxxxxxxxxxxxxxxxxxxxxxxxxxx
XXXXXXXXXXXXXXXXXXXXXXXXXX-------XXXXX---XXXXXXXXXXXXXXXXXXXXXXXXXXXXXXXXXXXXXXXXXXXXXXXXXXXXXXXXXXXXXXXXXXXXXXXXXXXXXXXXXXXXXXXXXXXXXXXXXXXXXXXXXXXXXXXXXXXXXXX