----------------------------------------------------------------------------------------------------------------------------------------------------------------
----------------------------------------------------------------------------------------------------------------------------------------------------------------
----------------------------------------------------------------------------------------------------------------------------------------------------------------
----------------------------------------------------------------------------------------------------------------------------------------------------------------
----------------------------------------------------------------------------------------------------------------------------------------------------------------
----------------------------------------------------------------------------------------------------------------------------------------------------------------
--------------------------------------------------SSS-----------------------------------------------------------------------------------------------------------
---------------------Q-------------Q-Q-Q-QQ-------------------------SSS----------------------------------------------------------XQQ?QQQQ--?------?-------------
--------------------------------------------------------------------------------oooo---------------xxxxx-------------oooo--------X------------------------------
--------------------------------------------------X-----------------------------------------------xxXSS-xo-----------------------X------------------------------
--------------------------------------------------XEE--X------------SSS-----xxxx-----------------xxXXX---x-------xxxx------------XE-E-----------------xxxx-----o
------xxx------------Q-------------Q-Q-Q-QQ-------XSSSSX-------------------xx<>-x---------------xxXXXX-SS-x-----xx<>-x-----QQQ---XQQ-QQQQ--Q---------xx<>-x-----
------xB-x--------------B------------------QQ-----------------------------xx-[]--x-------------xxXXXXX-----x---xx-[]--x-------------------------E---xx-[]--x----
-----xxb--x-------------b----------------------------------------Exxxxx--xx--[]---x-----------xxXXXXXX--SSS-x-xx--[]---x---E-----------------------xx--[]---x---
xxxxxx-BEE-xxxxxxxxxxxxxxxxxxxxxxxxxxxxxxxxxxxxxxxxxxxxxxxxxxxxxxxx----xxx-E-[]----xxxxxxxxxxxxXXXXXXX-------xx---[]----xxxxxxxxxxxxxxxxxxxxxxxxxxxx---[]----xxx
XXXXXXXXXXXXXXXXXXXXXXXXXXXXXXXXXXXXXXXXXXXXXXXXXXXXXXXXXXXXXXXXXXX----XXXXXXXXXXXXXXXXXXXXXXXXXXXXXX------XXXXXXXXXXXXXXXXXXXXXXXXXXXXXXXXXXXXXXXXXXXXXXXXXXXXX