----------------------------------------------------------------------------------------------------------------------------------------------------------------
----------------------------------------------------------------------------------------------------------------------------------------------------------------
----------------------------------------------------------------------------------------------------------------------------------------------------------------
----------------------------------------------------------------------------------------------------------------------------------------------------------------
-----------------------------------------------------------------SSSSSSSS?SSSSSSSSSSSS?SSSSSSSSSSSSSSSSSSSSSSSSSSSSSSSSSS?SSSSSSSSSSSSSSSSSSSSSS?SSSSSSSS-------
------------------------o-----------------------------------------------------------------------SS--SSSSSSSSSSSSSSS---------------------------------------------
------SSS---------------------------------------------------------------------------------------SS--SSSSSSSSSSSSSSS---------------------------------------------
----------------------SSS-----------------------------------SSSSS-----oooo--------ooooo-------SS----------------------oooo-------------------oooo---------------
----------------------------------------------------------------------------------------------SS----------------------------------------------------------------
------X------------xxxxxxxxx----xxxx----------------------------------SSSS--------SSSSS-------SS----------------------SSSS-------------------SSSS----------oo---
------XEE--------xxx---x----x-xxx---x----------------B----------------SSSS--------SSSSS-------SS----ooooooooooooo-----SSSS-------------------SSSS-----xxxxx-----
------XSSSS-----xx<>---S-----xx<>----xx------SS------b-----S----------------------------------SSSS--SSSSSSSSSSSSSSS---------QQQQQQQQQQQQ-------------xxXXX-x----
---------------xx-[]--------E<>[]---<>-x--------------------------------------------------------SS--------------------------------------------------xxEXXX--x---
--------------xx--[]-------<>[][]---[]--x--------------------xxxx-xxxx--------xxxx--------------SS----------------xxxx-------------------xxxx------xxXXXXX---x--
xxxxxxxxxxxxxxx---[]----E--[][][]---[]---xxxxxxxxxxxxxxxxxxxxx---xx---xxxxxxxxx---xxxxxxxxxxxxxxxxxxxxxxxxxxxxxxxxx---xxxxxxxxxxxxxxxxxxxx---xxxxxxxXXXXXX----xx
XXXXXXXXXXXXXXXXXXXXXXXXXXXXXXXXXXXXXXXXXXXXXXXXXXXXXXXXXXXXXX---XX--XXXXXXXXXX--XXXXXXXXXXXXXXXXXXXXXXXXXXXXXXXXXX--XXXXXXXXXXXXXXXXXXXXX--XXXXXXXXXXXXX---XXXX