----------------------------------------------------------------------------------------------------------------------------------------------------------------
----------------------------------------------------------------------------------------------------------------------------------------------------------------
----------------------------------------------------------------------------------------------------------------------------------------------------------------
----------------------------------------------------------------------------------------------------------------------------------------------------------------
SSSSSSSSSSSSSSSSSSSSSSSSSSSSSSSSS?SSSSSSSSSSSSSS?SSSSSSSSSSSSSSSSSSSSSSSSSSSSSSSSSSSSSSSSS?SSSSSSSSSSSSSSSSSSSSSSSSSSSSSSSSSSSSSSSSSSSS?SSSSSSSSSSSSSSSSSSSSSSSS
------SS--SSSSSS--SSSS------------------------------------------------SSSS------SSSS-----------------------------------------SSSS-------------SS--SSSSSSS--SSSS-
------SS--SSSSSS--SSSS------------------------------------------------SSSS--E---SSSS-----------------------------------------SSSS-------------SS--SSSSSSS--SSSS-
----SS-------SSS--------------oooo---------oooooo-------------oooo-----S----SS---------oooo------------------------------SS---------oooo----SS---------SS-------
----SS--------SS-------------------------------------------------------S----SS---------------------xx--------------------SS-----------------SS---------SS-------
----SS--------SS--------------SSSS---------SSSSSS-----------S-SSSS-S---S----SS---------SSSS-------xx-x-xxx---------------SS---------SSSS----SS---------SS-------
----SS----ooooSS---E----------SSSS---------SSSSSS-----------SoS--SoS---So??-SS---E-----SSSS------xx---xx--x--------------SS---E-----SSSS----SS----oooooSS---E---
----SSSS--SSSSSS--SSSS-------------------------------xxx----SSS--SSS---SSS--SS--SSSS-----------xxx----<>---xx------------SS--SSSS-----------SSSS--SSSSSSS--SSSS-
------SS---------EE--------------------------------Exx--x----------------------EE-------------xx<>----[]--XX-xx-------------EE----------------SS----------EE----
------SS-------------xxxx-xxxx---------xxxx--------xx----x-------------------------xxxx------xx-[]----[]--XXXX-x----------------xxxx----------SS--------------xx
xxxxxxxxxxxxxxxxxxxxxx---xx---xxxxxxxxxx---xxxxxxxxxX-----xxxxxxxxxxxxxxxxxxxxxxxxxx---xxxxxxx--[]----[]--XXXX--xxxxxxxxxxxxxxxxx---xxxxxxxxxxxxxxxxxxxxxxxxxxx-
XXXXXXXXXXXXXXXXXXXXXX---XX--XXXXXXXXXXX--XXXXXXXXXXX----XXXXXXXXXXXXXXXXXXXXXXXXXXX--XXXXXXXXXXXXXXXXXXXXXXXXXXXXXXXXXXXXXXXXXXX--XXXXXXXXXXXXXXXXXXXXXXXXXXXX-