----------------------------------------------------------------------------------------------------------------------------------------------------------------
----------------------------------------------------------------------------------------------------------------------------------------------------------------
----------------------------------------------------------------------------------------------------------------------------------------------------------------
----------------------------------------------------------------------------------------------------------------------------------------------------------------
------------------------------SSSSSSSSSSSSSS----[]SSSSSSS-------------------------------------------------------------------------------------------------------
------------------------------SSSS--------------[]SSSSSSS-------------------------------------------------------------------------------------------------------
--------------------------xxx-SSSS--------------[]SSSSSSS---o-o----------------------------------------------------------------------------------Q-?-Q----------
-------------------------xx--xSSSS--------------[]SSSSSSS---------------------------xx------xxxxx--------------------------------------------------------------x
------------------------xx----x-----------------[]SSSSSSS--------------------------xx-x----xx-<>-x-----------------------------------------------------E------xx
-------------------xxxxxx------x----------------[]SSSSSSS-------------------------xx---x--xx--[]--x----------oo---------------------xxxx-xxx----xxx----xxxxxxxx-
------------------xx---<>------oxxx--------------]SSSSSSS---------o----------xxxxxx-----xxx---[]---x----xxxxx---------------------xxx---xx--xxxxxE-xxxxxXXXXXXX-
--------QQQxxxxxxxx----[]-----S?SS-x----xxxxxxxx-]SSSSSSS---XXX--XXX--------xxXSSS?----SSS?--QQQ?---x--xxXXX-x-------------------xxXX---XX--XXXXXEXXXXXXX-------
----------xx-----x-----[]-----SSS---x--xxSSSSSSSSSSSSSSSS------------------xx-X----------------------xxxXXXX--x-----------------xxXXX---------------------------
---------xx-----<>-----[]-----SS-----xxx-SSSSSSSSSSSSSSSS-------------x---xx--X---S-------S-----------xXXXXX---x---------------xxXXXX---------------------------
xxxxxxxxxxX-----[]--E--[]-------E-EE--x--SSSSSSSSSSSSSSSS--------------xxxxE-EX------------------E----XXXXXX----xxxxxxxxxxxxxxxxXXXXX---------------------------
XXXXXXXXXXX-----XXXXXXXXX-XXXXXX-XXXXXX--XXXXXXXXXXXXXXXX----------XXXXXXXXXXXXXXXXX----XXXX-----X----XXXXX---XXXXXXXXXXXXXXXXXXXXXXX---------------------------