----------------------------------------------------------------------------------------------------------------------------------------------------------------
----------------------------------------------------------------------------------------------------------------------------------------------------------------
----------------------------------------------------------------------------------------------------------------------------------------------------------------
------------------------------------------------------------------xx-------------------------------------------------------------------------------------xxx----
---------------------------S-------------------------------------xx-x-----------------------------------------------------------------------------------xx--xxx-
----------------------------------------------------------xx----xx---x---------------------------------------------------------------------------------xx---XX-x
---------------------------------------------------xxx---xx-xxxxx-----xxxx---------E------------------------------------------------------------xxx---xx----XX--
-----------------------SSSSS----------------------xx--x-xx--SSSSS-----SSSxSSSSSSSSSSSSS--------------------------------------------------------xx--x--xS----XX--
-------------------------------------------------xx----xx-----------------x-----------------------------------------------------xxx-----------xx----x-x-----XX--
------------------------------------------------xx-----<>------------------x----------------------------oooooo-----------------xx--x---------xx------xx-----XX--
-------------------o---------------------ooooxxxx------[]-------------------x------E----------------------xx-------------oo---xx----x------xxx--o-----x-----XX--
------------xxx-------xxx-------------------xx-<>------XXX-------------------x-----QQ?QQQQ?QQ?----xxxx---xx-x---------------xxx------x----xx<>--------SS----XX--
-----------xxX-x-----xx--x-----------------xx--[]------------E------E---------x------------------xx---x-xx---x-------------xx<>-------x--xx-[]--------------XX--
----------xx-X--x---xx----x---------------xx---[]-----------<>-----<>----------xx---------------xx-----xx-----x---xxx-----xx-[]--------xxx--[]--------------XX--
xxxxxxxxxxx--X---xxxx------xxxxxxxxxxxxxxxx----[]-----------[]-----[]----------X-xxxxxxxxxxxxxxxx------<>------xxxxE-xxxxxx--[]-E-------x---[]--------------XX--
XXXXXXXXXXX--XXXXXXXX-----XXXXXXXXXXXXXXXXX-XXXXXXXXXXXXXXXXXXXXXXXXXXXX-------XXXXXXXXXXXXXXXXXX------[]----XXXXXXXXXXXXXXXXXXXXXXXXXXXXXXXXXXXXXXXXXXXXXXXXX--