----------------------------------------------------------------------------------------------------------------------------------------------------------------
----------------------------------------------------------------------------------------------------------------------------------------------------------------
----------------------------------------------------------------------------------------------------------------------------------------------------------------
----------------------------------------------------------------------------------------------------------------------------------------------------------------
SSSSSSSS?SSSSSSSSSSSSSSSS?SSSSSSSSSSSSSSSSSSSSSSSSSSSSSSSSSSSSSSSSSSSSSSSSSSSSSSSSSSSSSSSSSSSSSSSSSSSSSSSSSSSSSSSSSSSSSSSSSSSSSSSSSSSSSSSSS?SSSSSSSSSSSSSSSSSSSS
--------------------------------------------------------SSSSSSSSSSSSSSSSSSSSSSSSSSSS---------------------------------------------------------------SS--SSSSS--SS
--------------------------------------------------------SSSSSSSSSSSSSSSSSSSSSSSSSSSS---------------------------------------------------------------SS--SSSSS--SS
-----oooo---------oooooooo------------------------------SSSSSSSSSSSSSSSSSSSSSSSSSSSS--QQ-----------Q-------------oooo-------------------oooo-----SS-------SS----
----------------------------------------------o--------------------------------------------------------------------------------------------------SS-------SS----
-----SSSS---------SSSSSSSS----------------xxxxx------------------xxx---------------xxx-xxx---------------------S-SSSS-S-----------------SSSS-----SS-------SS----
-----SSSS---------SSSSSSSS------------xxxxx--S-x--------xxxxxxxxxx?-xxxxxxxxxxxxxxxx--xx--x--------------------SoS--SoS-----------------SSSS-----SS----oooSS--oo
------------------------------------xxxXXXX-----xx-----xx-SSSSSSSS??SSSSSSSSSSSSSSSS--QQ---x------xxx---xxx----SSS--SSS--------------------------SSSS--SSSSS--SS
----------------------------------xxxXXXXXXXX--XX-xx--xx--SSSSSSS---SSSSSSSSSSSSSSSS--------xxx--xx--x-xx--x---------------------------------------SS-----------
-xxxx---------xxxx----------xxx-xxxXXXXXXXXXX--XXXX-xxx---SSSSSSS---SSSSSSSSSSSSSSSS--------<>-xxx----xx----x------------------xxxx-xxxx-----------SS-----------
xx---xxxxxxxxxx---xxxxxxxxxxx--xxXXXXXXXXXXXXE-XXXX--x-----------oooSSSSSSSSSSSSSSSS------E-[]--x-----XX-----xxxxxxxxxxxxxxxxxxx<>-xx---xxxxxxxxxxxxxxxxxxxxxxxx
XX--XXXXXXXXXXX--XXXXXXXXXXXX--XXXXXXXXXXXXXXXXXXXXXXX---XXXXXXXXXXXXXXXXXXXXXXXXXXXXXXXXXXXXXXXX-----XX----XXXXXXXXXXXXXXXXXXXX[]-XX--XXXXXXXXXXXXXXXXXXXXXXXXX