----------------------------------------------------------------------------------------------------------------------------------------------------------------
----------------------------------------------------------------------------------------------------------------------------------------------------------------
----------------------------------------------------------------------------------------------------------------------------------------------------------------
----------------------------------------------------------------------------------------------------------------------------------------------------------------
----------------------------------------------------------------------------------------------------------------------------------------------------------------
----------------------------------------------------------------------------------------------------------------------------------------------------------------
---------------------------------------E------------------------------------------------------------------------------------------------------------------------
---------------------------------------------------------------------------------------------------------------------S------------------------------------------
-----------xxxxx----------------------------------------------------------------------------------------------------------------------------------xxxxxx-xxx----
----------xxXSS-xo------------------------xxxx---------------------------------------------------------------------------------------------------xx-----xx--x---
---------xxXXX-S-x----------------------xxx---xx--------------------------------------------xxxx----------------------------------------xxxx----xx-----XXX---xx-
------xxxxXXXX--S-x-------------------xxx-?--<>-x----------------xxxxx----------------S----xx<>-x------------------QQQQQQ?QQQQ---------xx---xxxxx-----------XX-x
----xxx--XXXXX-----x-----------------xx<>----[]--x--------------xx----x-------------------xx-[]--x------------------------------------xx----XXXXX---------------
---xx<>-XXXXXX--SSS-x-----------B---xx-[]----[]---x----------B-xxX---X-x----xxxx---------xx--[]---x---xxx-----------------------xxx--xx-------------------------
xxxx-[]XXXXXXX-------xxxxxxxxxxxxxxxx--[]----[]----xxxxxxxxxxxxx-X-E-X--xxxxxEE-xxxxxxxxxx---[]----xxxx--xxxxxxxxxxxxxxxxxxxxxxxx--xxx--------------------------
XXXXXXXXXXXXX------XXXXXXXXXXXXXXXXXXXXXXXXXXXXXXXXXXXXXXXXXXXXXXXXXXXXXXXXXXXXXXXXXXXXXXXXXXXXX---XXXX--XXXXXXXXXXXXXXXXXXXXXXXX--XXX--------------------------