----------------------------------------------------------------------------------------------------------------------------------------------------------------
----------------------------------------------------------------------------------------------------------------------------------------------------------------
----------------------------------------------------------------------------------------------------------------------------------------------------------------
----------------------------------------------------------------------------------------------------------------------------------------------------------------
------------------------------------------------------------------------------------------------------------------xx--------------------------------------------
-----------------------------------------------------------------------------------------------------------------xx-x-------------------------------------------
----------------------------------------------------------XXXXXXXXXXXX------------------------------------------xx---x------------------------------------------
---XSSSSS-----------------------------------------------------------[]-----------------------X--------------xxxxx-----x-----------------------------------------
---X----------------------------------------------------------------[]--------QQQ------------X-------------xxXSSS------x---------------ooo----------------------
---X------------------------------------------xxx-------------------[]---------------X-EE--X-X------------xxXXX---------x---------------------------------------
--EX--E-X-----------------------------------xxx--xx-----------------[]---------------XSSSSSX-X-----------xxXXXS----------xxx-?-----------------ooooooooooooooo--
---XSS?SX-----------------oo---------------xxXX--X-x----------------<E----------------------------------xxXXXXX----------<>-x-------xxx-------------------------
------------------------------------------xxXXX--XX-xxx-------------xxxx--------xxx--------------------xxXXXXXX-SSS------[]--x-----xxX-x------------------------
--------------xxxx------------------xxxxxxxXXXX--XXXXX-xxxxxxxxxxxxxxXX-xxxxxxxxxB-xxxxxxxxxxxxxxxxxxxxxXXXXXXX----------[]---x---xx-X--x-----------------------
xxxxxxxxxxxxxxxEE-xxxxxxxxxxxxxxxxxxxEEXXXXXXXX--XXXXXXXXXXXXXXXXXXXXXXXXXXXXXXXXXXXXXXXXXXXXXXXXXXXXXXXXXXXXXX----------[]----xxxx--X---xxxxxxxxxxxxxxxxxxxxxxx
XXXXXXXXXXXXXXXXXXXXXXXXXXXXXXXXXXXXXXXXXXXXXXX--XXXXXXXXXXXXXXXXXXXXXXXXXXXXXXXXXXXXXXXXXXXXXXXXXXXXXXXXXXXXXXXX---XXXXXXXXXXX<>XXXXXXXXXXXXXXXXXXXXXXXXXXXXXXX