----------------------------------------------------------------------------------------------------------------------------------------------------------------
----------------------------------------------------------------------------------------------------------------------------------------------------------------
----------------------------------------------------------------------------------------------------------------------------------------------------------------
----------------------------------------------------------------------------------------------------------------------------------------------------------------
SSSSSSSSSSSSSSSSSSSSSSSSSSSSSSSSSSSSSSSSSSSSSSSSSSSSSSSSSSSSSSSSSSSSSSSSSSSSSSSSSSSSSSSSSSSS--[]SSSSSSSSSSSSSS--------------------------------------------------
-----------------SSSSSSSSSSSSSSSSSSSSS--------------------------------------------------------[]SSSSSSSSSSSSSS--------------------------------------------------
-----------------SSSSSSSSSSSSSSSSSSSSS--------------------------------------------------------[]SSSSSSSSSSSSSS--------------------------------------------------
-----------------SSSSSSSSSSSSSSSSSSSSS--QQ--QQ--QQ--QQ--QQ--QQ--QQ--QQ--QQ--QQ----------------[]SSSSSSSSSSSSSS--------------------------------------------------
----------------------------------------------------------------------------------------------[]SSSSSSSSSSSSSS-----------------------------------------E--------
------------------------xxx----------xxx-xxx-xxx-xxx-xxx-xxx-xxx-xxx-xxx-xxx-xxx--------------[]SSSSSSSSSSSSSS----------------------------------------<>-------x
-----------------xxxxxxxx?-xxxxxxxxxxx--xx--xx--xx--xx--xx--xx--xx--xx--xx--xx--x--------------]SSSSSSSSSSSSSS----------------------------------oo----[]------xx
-----xxx--------xx-SSSSSS??SSSSSSSSSSS--QQ--QQ--QQ--QQ--QQ--QQ--QQ--QQ--QQ--QQ---x------xxxxxx-]SSSSSSSSSSSSSS-----------------B---------------xxxx---XX-----xxX
---xxx--x------xx--SSSSS---SSSSSSSSSSS--------------------------------------------xxx--xxSSSSSSSSSSSSSSSSSSSSS-----------------b--------------xx---x--------xxXX
-xxxX----x-xxxxx---SSSSS---SSSSSSSSSSS--------------------------------------------<>-xxx-SSSSSSSSSSSSSSSSSSSSS--<>-------------B-------------xx-----x----B-xxXXX
xxXXX-----xx--x---------oooSSSSSSSSSSS------------------------------------------E-[]--x--SSSSSSSSSSSSSSSSSSSSS--[]--xxxxxxxxxxxxxxxxxxxxxxxxxx-------xxxxxxxXXXX
XXXXX----XXX--X---XXXXXXXXXXXXXXXXXXXXXXXXXXXXXXXXXXXXXXXXXXXXXXXXXXXXXXXXXXXXXXXXXXXXX--XXXXXXXXXXXXXXXXXXXXX--XXXXXXXXXXXXXXXXXXXXXXXXXXXXXX-------XXXXXXXXXXX