----------------------------------------------------------------------------------------------------------------------------------------------------------------
----------------------------------------------------------------------------------------------------------------------------------------------------------------
----------------------------------------------------------------------------------------------------------------------------------------------------------------
--------------------------------------------------------------------------------------------------------------------------------------------------XXSSSSSSSSSSSS
SSSSSSSSSSSSSSSSSSSSSSSSSSSSSSSSSSS---------xx-----------------------------------------------------------------------------------------------------[]----------S
-------------------------------------------xx-x-----------------------------E----------------------------------------------------------------------[]-----S----S
------------------------------------------xx---x--------oo-----------------------------------------------------------------------------------------<>QQ--------S
------------------------------------xxxxxxx-----x---------------------------------------------------------------------------------------------------------------
--------------------o--------------xx-XXXXX------x--------------------------------------------------------------------------------------------------E-----------
----------------xxxxx-------------xx--------------x----------------xxx--------------------------------------------------------xxx-------------------xxxxxxxxxxxx
-----------xxxxxx--S-x--------xxxxx----------------xxx----------xxxx--xx-----------------------------------------------------xx<-x----------------xx--S???SS???S
--QQ-----xxxXXXXX-----xx-----xx-XXX----------------<>-x--------xxXXX--X-x-------------------------------------------E-------xx-[]-x--------------xx----SSS-SSSS-
-------xxxXXXXXXXXX--XX-xx--xx---------------------[]--x------xxXXXX--XX-x---xxx-------------------------------------------xx--[]--x------------xx-----SSSSSS-S-
-----xxxXXXXXXXXXXX--XXXX-xxx----------------------[]---x----xxXXXXX--XXX-xxxx--x-xxxx------------------------------------xx---[]---xxxxxxxxxxxxx---------------
xxxxxxXXXXXXXXXXXXXE-XXXX--xX----------------------[]-E-ExxxxxXXXXXX--XXXXXXXX---xx---xxxxxxxxxxxxxxxxxxxxxxxxxxxxxxxxxxxxxX---XXXXXXXXEXEXXXXXXX-----XXXXX-XXXX
XXXXXXXXXXXXXXXXXXXXXXXXXXXXX----------------XXXXXXXXXXXXXXXXXXXXXXX--XXXXXXXX---XX--XXXXXXXXXXXXXXXXXXXXXXXXXXXXXXXXXXXXXXX---XXXXXXXXXXXXXXXXXX-----XXXXX-XXXX