----------------------------------------------------------------------------------------------------------------------------------------------------------------
----------------------------------------------------------------------------------------------------------------------------------------------------------------
---------------------------------------------------------------------------------------------------------------------------------------------------------------x
--------------------------------------------------------------------------------------------------------------------------------------------------------------xx
-------------------------------------------------------------------------------------------------------------------------------------------------------------xx-
------------------------------------------------------------------------------------------------------------------------------------------------------xxxxxxxx--
----------------------------------------------------------------------------E------------------------------------------------------------------------xxXXXXXXX--
---------------------E----E------------------------------------------------SQS----------------------------------------------------------------------xx----------
------------------E---------------------------------------------------------------------------xx---------------------------------------------------xx-----------
--------------xxxxxxxxxxxxx------------------------------------------------------------------xx-x----oo----ooo----oooooooo----------------------xxxx------------
-------------xxXSSSSSSSSSS-x-----------xxxx------------------------xxxx---------------------xx---x---oo----ooo----oooooooo---------------------xxXEXXX----------
------------xxXX------------x---------xx---x----------------------xx<>-x---SQS--------QQ?--xx-----x-----------------------------E-------------xx----------------
-----------xxXXX----oooo-----x-------xx---X-x--------------------xx-[]--x----------------xxx-------xxxxxxxxxxxxxxxxxxxxxxxxxxxxxxxxxxxxxxx---xx-----------------
-xxxx-----xxXXXX--------------xxxxxxxx----X--x-xxxxxxxxxxx------xx--[]---x--------------xx<>-------XXXXXEXXXXXXEXXXXXXXXXXXXXXXXXXXXXXXXX-xxxx------------------
xx---xxxxxxXXXXX----oooo------XXXXXXXX----X---xx---x---x--xxxxxxx---[]---Exxxxxxxxxxxxxxx-[]-------X-----------------------------------XX-XXXXXXX---------------
XX--XXXXXXXXXXXXXXXXXXXXXX----------------XXXXXX-X-X--XX--XXXXXXXXXXXXXXXXXXXXXXXXXXXXXXXXXXXXXX---X-----------------------------------XX-----------------------