----------------------------------------------------------------------------------------------------------------------------------------------------------------
----------------------------------------------------------------------xxx---------------------------------------------------------------------------------------
---------------------------------------------------------------------xx--x--------------------------------------------------------------------------------------
--------------------------------------------------------------------xx----x-------------------------------------------------------------------------------------
-------------------------------------------------------------------xx------x------------------------------------------------------------------------------------
------------------------------------------------------------xxxxxxxx--------xxxxx-o-o---------------------------------------------------------------------------
-----------------------------------------------------------xx?QQQQQQ--------XXXX-xo-o---------------------------------------------------------------------------
----------------------------------------------------------xx----------------------x-----------------------------------------------------------------------------
---------------------------------------------------------xx------------------------x----------------------------------------------------------------------------
------------------------xxx---------xxx--xxx-Exxx----xxxxx--------------------------xx---------------------------------o--------xxxxx---------------------------
----xxxx--------------xxx--x--E----xx--xxx--xxx--x--xx--<>---S---------------------XX-x----------------xxxx----------SSS-----xxxx----x--------------------------
---xx<>-x------S-----xxXX---x-----xx---XXX--XXX---xxx---[]-----------------------------x--------------xx---xxxxxxxxx--------xxXXX-----x-xxx---------------------
--xx-[]--x----------xxXXX----x---xx----XX---XX-----x----[]------------------------------x------------xx----XXXXXXXX-x------xx----------xx--xxx------------------
-xx--[]---x--------xxXXXX-----xxxx----------------<>----[]----EE-------------------------xxxxxxxxxxxxx---------------x----xx-----------<>--<>-x----Exxxxxxxxxxxx
xx-E-[]----xxxxxxxxxXXXXX-----XXXX----------------[]---XXXXXXXXXX------XXX-------------XXXXXXXXXXXXXXX----------------xxxxx------------[]--[]--xxxxxx----x-----X
XXXXXXXXXXXXXXXXXXXXXXXXX-----X-------------------[]---XXXXXXXXXX----------------------XXXXXXXXXXXXXXX---------------XXXXXXXXX---------[]XXXXXXXXXXXX--X-X--XX-X