----------------------------------------------------------------------------------------------------------------------------------------------------------------
----------------------------------------------------------------------------------------------------------------------------------------------------------------
----------------------------------------------------------------------------------------------------------------------------------------------------------------
----------------------------------------------------------------------------------------------------------------------------------------------------------------
----------------------------------------------------------------------------------------------------------------------------------------------------------------
----------------------xxx----------------------------------------------------------------------------------------------------------------------------------o----
-----------------E--xxx--x--------------------------------------------------------------------------------------------------------------------------------------
---------------SSSSxxXX---x-----------------------Q---------------------SSSSSS----------Q-----------------------------------------------XXX--------------SSS----
--------xxxxx-----xx-XX----x------------------------------------------------------------------------------------------------------------------------------------
-------xxXSS-x---xxXXXX-----x-------------------------------------------------------------------------------------------------------------------------xxxxxxxxx-
------xxXXX-S-xxxxXXXXX------x---------------------------------------------E------------------------------------------------------------------------xxx---x----x
-----xxXXXX-S-SSSSXXXXX----X--x-----SSSSQS---xxxx-?----xxxx-------------SSSSSS----xxxxx-?-----xxx-------xxx----------------------------------------xx<>---S---<>
----xxXXXXX-SS----XXXXX----X---x------------xx<>-x----xx<>-x---------------------xx-<>-x------xB-x------xB-x--------------------------------------xx-[]-------[]
---xxXXXXXX--S----XXXXX----XX---x----------xx-[]--x--xx-[]--x-------------xxx---xx--[]--x----xxb--x----xxb--x------------------------------------xx--[]-------[]
xxxxXXXXXXX--S---XXXXXX----XX----xxxxxxxxxxx--[]---xxx--[]---xxxxxxxxxxxxxx--xxxx---[]---xxxxx-BEE-xxxxx-BEE-xxxxxxxxxxxxxxxxxxxxxxxxxxxxxxxxxxxxx---[]----E--[]
XXXXXXXXXX----XXXXXXXXXXXXXXXXXXXXXXXXXXXXXXXXXXXXXXXXXXXXXXXXXXXXXXXXXXXXX--XXXX--XXXXXXXXXXXXXXXXXXXXXXXXXXXXXXXXXXXXXXXXXXXXXXXXXXXXXXXXXXXXXXXXXXXXXXXXXXXXX