----------------------------------------------------------------------------------------------------------------------------------------------------------------
----------------------------------------------------------------------------------------------------------------------------------------------------------------
----------------------------------------------------------------------------------------------------------------------------------------------------------------
---------------------------------------------------------------------------------------------------------------------------------------------------------------x
---------SSSSSSSSS?SSSSSSSSSSSSS?SSSSSSSSSSSSSSSSSSSSSSSSSSSSSSSSSSSSSSSSSSS?SSSSSSSSSSSSSSSSSSSSSSSSSSSSSSSSSSSSSSSSSSS--[]SSSSSSSSSSSSSSSSSSSSS--------------?
------------------------------------------SS--SSSSSSS--SSSSSSSSSSSSS------------SS--SSSSSSSSS--S--------------------------[]SSSSSSSSSSSSSSSSSSSSS---------------
------------------------------------------SS--SSSSSSS--SSSSSSSSSSSSS------------SS--SSSSSSSSS--S--------------------------[]SSSSSSSSSSSSSSSSSSSSS---------------
--SSSSSSSS----ooooo---------ooooo-------SS---------SS------------------oooooo--S-----------SS-----------------------------[]SSSSSSSSSSSSSSSSSSSSS-------------X-
----------------------------------------SS---------SS--------------------------S-----------SS--------xx-------------------[]SSSSSSSSSSSSSSSSSSSSS------------XX-
--------------SSSSS---------SSSSS-------SS---------SS------------------SSSSSS--S-----------SS-------xx-x-xxx--------------[]SSSSSSSSSSSSSSSSSSSSS-----------XXX-
--------------SSSSS---------SSSSS-------SS----oooooSS--ooooooooooo-----SSSSSS--S----oooooooSS------xx---xx--x--------------]SSSSSSSSSSSSSSSSSSSSS----------XXXXX
-S--------------------------------------SSSS--SSSSSSS--SSSSSSSSSSSSS-----------SSS--SSSSSSSSS----xxx----<>---x------xxxxxx-]SSSSSSSSSSSSSSSSSSSSS---------XXXXXX
------------------------------------------SS------------------------------------SS--------------xx<>----[]----xxx--xxSSSSSSSSSSSSSSSSSSSSSSSSSSSS--------XXXXXXX
---xxxxxx-xxxx----------xxxx--------------SS-----------------------xxxx---------SS-------------xx-[]----[]----<>-xxx-SSSSSSSSSSSSSSSSSSSSSSSSSSSS------XXXXXXXXX
xxxx-----xx---xxxxxxxxxxx---xxxxxxxxxxxxxxxxxxxxxxxxxxxxxxxxxxxxxxxx---xxxxxxxxxxxxxxxxxxxxxxxxx--[]----[]--E-[]--x--SSSSSSSSSSSSSSSSSSSSSSSSSSSS--XXXXXXXXXXXXX
XXXX-----XX--XXXXXXXXXXXX--XXXXXXXXXXXXXXXXXXXXXXXXXXXXXXXXXXXXXXXXX--XXXXXXXXXXXXXXXXXXXXXXXXXXXXXXXXXXXXXXXXXXXXX--XXXXXXXXXXXXXXXXXXXXXXXXXXXX--XXXXXXXXXXXXX