----------------------------------------------------------------------------------------------------------------------------------------------------------------
----------------------------------------------------------------------------------------------------------------------------------------------------------------
----------------------------------------------------------------------------------------------------------------------------------------------------------------
----------------------------------------------------------------------------------------------------------------------------------------------------------------
----------------------------------------------------------------------------------------------------------------------------------------------------------------
----------------------------------------------------------------------------------------------------------------------------------------------------------------
----------------------------------------------oooo----------------------------------------------------------------------------E---------------------------------
-----------SS?SSS-----------------------------XXXX-----------------------------------------xx---------E-SSS?SSS-------------SSSS------------------------?SS--XXX
-------------------------------------------------------------------oooo-------------------xx-x--------------------------------------------------XXX-------------
-------------------------X---------------------------------------------------------------xx---x----------------------------E------------------------------------
---------------------------------------------------------------xxxx--------E--------xxxxxx-----x-xxx--------------o-----------E---------xxxxxxx-----------------
-----------SSSSSS-----------------xxxxxxxxxxxxx---------------xx<>-x------<>-------xxXSSS?------xx--x----SSSSSS----------S?S--QQ?QQ----xxXXXXX-x----------------
---------------------------------xxXXXXXXXXXX?-x-------------xx-[]--x-------------xx-X----------<>---x--------------------------------xx--------x----E---B------
--------------xxxxxxxxxxxxxxxxxxxxXXXXXXXX------xxxx------B-xx--[]---x-----------xx--X---S------[]----x-----xxxxxxxx-----------------xx----------x-------b-----x
xxxxxxxxxxxxxxx---x-----x-------xXXXXXXXXX-------x--xxxxxxxxx-E-[]----xxxxxxxxxxxxE-EX----------[]-----xxxxxx---x---xxxxxxxxxxxxxxxxxx------------xxxxxxxxxxxxxx
XXXXXXXXXXXXXXX-X-X---X-X------XXXXXXXXXXX---XXXXX-XXXXXXXXXXXXXXXXXXXXXXXXXXXXXXXXXXXXXXXX-----[]-----XXXXXX-X-X---XXXXXXXXXXXXXXXXXXXXX--------XXXXXXXXXXXXXXX