----------------------------------------------------------------------------------------------------------------------------------------------------------------
----------------------------------------------------------------------------------------------------------------------------------------------------------------
----------------------------------------------------------------------------------------------------------------------------------------------------------------
----------------------------------------------------------------------------------------------------------------------------------------------------------------
----------------------------------------------------------------------------------------------------------------------------------------------------------------
----------------------------------------------------------------------------------------------------------------------------------------------------------------
-----------------------------oo----------------------------------------------E----------------------------------------------------------------------------------
-------------------------------------------------------oo--XXXX------------SSSSSSQS------------------------------------------------------xx-------------SQS-----
---------------------------------------xxx----oooo----XX--------------------------------------------------------------------------------xx-x----oooo------------
--------------------------------------xx--x---------------xxxxx-----------E------------------------------------------------------------xx---x-------------------
-------------xxxx------xxxx----------xx----xxx----------xxx----xxx---------------------------------------------------------------oo---xx-----xxx----------------
------------xx<>-x----xx<>-x-------xxx-----<>-x--------xxXX---XXX-x-----S?S-----QS--------------------------------------------------xxx------<>-x-------S?S-----
-----------xx-[]--x--xx-[]--x-----xx<>-----[]--x------xx-----------x----------------E------?QQ-------------------------------------xx<>------[]--x--------------
--------B-xx--[]---xxx--[]---x---xx-[]-----[]---x----xx-------------x-------------------------------------------------------------xx-[]------[]---x-------------
xxxxxxxxxxx---[]----x---[]-E-Exxxx--[]-----[]----xxxxx--------------Exxxxxxxxxxxxxxxxxxxxxxxxxxxxxxxxxxxxxxxxxxxxxxxxxxxxxxxxxxxxxx--[]E-----[]----xxxxxxxxxxxxx
XXXXXXXXXXXXXXXXX---XXXXXXXXXXXXXXXXXXXXXXXXXXXXXXXXXX------XXX--XXXXXXXXXXXXXXXXXXXXXXXXXXXXXXXXXXXXXXXXXXXXXXXXXXXXXXXXXXXXXXXXXXXXXXXXXXXXXXXXXXXXXXXXXXXXXXX