----------------------------------------------------------------------------------------------------------------------------------------------------------------
----------------------------------------------------------------------------------------------------------------------------------------------------------------
----------------------------------------------------------------------------------------------------------------------------------------------------------------
----------------------------------------------------------------------------------------------------------------------------------------------------------------
--------------------------------------------S-------------------------------------------------------------------------------------------------------------------
---------------------------------------------------------------------------------------------------------------------------------------------o------------------
-------------------------------xxxxxxx------------------------------------------------------------------------------------------------------XXX-----------------
-----XXXXXX--------------------xSSSSSxSSSSSSS-------------------------------XXX-----------------------------------------------------------------o---------xxxE--
-------------------------------x------x--------------------------------------------------------------------------------------------------o------XXXX---xxxx--x--
-------------------------------x-------x------------------------------------------------------------------------------------------------XXX-----------xxXXX---x-
------------------------------xx--------x-------------------------------------------------------xxxxxxx----------------------------------------------xx--------x
-----------------------------xxX---------x----------------ooo----------------------------------xxXSSSS-x-----------------------------------------xx-xx---------X
----------------------------xx-X----------x---------------------------------------------------xx-X------x---------------------------------------xx-xx-----------
--------xxx--------------B-xx--X-----------x------B---------xxx----xxxx----------------------xx--X-------x-------------------------------------xx--XXX----------
xxxxxxxxx--xxxxxxxxxxxxxxxxxE--X------------xxxxxxxxxxxxxxxxx--xxxxx---xxxxxxxxxxxxxxxxxxxxxxxE-EX--------xxxxxxxxxxxxxxxxxxxxxxxxxxxxxxxxxxxxxx------------ooo-
XXXXXXXXX--XXXXXXXXXXXXXXXXXXXXXXXXX-------XXXXXXXXXXXXXXXXXX--XXXXX--XXXXXXXXXXXXXXXXXXXXXXXXXXXXXXXXX---XXXXXXXXXXXXXXXXXXXXXXXXXXXXXXXXXXXXXX------------XXX-