----------------------------------------------------------------------------------------------------------------------------------------------------------------
----------------------------------------------------------------------------------------------------------------------------------------------------------------
-------------------------------------------------------------------------------------------------------------------------------------------xxx------xxx---------
-----------------XXXX--------------------XXXX---------------------------------------------------------------------------------------------xx--x----xx--x-----xx-
------------------[]----------------------[]----------------------------------------------S----------------------------------------------xx----x--xx----x---xx-x
------------------[]----------------------[]--------------------------------------------------------------------------------------------xx------xxx------x-xx---
------------------<>----------------------<>------------------------------------------------------------------------------------------xxx-------XXX-------xx----
--------------------------------------------------------------------------------------SSSSS---------S--------------------------------xxXX-----------------XX----
-------------------E-----------------------E----------------------------------------------------------------------------------------xxXXX-----------------------
-----------------------xxxx--------------------xxxx--------------------------------------------------------------------------------xxXXXX-----------------------
-----------------xxxx-xx<>-x-------------xxxx-xx<>-x------------------------------------------------------------------------------xxXXXXX-----------------------
----------------xx---xxX[]--x-----------xx---xxX[]--x--------------------------------xxx-----------S---xxxx----------------------xxXXXXXXS----------------------
---------------xx---<>XX[]---x---------xx---<>XX[]---x------------------------------xx--x-------------xx<>-x--------------------xxXXXXXXX-----------------------
--------xxxxxxxx----[]XX[]----xxxxxxxxxx----[]XX[]----xxxxxxxxxxx-----------------Exx----x-----------xx-[]--x-xxxxxx-----------xxXXXXXXXX------o----------------
xxxxxxxxx--XXXXX----[]XXXXXXXXXXXXXXXXXX----[]XXXXXXXXXXXXXEE-EE-xxxxxxxxxxxxxxxxxxx------xxxxxxxxxxxx--[]---xx-----xxxxxxxxxxxxXXXXXXXXX------X----------------
XXXXXXXXX--X-XXX----[]XXXXXXXXXXXXXXXXXX----[]XXXXXXXXXXXXXXXXXXXXXXXXXXXXXXXXXXXXXX-----XXXXXXXXXXXXXXXXXXXXXX----XXXXXXXXXXXXXXXXXXXXXXXX---------------------