----------------------------------------------------------------------------------------------------------------------------------------------------------------
----------------------------------------------------------------------------------------------------------------------------------------------------------------
----------------------------------------------------------------------------------------------------------------------------------------------------------------
-----------------------------------------------------------------xxxx------xx-----------------------------------------------------------------------------------
----------------------------------------------------------------xx---xx---xx-x----------------------------------------------------------------------------------
---------------------------------------------------------------xx---<>-x-xx---x-xxx-----------------------------------------------------------------------------
---------------------------------------------------------------xx---[]--xx-----xx--x----------------------------------------------------------------------------
------------------------------------XXXXX----------------------Sx---XX--XX-----XX---x---------S-----------------------------------------------------------------
-------------------------------------------------------------xxxx--------------XX----x-------------------------------xxxx---------------------------------------
------------------------------------------------------------xx--x--------------XX-----x-----------------------------xx---x--------------------------------------
---------------o-------oo----------------------------------xx---S--------------XX------x---------------------------xx-----xxx---Q--?----------------------------
----------------------------------------------------------xx-------------------XX----X--x----xxxx----------xxxxxxxxx------<>-x----------------------------Q-----
-------------------------------------------------------xxxx--------------------XX----X---x--xx<>-x--B-----xx------x-------[]--x---------------------------------
------xxx----xxxxxxxxxxxxxx----xxx----xxx-------------xx--B--------------------XX----XX---xxx-[]--x-b--B-xx------<>-------[]---x---E-------------------B-------x
xxxxxxx--xxxxx-------x-----xxxxx--xxxxx--xxxxxxxxxxxxxxE--[---E----------------XX----XX----x--[]---xxxxxxx-------[]-------[]----xxxxxxxxxxxxxxxxxxxxxxxxxxxxxxxx
XXXXXXX--XXXXX---XX-XX----XXXXXX--XXXXX--XXXXX<>XXXXXXXXXXXXXXXXXX-------------XXXXXXXXXXXXXXXXXXXXXXXXXXX-------XXXXXXXXXXXXXXXXXXXXXXXXXXXXXXXXXXXXXXXXXXXXXXX