----------------------------------------------------------------------------------------------------------------------------------------------------------------
----------------------------------------------------------------------------------------------------------------------------------------------------------------
----------------------------------------------------------------------------------------------------------------------------------------------------------------
----------------------------------------------------------------------------------------------------------------------------------------------------------------
--------------------------------------------------------------------------------------------------------------------------------xx------------------------------
-------------------------------------------------------------------------------------------------------------------------------xx-x-----------------------------
------------------------------------------------------------------------------------------------------------------------------xx---x----------------------------
-------------------------------Q------------------------SSS------------------------------------------------SSSS---------E-xxxxx-----x---------------------------
-------------------------------------------------------------------------------------------------------------------------xxXSSS------x--------------------------
------------------------------------------------------------------------------------------------------------------------xxXXX---------x-------------------------
--------------------------------------------------xxxxx---------------------------------------------------------------xxxXXXS----------x--------------------oooo
-----------------------------S?SQQQ---E----------xx-XX-xSSS---E-------------------------------QQQ?QQ?QQ--------------xx<>XXXX--------X--x-----------------------
-------------------------------------<>---------xx--XX--x----<>------------B----------------------------------------xx-[]XXXX-SSS----X---x----------------------
----xxx----------------------------------------xx---XXX--x----------xxx----b---------------xxxx--------------xxxx--xx-X[]XXXX--------XX---x---------------------
xxxxxE-xxxxxxxxxxxxxxxxxxxxxxxxxxxxxxxxxxxxxxxxx----XXX---xxxxxxxxxxxE-xxxxxxxxxxxxxxxxxxxxxEE-xxxxxxxxxxxxxxx---xxx-XX[]XXXX--------XX----xxxxxxxxxxxxxxxxxxxxx
XXXXXXXXXXXXXXXXXXXXXXXXXXXXXXXXXXXXXXXXXXXXXXXX--XXXXXXXXXXXXXXXXXXXXXXXXXXXXXXXX<>XXXXXXXXXXXXXXXXXXXXXXXXXX-X-XXXXXXXXXXXXXX---XXXXXXXXXXXXXXXXXXXXXXXXXXXXXX