----------------------------------------------------------------------------------------------------------------------------------------------------------------
----------------------------------------------------------------------------------------------------------------------------------------------------------------
----------------------------------------------------------------------------------------------------------------------------------------------------------------
----------------------------------------------------------------------------------------------------------------------------------------------------------------
----------------------------------------------------------------------------------------------------------------------------------------------------------------
----------------------------------------------------------------------------------------------------------------------------------------------------------------
--------------------------------------------------------------------SSS----------------------------------------------------xxx-------------------xxx------------
-------------------------E----------------------------------------------------XX---------------XXXXXXXXXXXXXXX----xSSS----xx--x-----------------xxX-x-------E---
------------------------SSSS---------------------------------------------------------------------------------------------xx----x---------------xxXX--x----------
--------------------------------------------------------------------X---------------------------------------------------xx------x-------------xxXXX---x---------
----------------------E--E-----------------------------oo-----------XEE-----------------------------------------------xxx--o-----x-----------xxXXXX----x--------
--------------------SS?SSSSS---X---------ooooooooo------------------XSSSS--------------------------------------------xx<>------X--x---------xxXXXXX-----x-------
----------Q?QQQ---E-ES------EE-X------------------------------------------------------------------------------------xx-[]------X---x-------xxXXXXXX------x------
--------------------SSSSSSSSSSSX-----------------xxxxxxxxxx------------------------------------------xxxx-xxxx---x-xx--[]------XX---x-----xxXXXXXXX-----B-xxxxxx
xxxxxxxxxxxxxxxxxxxxxxxxxxxxxxxxxxxxxxxxxxxxxxxxxx---x-----xxxxxxxxxxxxxxxxxxxxxxxxxxxxxxxxxxxxxxxxxxx---xx---xxxxxx---[]------XX----xxxxxxXXXXXXXXXXXXXXXXXXXXX
XXXXXXXXXXXXXXXXXXXXXXXXXXXXXXXXXXXXXXXXXXXXXXXXXX--XX----XXXXXXXXXXXXXXXXXXXXXXXXXXXXXXXXXXXXXXXXXXXX---XX---XXXXXXXXXXXXXXXXXXXXXXXXXXXXXXXXXXXXXXXXXXXXXXXXXX