----------------------------------------------------------------------------------------------------------------------------------------------------------------
----------------------------------------------------------------------------------------------------------------------------------------------------------------
--------------------------------------------------------------xxx-----------------------------------------------------------------------------------------------
-------------------------------------------------------------xx--x----------------------------------------------------------------------------xx----------------
------------------------------------------------------------xx----x--------------------------------------------------------------------------xx-xxx---SSSSSSSSSS
-----------------------------------------------------------xx------x------------------------------------------------------------------------xx--XX-x--SSSS------
-------------------------------------------------------xxxxx--------x-------------------------------------E-------------------------xxxx---xx---XX--x-SSSS------
-------------------------------------E----------------xxXXXX---------x------------------------------SSS--SQS-----------------------xxXX-x--xS---XX---xSSSS------
-----------------------------------------------------xxXXXXX--------oox-----------------------------------------------------------xxXXX--x-x----XX----x---------
----------------------------------------------------xxXXXXXX-----------x------------------------xxx------------------------------xxXXXX---xx----XX-----x--------
--------xxxx-?-------------------------------------xxXXXXXXX------------xxx-?----------------xxxx--xx-----------------xxxx------xxXXXXX----x----XX-----oxxx-----
-------xx<>-x-------------------------------------xxXXXXXXXXS-----------<>-x----------------xxXXX-XX-x---SQS---------xx<>-x----xxXXXXXX----SS---XX----S?SS-x----
------xx-[]--x-----------------------------------xxXXXXXXXXX------------[]--x--------------xxXXXX-XX--x-------------xx-[]--x--xxXXXXXXX---------XX----SSS---x--x
-----xx--[]---x----------------xxxxxxxxxxxxxxxxxxxXXXXXXXXXX------------[]---x------------xxXXXXX-XXX--x-----------xx--[]---xxxXXXXXXXX---------XX----SS-----xxx
xxxxxx---[]----xxxxxxxxxxxxxxxxxEEXXXXXXXXEXXXXXXXXXXXXXXXXX------------[]----xxxxxxxxxxxxxXXXXXX-XXX--Exxxxxxxxxxxx---[]----xXXXXXXXXX---------XX------E-EE--xX
XXXXXXXXXXXXXXX<>XXXXXXXXXXXXXXXXXXXXXXXXXXXXXXXXXXXXXXXXXXXXX------XXXXXXXXXX<>XXXXXXXXXXXXXXXX--XXXXXXXXXXXXXXXXXXXXXXXXXXXXXXXXXXXXXXXXXXXXXXXXXXXXXX-XXXXXXX