----------------------------------------------------------------------------------------------------------------------------------------------------------------
----------------------------------------------------------------------------------------------------------------------------------------------------------------
----------------------------------------------------------------------------------------------------------------------------------------------------------------
-----------------------------------------------------------------S-----------------------------------------------------------------------------?----------------
-------?-----------------------------------------------------------------------------------------------------------xx-------------------------------------------
------------------------------------------------------------------------------------------------------------------xx-x------------------------------------------
-------------------------------S-?-Q--------------xxxxxx-------XXXX----------------------------------------------xx---x-------xxxxxxxx--------S-------XXX-------
--------------------------oo---------------------xx-----xoo----XXX--------------------------------------------xxxx-----x-----xx----XX-x-------------------------
---------SS--------------------------E---E------xx-------x---------------------------------------------------xxXXX------x---xx---------xx-----------------------
-------------------xxxx--xxx--xxx----xxxxxxxxxxxx---------xxx-----------xxxxx----------------xxxx-----xxxxxxxx-----------xxxx----------E-xxxxxxxxx--------xxxxxx
-----SS----xxxxxxxxx---xxx--xxxE-xxxxxXXXXXXXXXXX---------XX-x---------xxX---x------------xxxx---x---xx-XXXXXX-----------XXXX--------XXXXXXXXXXXX-x------xxXXXXX
----------xxXXXXXXXX---XXX--XXXEXXXXXXX-----------------------x-------xx-X----x----------xxXXX----x-xx---------------------------------------------x----xx------
---------xxXXX-------------------------------------------------xx----xx--X-----x--------xx---------xx-----------------------------------------------x--xx-------
-------xxxXXX-------------------------------------------------XX-xxxxx--EX------x-xxxx-xx----------<>------------------------------------------------xxx--------
xxxxxxxx-XXXX-------------------------------------------------XXXXXXXXXXXX-------xx---xx-----------[]---------------XXXXX-------------------------XXEXXXX-------
XXXXXXXX-XXXX-------------------------------------------------XXXXXXXXXXXX-----XXXX--XXXXXX--------[]-----------------------------------------------------------