----------------------------------------------------------------------------------------------------------------------------------------------------------------
----------------------------------------------------------------------------------------------------------------------------------------------------------------
----------------------------------------------------------------------------------------------------------------------------------------------------------------
----------------------------------------------------------------------------------------------------------------------------------------------------------------
--------------------------------------------------------------------------------------------------------------------------------------------X-------------------
-------------------------------------------------------------------------------------------------------------------------------------------X--------------------
-------------------------------------------------------------------------------------------------------------X--EX----------------------------------------------
---------------------------------------------?---------------------------------------------------------------X---X----------------------------------------------
-----------------------------------------------------------------------------XXoo--------------E----X-EE---X-X---X-------------------oo------------------------x
----------------------------------------------------------------------------------------------<>----XSSSSSSX-XSS?X----------xxx------oo-------XXXX-----------xxx
------------------------------------------------------------------------------------------<>--[]---------------------------xx--x------------xxxx------------xx<>
--XXXX------------------------------------------xxxxx-----oooo------------------------<>--[]--[]--------------------------xx----xxxxxxxxxxxxXXX-x----------xx-[]
------------------------------------------E----xx----x--------------------------------[]--[]--[]--xxxxxxxxxxxxxxxxxxxxxxxxxX----XXXXXXXXXXXX-----x--------xx--[]
--xxx---------B-------------------------------xxX---X-x------xxxxx--------------------[]--XX--XXXXXXXXXXXXXXXXXXXXXXXXXXXXXX----X---------X-------xxxxxxxxx---[]
xxx--xxxxxxxxxxxxxxxxxxxxxxxxxxxxxxxxxxxxxxxxxx-X-E-X--xxxxxxx----xxxxxxxxxx----------XX--XX--XXXXXXXXXXXXXXXXXXXXXXXXXXXXXX----X---------X------XXXXXXXXXXXXXXX
XXX--XXXXXXXXXXXXXXXXXXXXXXXXXXXXXXXXXXXXXXXXXXXXXXXXXXXXXXXXX--X-XXXXXXXXX-----------XX------------------------------------------------------------------------