----------------------------------------------------------------------------------------------------------------------------------------------------------------
----------------------------------------------------------------------------------------------------------------------------------------------------------------
----------------------------------------------------------------------------------------------------------------------------------------------------------------
----------------------------------------------------------------------------------------------------------------------------------------------------------------
----------------------------------------------------------------------------------------------------------------------------------------------------------------
-----------------------------------------------------------------------------------------------------------------------------------xxx--------------------------
--------------------------------------------------oooooooooooooooooooo----------------------------E---------xxxxx---------XXX-----xx--x-------S-----------------
-------------------------------------------------XXXXXXXXXXXXXXXXXXXXXX---------------SSS------------XXoo--xxXXX-x---------------xx----x------------------------
----------------------------------------------------------------------------------------------------------xx------xx------------xx------xxxx--------------------
----------------------------------------------------------------------------------------------------xxxxxxx-------E-xx--------xxx--------xB-xxxxx---------------
--ooooooo------------------------------------------------------------------------------------oo--xxxx----x------XXXXX-x------xxXXEXX-----XXXXESS-x-----------xxx
---------o-xxx----------------------------------------------------------------------------------xxXXX----XX------------x----xx----------XXXXXX----x---------xxX-
----------xxX-x-----------------E--------------------------------------------------------------xx-----------------------x--xx----------XXXXXXX-----x-------xx-X-
---------xx-X--x----------------------xxxxx------------------------------------------xxxx-----xx-------------------------xxx----------XXXXXXXX------xxxxxxxx--X-
xxxxxxxxxx--X---xxxxxxxxxxxxxxxxxxxxxxx--------------------------------E--------xxxxxx---xxxxxx-----------------------XXEXXXXX--------XXXXXXXXXXXXXXXXXXXXXXXXXX
XXXXXXXXXX--XXXXXXXXXXXXXXXXXXXXXXXXXXX----XXXXXXXXXXXXXXXXXXXXXXXXXXXXXXXXXXXXXXXXXXX---XXXXXXXXX------------------------------------XXXXXXXXXXXXXXXXXXXXXXXXXX