----------------------------------------------------------------------------------------------------------------------------------------------------------------
----------------------------------------------------------------------------------------------------------------------------------------------------------------
----------------------------------------------------------------------------------------------------------------------------------------------------------------
------------------------------------------------------------------------------xxxxxxxxxxxxxxxxxxxxxxxxxxxxxxxxxxxxx---------------xx----------------------------
SSSSSSSSSSSS?SSSSSSSSSS?SSSSSSSSSSSSSSSSSSSSSSSSSSSSSSSSSSSSSS---------------xxSSSSSSSSSSSSSSSSSSSSSSSSSSSSSSSSSSS-x-------------xx-x-----------S---------------
----------------------------------------------------------------------------xx--------------------------------------x-----xx----xx---x--------------------------
----------------------------------------------------------------XXXXXXXXXX-xx----------------------------------------x---xx-xxxxx-----xxxx----------------------
---------oooo------ooooo---------------QQ--QQ--QQ--QQ--QQ------xxxxxxxxxxx-xSSS---------------------------------------x-xx--SSSSS-----SSSxSSSSSSS---------------
------------------------------------xx------------------------xx----------xx-------------------------------------------xx-----------------x---------------------
---------SSSS------SSSSS-----------xx-x-xxx-xxx-xxx-xxx-xxx--xx------------xS--------------------E---------------------<>------------------x--------------------
---------SSSS------SSSSS----------xx---xx--xx--xx--xx--xx--xxx-------------S-S-----------E------<>---------------------[]-------------------x-------------------
--------------------------------xxx----QQ--QQ--QQ--QQ--QQ--QQQ----------------S---------<>------[]---------------------XXX-------------------x-----------xxxx---
-------------------------------xx<>--------------------------------------------------XX-[]--<>--[]---------------E-----------E------E---------x---------xx<>-x--
-----xxxx------xxxx-----------xx-[]-------------------------------------------------XXX-[]--[]--[]--XXXXX-------<>----------<>-----<>----------x-------xx-[]--x-
xxxxxx---xxxxxxx---xxxxxxxxxxxx--[]-----------------------------------------------E-XXX-[]--[]--[]--------------[]----------[]-----[]-----------xxxxxxxx--[]---x
XXXXXX--XXXXXXXX--XXXXXXXXXXXXXXXXXXXXXXXXXXXXXXXXXXXXXXXXXXXX-------------XXXXXXXXXXX--XX--XX--XX------------XXXXXXXXXXXXXXXXXXXXXXXXXX-------XXXXXXXXXXXXXXXXX