----------------------------------------------------------------------------------------------------------------------------------------------------------------
------------------------------------------------------------------------------------------------------------------------------------------xxxxx-----------------
-----------------------------------------------------------------------------------------------------------------------------------------xx---xx----------------
----------------------------------------------------------------------------------------------------------------------------------------xx------x---------------
---------------------------------------------------------------------------------------------------------------------------------------xx--------xx-------------
----------------------------------------------xxxx------------------------------------------------------------------------------------xx---------E-xxxx---------
---------------------------------------------xxXX-x-------------------------------------------------------------------------------xxxxx-------------x--x--------
--------------------------------------------xxXEX--x---E--------------------------------XX-----------------SQ?QQQ----------------xxXXXX------X-----<>---x-----E-
-------------------------------------------xxXXXX---x-----------------------------------XX--------------------------------------xxXXXXX------------[]----x-xxxxx
----------------------xx------------------xxXXXXX--E-x--------ooo-------------------xxx-XX-------------------------------------xxXXXXXX------------[]-----xx----
---------------------xx-x----------------xxXXXXXX-<>--x-------ooo------------------xxXx-XX-------------------E----------------xxXXXXXXX------------XX-----XX----
--xxx-----E---------xx---x--------------xxXXXXXXX-[]---x--------------------------xxXX--XX----------------QQQ-QQQ------------xxXXXXXXXX-----------------E-------
--xB-x------------xxx-----x------------xxXXXXXXXX-[]----x------------------------xxXXX-xXX----------------------------------xxXXXXXXXXX-------------------------
-xxb--x----------xx<>------x----------xxXXXXXXXXX-[]-E---xxxxxxxxxxxxxxxxxxxxxxxxxXXXX--x----------------------------------xxXXXXXXXXXX-------------------------
xx-BEE-xxxxxxxxxxx-[]-------xxxxxxxxxxxXXXXXXXXXXXXXXXXXXXXXXXXXXXXXXXXXXXXXXXXXXXXXXX---xxxxxxxxxxxxxxxxxxxxxxxxxxxxxxxxxxxXXXXXXXXXXX-------------------------
XXXXXXXXXXXXXXXXXXXXXXX----XXXXXXXXXXXXXXXXXXXXXXXXXXXXXXXXXXXXXXXXXXXXXXXXXXXXXXXXXXXXXXXXXXXXXXXXXXXXXXXXXXXXXXXXXXXXXXXXXXXXXXXXXXXX------X------------------