----------------------------------------------------------------------------------------------------------------------------------------------------------------
----------------------------------------------------------------------------------------------------------------------------------------------------------------
----------------------------------------------------------------------------------------------------------------------------------------------------------------
----------------------------------------------------------------------------------------------------------------------------------------------------------------
SSSSSSSSSSSSSSSSSSSSSSSSSSSSSSSSSSSSSSSSSSSSSSSSSSSSSSSSSSSSSSSSSSSSSSSSSSSSSSSSSSSSSSSSSSSSSSSSSSSS---------oo-------------------------------------------------
-------------------------------------------------------------------------------------------------------------XXX------------------------------------------------
------------------------------------------------------------------------------------------------------xxxx------------------------------------------------------
------------------------------------------------------ooo--------------------------------------------xxXX-x--------------------------------------SSS------------
-------------------------------------xx----------------------------------------------o--------------xx-----x----------------------------------------------------
------------------------------------xx-x-xxx--------S-SSS------------------------xxxxx-------------xx-------x---------------------------------------------------
-----------------------------------xx---xx--x-------So--S--------------------xxxxx--S-x--------xxxxx-------------XX-------------------Q------xxxxx--------------
------QQQQQQQQQQ---QQQQQQQQQQQ---xxx----<>---x------SS--S--------QQQQQ-----xxxXXXX-----xx-----xx-XXX------XX-xxxxxx--------------xxxx----xxxxx-XX-x----------xxx
--------------------------------xx<>----[]----xxx------------------------xxxXXXXXXXX--XX-xx--xx---------------XXXX-x------------xx<>-x-xxxXX<>-XX--x---------xB-
-------------------------------xx-[]----[]----<>-x---------------------xxxXXXXXXXXXX--XXXX-xxx---------------X------xxxxxxxxxxxxx-[]--xXXXXX[]-XXX--x-------xxb-
xxxxxxxxxxxxxxxxxxxxxxxxxxxxxxxx--[]----[]--E-[]--xxxxxxxxxxxxxxxxxxxxxxXXXXXXXXXXXXE-XXXX--xX----------------------XXXXXXXXXXXXXXXXX-XXXXXX[]-XXX--Exxxxxxxx-BE
XXXXXXXXXXXXXXXXXXXXXXXXXXXXXXXXXXXXXXXXXXXXXXXXXXXXXXXXXXXXXXXXXXXXXXXXXXXXXXXXXXXXXXXXXXXXXX----------------------XXXXXXXXXXXXXXXXX-XXXXX-XXXXXXXXXXXXXXXXXXXX