----------------------------------------------------------------------------------------------------------------------------------------------------------------
----------------------------------------------------------------------------------------------------------------------------------------------------------------
----------------------------------------------------------------------------------------------------------------------------------------------------------------
----------------------------------------------------------------------------------------------------------------------------------------------------------------
----------------------------------------------------------------------------------------------------------------------------------------------------------------
----------------------------------------------------------------------------------------------------------------------------------------------------------------
----------------------------------------------------------------------------------------------------------------------------------------------------------------
-----------------------------------------------------------QQQQ-------------------------------------------------------------------------------------------------
---------------------------------------------------------------------------------------------------------------------------------------------------------------x
--------------------------------------------------------------------------------------------------------------------------------------------------------xxxxxxxx
--oooooooooooooooooooooooooooo--------------------------------------------------------------ooooooooooooo-------oooooooooooo---------ooooooooooo-------xx----XXX
---------------------------------------------------------QQ?SSQQQQ?QQ?QQQQ--------------------------------------------------o-------------------o-----xx--------
-----------------------------------------xxxx--------------------------------------------------------------------------------------------------------xx---------
----------------------------------------xx<>-x-------------xxx------------------------------------------------------------------------------------xxxx----------
xxxxxxxxxxxxxxxxxxxxxxxxxxxxxxxxxxxxxxxxx-[]--xxxxxxxxxxxxxx--xxxxxxxxxxxxxxxxxxxxxxxxxxxxxxxxxxxxxxxxxxxxxxxxxxxxxxxxxxxxxxxxxxxxxxxxxxxxxxxxxxx-XXXX----------
XXXXXXXXXXXXXXXXXXXXXXXXXXXXXXXXXXXXXXXXXXXXXXXXXXXXXXXXXXXX--XXXXXXXXXXXXXXXXXXXXXXXXXXXXXXXXXXXXXXXXXXXXXXXXXXXXXXXXXXXXXXXXXXXXXXXXXXXXXXXXXXX---------------