----------------------------------------------------------------------------------------------------------------------------------------------------------------
----------------------------------------------------------------------------------------------------------------------------------------------------------------
----------------------------------------------------------------------------------------------------------------------------------------------------------------
--------------------------------------------------------------------------------------------------------------S-------------------------------------------------
----------------------------------------------------------------------------------------------------------------------------------------------------------------
----------------------------------------------------------------------------------------------------------------------------------------------------------------
------------------------------------------------------------------------------------------------------------XXXX------------------xxxxxxx-----------------------
-------SSSSSSS?SSS------------------------------------------------------------------------------------------XXX------------------xx--QQQ-x----------SSSSSSS-----
--------------------------------------------------------------------------------------------------------------------------------xx--------x---------------------
--------------------------------------------------------------------------------------------------------xx------------S--------xx----------x--------------------
-------------------------------------------------------------------------ooooooooo---------------------xx-x-------------------xxX----SSS----xxx------E--E-------
-------SSSSSSSSSSS----------------------------xxxxx-------------------------------o----------oo-------xx---x---------xxx-----xxEX-----------<>-x----SSSSSSS-----
---------------------------------------------xx----x-------------------------------------------------xx-----xx------xxS-x---xxXXX-----------[]--x--------------x
---------------xxxxxxx----------------xxx---xxX---X-x-xxxxx-xxx-------------------------------------xx-----XX-xxxxxxx-SS-x-xxXXXX-----------[]---x-----xxx----xx
xxxxxxxxxxxxxxxx---x--xxxxxxxxxxxxxxxxxE-xxxx-X-E-X--xx--X-xx-ExxxxxxxxxxxxxxxxxxxxxxxxxxxxxxxxxxxxxxX-----XXXXXXX<>XXXXX-xxXXXXX---E-------[]----xxxxxx--xxxxx-
XXXXXXXXXXXXXXXX-X-X-XXXXXXXXXXXXXXXXXXXXXXXXXXXXXXXXXX--XXXX--XXXXXXXXXXXXXXXXXXXXXXXXXXXXXXXXXXXXXXX-----XXXXXXX[]XXXXXXXXXXXXXXXXXXXXXXXXXXXXXXXXXXXX--XXXXXX