----------------------------------------------------------------------------------------------------------------------------------------------------------------
----------------------------------------------------------------------------------------------------------------------------------------------------------------
----------------------------------------------------------------------------------------------------------------------------------------------------------------
----------------------------------------------------------------------------------------------------------------------------------------------------------------
-----------------------------------------------------------------------------------------------------S----------------------------------------------------------
----------------------------------------------------------------------------------------------------------------------------------------------------------------
------------------------------------?--XXXXXXX---------xxxx-------------------------------xxxxx-------------------------------------------------------xxxx------
------------------------------------E-----[]----------xxXX-x------------------------------xSSSxSSSSSSS-----------------------------------------------xxXX-x-----
------------------------------------------[]---------xxXXX--x-----------------------------x----x----------------------------------------------------xxXXX--x----
------------------------------------------[]--------xxXXXX---x----------------------------x-----x--------------------------------------------------xxXXXX---x---
----ooooxxxx------------------------------[]-------xxXXXXX----xxx------------------------xx------x---------------------------------xxxx-----------xxXXXXX----xxx
-------xx-X-x-----------------------------<>x-----xxXXXXXX---SSS-x----------------------xxX-------x-------------------------------xx---xx--------xxXXXXXX----<>-
------xx--X--x----------------------------xx-x---xxXXXXXXX--------x------------E-------xx-X--------x---------xxxxxx--------------xx---<>-x------xxXXXXXXX----[]-
-----xx---X---x----xxxxxxxxxxxxxxxxxxxxxxxxE--xxxxXXXXXXXX---------xxxxxx-------------xx--X---------x-------xx<><>-x---xxx------xx----[]--xxxxxxxXXXXXXXX----[]-
xxxxxx----X----xxxxxXXXXXXXXXXXXXXXXXXXXXXXX--XXXXXXXXXXXX----------x----xxxxxxxxxxxxxxE--X----------xxxxxxxx-[][]--xxxx--xxxxxxxX----XXXXXXXXXXXXXXXXXXX----[]-
XXXXXX-XXXXXXXXXXXXXXXXXXXXXXXXXXXXXXXXXXXXX--XXXXXXXXXXXXXX--XXX---X----XXXXXXXXXXXXXXXXXXXX-------XXXXXXXXXXXXXXXXXXXX--XXXXXXXX----XXXXXXXXXXXXXXXXXXXXXXXXXX