----------------------------------------------------------------------------------------------------------------------------------------------------------------
----------------------------------------------------------------------------------------------------------------------------------------------------------------
----------------------------------------------------------------------------------------------------------------------------------------------------------------
---------------------------------------------------------------------------------xx-----------xx-x---------------xx------------------------------xx-------------
SSSSSSSSSS?SSSSSSSSSSSSSSSSSSSS-------------------------------------------------xx-xxx-------xx-x-x-------------xx-xxx--------------------------xx-x-----------S
-------------------------------------------------------------------------------xx--XX-x-----xx--S--x-----xx----xx--XX-x------------------------xx---x-----------
---------------------------------XXXX-----------------------------------------xx---XX--x---xx-------x---xx-xxxxx---XX--x---------------xxxx---xx-----xxxx-------
------ooooo-------------QQ------xxxxxxxxS-------------------------------xxxx--xS---XX---x--xS--------x-xx--SSSSS---XX---x-------------xxXX-x--xS-----SSSxSSSSSSS
---------------------xx--------xx------xxx-----------------------------xx---x-x----XX----x-x----------xx-----------XX----x-----------xxXXX--x-x----------x------
------SSSSS---------xx-x-xxx--xx----------x-xxx-----------------------xxX----xx----XX-----xx----------<>-----------XX-----x---------xxXXXX---xx-----------x-----
------SSSSS--------xx---xx--xxx--------E-EExx--x---------------------xxXX-----x----XX------x----------[]-----------XX------x-------xxXXXXX----x------------x----
-----------------xxx----QQ--QQQ------------XX-X-x--------QQQQ-------xxXXX-----SS---XX------SS---------XXX----------XX----X--x-----xxXXXXXX----SS------------x---
----------------xx<>-----------------------XX-XX-x-----------------xxXXXX----------XX-----------E-----------E------XX----X---x---xxXXXXXXX---------E---------x--
--xxxx---------xx-[]-----------------------XX-XXX-x---xxxx------B-xxXXXXX----------XX----------<>----------<>------XX----XX---x-xxXXXXXXXX--------<>----------x-
xxx---xxxxxxxxxx--[]-----------------------X--XXXX-xxxxEE-xxxxxxxxxXXXXXX----------XX----------[]----------[]------XX----XX----xxXXXXXXXXX--------[]-----------x
XXX--XXXXXXXXXXXXXXXXXXXXXXXXXX------------X--XXXXXXXXXXXXXXXXXXXXXXXXXXXXXXXXXXXXXXXXXXXXXXXXXXXXXXXXXXXXXXXXXXXXXXXXXXXXXXXXXXXXXXXXXXXXXXXXXXXXXXXXX-------XX