----------------------------------------------------------------------------------------------------------------------------------------------------------------
----------------------------------------------------------------------------------------------------------------------------------------------------------------
----------------------------------------------------------------------------------------------------------------------------------------------------------------
----------------------------------------------------------------------------------------------------------------------------------------------------------------
-------------------------------------------------------------------xx------------------------xxxxx--------------xxxxx-------------------------------------------
--------------------oo--------------------------------------------xx-xxxx-----------------xxxx----xxxxxxxxxxxxxxx----xxxxxxxxxxxxxxxxxxxxxxxxxxxx---------E-----
--------------------oo-------------------------------SSSS--------xxX--x--x---------------xx--X----SSSSSSSSSSSSSSS----SSSSSSSSSSSSSSSSSSSSSSSSSSX-x--------------
--------------SSS-------------------------------------[]--------xxXX--X---x-------------xx-----------------------------------------------------X--x-------------
------------------------------------------------------[]-------xxXXXX------x-xxxx-xxxxxxxE-----------------------------------------------------X---x------------
------------------------------------------------------[]------xxXXXX--------xx---xx-----<>-------------------E----------E----E----E------E-----X--E-x-----------
----------xxxxxxxxx----?---oo-------------------------[]-----xxXXXXX--------XX--XXX-----[]------S-----------<>-----S---->---<>---<>-----<>---S?X-<>--x----------
--------xxx-XXXXXX-xx-----xx---------QQ---------------<>----xxXXXXXX--------------------[]-------------E----[]---------<]---[]---[]-----[]-----X-[]---x---------
-------xx<>-XX-------x---xx-x-------------------------xxx--xxXXXXXXX-E------------------[]------------<>----[]---------[]---[]---[]-----[]-----X-[]----x---xxx--
------xx-[]-XX--------x-xx---xxxx-----------xxxxxxxxxxxE-xxxXXXXXXXX<>------------------[]------------[]----[]---------[]---[]---[]-----[]-----X-[]-E---xxxx--x-
xxxxxxx--[]-XX---------xx-----x--xxxxxxxxxxxx-EEXXXXXXXX-XXXXXXXXXXX[]------------------XXXXXXX-------XXXXXXXXXXXX-----XXXXXXXXXXXXXXXXXXXXXXXXXXXXXXXXXXXXX---x
XXXXXXXXXXXXXXXX-------XX-----X--XXXXXXXXXXXX-XXXXXXXXXXXXXXXXXXXXXX[]------------------XXXXXXX-------XXXXXXXXXXXX-----XXXXXXXXXXXXXXXXXXXXXXXXXXXXXXXXXXXXX---X