----------------------------------------------------------------------------------------------------------------------------------------------------------------
----------------------------------------------------------------------------------------------------------------------------------------------------------------
----------------------------------------------------------------------------------------------------------------------------------------------------------------
----------------------------------------------------------------------------------------------------------------------------------------------------------------
------SSSSSSSS?SSSSSSSSSSSSSSSSSSSSSSSSSSSSSSSSSSSSSSSSSSSSSSSSSSSSSSSSSSSSSSSSS?SSSSSSSSSSSSSSSSSSSSSSSSSSSSSS-------------------------------------------------
---------------------------------------SSSSSSSSSSSSSSSSSSSSS----------------------------------------------------------------------------------------------------
---------------------------------------SSSSSSSSSSSSSSSSSSSSS----------------------------------------------------------------------------xxxxx-------------------
-SSSSS-----oooo-----------QQ-----------SSSSSSSSSSSSSSSSSSSSS--QQ------------ooooo------------------------------------------------------xxXX--x------------------
-----------------------xx-------------------------------------------------------------------xx----------------------------------------xxXXX---x-----------------
-----------SSSS-------xx-x-xxx---------------xxx----xxx----xxx-xxx----------SSSSS----------xx-x-xxx--------------oo------------------xxXXXX----x----------------
-----------SSSS------xx---xx--x--------xxxxxxx?-xxxxx?-xxxxx--xx--x---------SSSSS---------xx---xx--x--------xxxxx-------------------xxXXXXX-----x---------------
S------------------xxx----QQ---x------xx-SSSSS??SSSSS??SSSSS--QQ---x--------------------xxx----<>---x------xxXXX-x-----------------xxXXXXXX---E--x---------S----
------------------xx<>----------xxx--xx--SSSS---SSSS---SSSSS--------xxx----------------xx<>----[]----xxx--xxEXXX--x---------E-----xxXXXXXXX---X---x------E------
--xxxx-xxxx------xx-[]----------<>-xxx---SSSS---SSSS---SSSSS--------<>-xxxxx----------xx-[]----[]----<>-xxxXXXXX---x-------------xxXXXXXXXX---X----x-------xxxx-
xxx---xx---xxxxxxx--[]--------E-[]--x--------oooS---oooSSSSS------E-[]--x---xxxxxxxxxxx--[]----[]--E-[]--xXXXXXX----xxxxxxxxxxxxxxXXXXXXXXX---X-----xxxxxxxx---x
XXX---XX--XXXXXXXXXXXXXXXXXXXXXXXXXXX---XXXXXXXXXXXXXXXXXXXXXXXXXXXXXXXXX--XXXXXXXXXXXXXXXXXXXXXXXXXXXXXXXXXXXX---XXXXXXXXXXXXXXXXXXXXXXXXXXXXXXXXXXXXXXXXXX---X