----------------------------------------------------------------------------------------------------------------------------------------------------------------
----------------------------------------------------------------------------------------------------------------------------------------------------------------
-----------------------------------------------------------------------------------------------------------------xxx--------------------------------------------
----------------------------------------------------------------------------------------------------------------xx--x-----xx------------------------------------
---------------------------------------------------------------------------------------------------------------xx----x---xx-x-----------------------------------
--------------------------------------------------------------------------------------------------------------xx------x-xx---x----------------------------------
----------------------------------------------------------------------------------------SSSSSS--------------xxx--------xx-----x---------------------------------
-----------------------------------------------------XXX------------xxx----------------------------------E-xxXX--------XX------x------------------?-------------
--------------xxxx------------------xxxx----------------------------xB-x-------QQQ------------------------xxXXX---------------oox----oooo-----------------------
-------------xxXX-x----------------xxXX-x--------------------------xxb--------------------xxxxx----------xxXXXX------------------x------------------------------
------------xxXXX--x--------------xxXXX--x------------------------xxXXX-x------------Q--xxxSSS-x-------xxxXXXXX-------------------xxx---------------------------
-----------xxXXXX---x------------xxXXXX---x----------------------xxXXXX--x-------------xx<>-----x-----xx<>XXXXXS------------------<>-x-----QQ?QQ--Q-------------
----------xxXXXXX----x----------xxXXXXX----x--------------------xxXXXXX---x------xxxx-xx-[]------x---xx-[]>XXXX-------------------[]--x-------------------------
---------xxXXXXXX-----x-----xxxxxXXXXXX-----x------xxxxx-------xxXXXXXX----xxxxxxxB--xx--[]-------xxxx-X[]XXXXX-------------------[]---x------------------------
xxxxxxxxxxXXXXXXX------xxxxxx--xXXXXXXX-----Exxxxxxx----xxxxxxxxXXXXXXXXXXXXXXXXXXX--XXXXXXXXXXXXXXXXXXX[]XXXXX-------------------[]----xxxxxxxxxxxxxxxxxxxxxxxx
XXXXXXXXXXXXXXXX--XXXXXXXXXXX-XXXXXXXX--XXXXXXXXXXXX----XXXX<>XXXXXXXXXXXXXXXXXXXXX--XXXXXXXXXXXXXXXXXXXXXXXXXXXX-------------XXXXXXXXXXXXXXXXXXXXXXXXXXXXXXXXXX