----------------------------------------------------------------------------------------------------------------------------------------------------------------
----------------------------------------------------------------------------------------------------------------------------------------------------------------
----------------------------------------------------------------------------------xxx---------------------------------------------------------------------------
---------------------------------------------xxxxxxxxxxxxxxxxxxxxxxxxxxxxxxxxxxxxxx--x-------------xxx-----xxxx-----xx------------------------------------------
---------------------------------------------xXXXXXXXXXXXXXXXXXXXXXXXXXXXXXXXXXXXXX---xx--xxx-----xx--x---xx---x---xx-x-----------------------------------------
--------------------------------------------xxXXXXXXXXXXXXXXXXXXXXXXXXXXXXXXXXXXXXX---E-xxx--x---xx----x-xx-----x-xx---x------------------------------oo--------
-------------------------------------------xx-XXXXXXXXXXXXXXXXXXXXXXXXXXXXXXXXXXXXX-----XXXE--x-xx------xx-------xx-----x-----------------------------oo--------
-------------------------------------------xS-XXXXXXXXXXXXXXXXXXXXXXXXXXXXXXXXXXXXX------------xx-------XX-------XX------x--------------------------------------
-------------------------------------------x--XXXXXXXXXXXXXXXXXXXXXXXXXXXXXXXXXXXXX------------XX-----------------------oox---------------xxx----xxx------------
------------------------------------------xx--XXXXXXXXXXXXXXXXXXXXXXXXXXXXXXXXXXXXX----------------------------------------x-----------xxxx--xxxxx--x-----------
-----------------------------------------xxS--XXXXXXXXXXXXXXXXXXXXXXXXXXXXXXXXXXXXX-------------o---------------------------x----E----xxXXX--XXXXX---x---?------
---------------------------------B----E--x----XXXXXXXXXXXXXXXXXXXXXXXXXXXXXXXXXXXXX-------------o--XX------------------------xxx-----xx---------------x-----xxxx
---------------------------------b----E-xx----XXXXXXXXXXXXXXXXXXXXXXXXXXXXXXXXXXXXX------------------------------------------XX-x---xx-----------------x---xxXXX
--------------------xxx----------B-----xx---E-XXXXXXXXXXXXXXXXXXXXXXXXXXXXXXXXXXXXX---------X------------------------------------xxxx-------------------x-xx----
xxxxxxxxxxxxxxxxxxxxx--xxxxxxxxxxxxxxxxx------XXXXXXXXXXXXXXXXXXXXXXXXXXXXXXXXXXXXX----------------------------------------------XXXX-----XXX----XXX-----xx-----
XXXXXXXXXXXXXXXXXXXXX--XXXXXXXXXXXXXXXXXXXXXXXXXXXXXXXXXXXXXXXXXXXXXXXXXXXXXXXXXXXX-------------------------------------XXXX-----X-----------------------XX-----