----------------------------------------------------------------------------------------------------------------------------------------------------------------
----------------------------------------------------------------------------------------------------------------------------------------------------------------
----------------------------------------------------------------------------------------------------------------------------------------------------------------
----------------------------------------------------------------------------------------------------------------------------------------------------------------
--------------------------------------------------------------------------------------------------------S-------------------------------------------------------
----------------xxx-----------------------------------------------------------------------------------------------------------xxx-------------------------------
--------------xxx--x-------------------------------------------------------------------E------------------------------------Exx--x------------------------------
-------------xxXX---x-----------------------SSSSSSSS-------S-------------------------QQQQQQQQ-------SSSSS----------------xxxxx----x-----------------------------
------------xx-XX----x---ooo--------------E-----------------------------------------------------------------------------xx--x------x----------------------------
-----------xxXXXX-----x--------------------xxxxxxx---------------------------------------------------------------------xx---X-------x-xxx-----ooo---------------
-------E--xx-XXXX------xo----------------xxx------xx------------------------------------E-----------------------------xx-------------xx--x----ooo--------------x
---------xxXXXXXX----XXxx---------------xx<>-----<>-x------S-------------------E----QQQQQQQQQ------xxx---------------xxX------------XXX---x--------E----------xx
--------xx-XXXXXX----XX--x-------------xx-[]-----[]--x------------------------<>------------------xx--x-------------xxXXX------------------xxxxxxxxxxxxx-----xx-
-------xx--XXXXXX----XX---x------xxxxxxx--[]-----[]---x------xxxx------------------------------B-xx----x------xxxxxxxXXXX------------------XXXXXXXXXXXX-xxxxxx--
xxxxxxxx---XXXXXX----XX----xxxxxxx----x---[]-----[]----xxxxxxx---xxxxxxxxxxxxxxxxxxxxxxxxxxxxxxxxx------xxxxxxx----xXXXX-------------------X---------XX-XXXXXX--
XXXXXXXXXXXXXXXXXXXXXXXXXXXXXXXXXX---XXXXXXX-----XX--XXXXXXXXX---XXXXXXXXXXXXXXXXXXXXXXXXXXXXXXXXX-----XXXXXXXX---XXXXXX-------------------X---------XX---------