----------------------------------------------------------------------------------------------------------------------------------------------------------------
----------------------------------------------------------------------------------------------------------------------------------------------------------------
----------------------------------------------------------------------------------------------------------------------------------------------------------------
--------------------------------------------------------------------------------------------------------xxx-----------------------------------------------------
-------------------------------------------------------------------------------------------------------xx--x----------------------------------------------------
------------------------------------------------------------------------------------------------------xx----x---------------------------------------------------
---------------------------------------xxxxxx---------------------------------------------------------xx-----x--------------------------------------------------
--------------------------?SS---------xxXXX--x-------------?SS----------------------------------------Sx------x----------------SSQSS?SSS?SSS--------------------
-------------------------------------xx-XXX---x-------------------------------ooo-------------------xxxx-----oox------------------------------------------------
------------------------------------xx--XXX----x---------------------------------------------------xx--x--------x-----------------------------------------------
----------oo-----------------------xxXX-XXX-----xo-------------------------------------------xxx--xx---S---------x-----------------------------oo---------------
---------xx-----------------------xxXXX-XXX------x------------------SS-----xxx--------------xx--xxx---------------x------------SSSSSSSSSSSSS--------------------
--------xx-x-----------E---B-----xxXXXX-XXX-------x-----E---B-------------xxX-x------------xx----x-----------------x--------------------------------------------
-------xx---xxxx-----------b----xxXXXXX-XXX--------x--------b----------B-xx-X--x----------xx-----X------------------x--------------------xxxxxxxxxxxx-----------
xxxxxxxx-----x--xxxxxxxxxxxxxxxxxXXXXXX-XXX---------xxxxxxxxxxxxxxxxxxxxxx--X---xxxxxxxxxxxX-----XX--E---------------xxxxxxxxxxxxxxxxxxxxx---x------------------
XXXXXXXX-----X--XXXXXXXXXXXXXXXXXXXXXX--XXXXXXXXXXXXXXXXXXXXXXXXXXXXXXXXXXXXXXXXXXXXXXXXXXXX-----XXXXXXXX----XXXXXXXXXXXXXXXXXXXXXXXXXXXXX-X-X----XX-X-----XXXXX