----------------------------------------------------------------------------------------------------------------------------------------------------------------
----------------------------------------------------------------------------------------------------------------------------------------------------------------
----------------------------------------------------------------------------------------------------------------------------------------------------------------
----------------------------------------------------------------------------------------------------------------------------------------------------------------
----------------------------------------------------------------------------------------------------------------------------------------------------------------
-----------------------------------------------------------------------------------------------------------------------------------E----------------------------
----------------------------------------------------------------------------------xxxxx-------------------------------------------------------------------------
-----------------------------------------------?QQ-------------------------------xxXX--x--------------------------------------------------------X-----X-----X--E
--------------------------------------------------------------------------------xxXXX---x-------------------------------------------------------X-----X-----X---
----------------------------------------------------------------------------xxxxxXXXX----x---------------------------------xxx----------X-EE--X-X---X-X---X-X---
----------------------------oooooooooooo----------------------------------xxx--xXXXXX-----x-------------------------------xx<-x---------XSSSSSX-XSSSX-XSSSX-XSS?
-----------------------------------------------QQQ------------S----S-----xxXX--XXXXXX---E--x--------------------xxx------xx-[]-x--------------------------------
--------------------------------------------E---------------------------xxXXX--XXXXXX---X---x------------------xxX-x----xx--[]--x---xxx-------------------------
---------------xxxxxx--------------------------------------------------xxXXXX--XXXXXX---X----x----------------xxXX--xxxxx---[]---xxxx--xxxxxxxxxxxxxxxxxxxxxxxxx
xxxxxxxxxxxxxxxx--EE-xxxxxxxxxxxxxxxxxxxxxxxxxxxxxxxxxxxxxxxxxxxxxxxxxxxXXXXX--XXXXXX---X-----xxxxxxxxxxxxxxxxx--X-XXXXXXX--XXXXXXXXX--XXXXXXXXXXXXXXXXXXXXXXXXX
XXXXXXXXXXXXXXXX--XXXXXXXXXXXXXXXXXXXXXXXXXXXXXXXXXXXXXXXXXXXXXXXXXXXXXXXXXXX--XXXXXXXXXXXXXXXXXXXXXXXXXXXXXXXXXXX-XXXXXXX--XXXXXXXXX--XXXXXXXXXXXXXXXXXXXXXXXXX