----------------------------------------------------------------------------------------------------------------------------------------------------------------
----------------------------------------------------------------------------------------------------------------------------------------------------------------
----------------------------------------------------------------------------------------------------------------------------------------------------------------
------------------------------------------------------------------xxx--------------------------------------ooo--------------------------------------------------
----------------------------------------------------------xxxxx--xx--x-------------------------------------o-o--------------------------------------------------
---------------------------------------------------------xx----xxx----x-----------------------------------xxxxx-------------------------------------------------
--------------------------------------------------------xxX-----x------x--------------------------xx-----xxXXX-x------------------------------------------------
------------------------------xxx----------------------xxXX----XX-------x------------------------xx-xoo-xx------x-----------------------------------------------
-----------------------------xx--x--------------------xxXXXXX----------oox----------------------xx---x-xx--------x----------------------------------------------
----------------------------xx----x------------------xxXXXX---------------x-------------------xxx-----xx----------xxxxx-------------------E-----xxx------------x
----------------------oo---xx------x----------------xxXXXXX----------------xxx---------------xxXX-----XX-----------xXX-x-QQQQQQQQQ------------xxx--xx---------xx
-------------------------xxx--------x--------------xxXXXXXX----------------<>-x-------------xx-X-------------------XXX--x-------------oo-----xxXX--X-x-------xx-
----------Q?QQQ---------xx<>---------x------------xxXXXXXXX-E--------------[]--x-----------xx---------------------XXXX---x------E-----oo----xxXXX--XX-xxx---xx--
-----------------------xx-[]----------xxxxxxxxxxxxxXXXXXXXX<>--------------[]---x---------xx---------------------XXXXX----xxxxxxxxxxxxxxxxxxxXXXX--XXXXX-xxxx---
xxxxxxxxxxxxxxxxxxxxxxxx--[]E--------XXXXXXXXXXXXXXXXXXXXXX[]--------------[]----xxxxxxxxxxX---------------------XXXXXXXXXXXEEXXXXXXXXXXXXXXXXXXX--XXXXX-XXXXXXX
XXXXXXXXXXXXXXXXXXXXXXXXXXXXXX-------XXXXXXXXXXXXXXXXXXXXXX[]----------XXXXXXXXXXXXXXXXXXXXX---------------------XXXXXXXXXXXXXXXXXXXXXXXXXXXXXXXX--XXXXX--------