----------------------------------------------------------------------------------------------------------------------------------------------------------------
----------------------------------------------------------------------------------------------------------------------------------------------------------------
----------------------------------------------------------------------------------------------------------------------------------------------------------------
----------------------------------------------------------------------------------------------------------------------------------------------------------------
---------------------------------------------------SSSSSSSSSSSS?SSSSSSSSS?SSSSSSSSSSSSSSSSSSSS?SSSSSSSSSSSSSSSSSSSSSSSSSSSSSSSSSSSSSSSSSSSSSSSSSSSSSSSS?SSSSSSSS
----------------------------------------------------------------------------------------------------------------------------------------------------------------
----------------------------------------------------------------------------------------------------------------------------------------------------------------
---------------------------------------------SSSSSSS--------oooo------oooo----------------ooooo-----------------------------------------------------oooo--------
--------------------------oooo----------------------------------------------------------------------------------------------------------------------------------
------------------------------------------------------------SSSS------SSSS----------------SSSSS-----------------------------------------------------SSSS--------
----------------------xxxx----------------------------------SSSS------SSSS----------------SSSSS-----------------------------------------------------SSSS--------
---------------------xx<>-x-----------------S---------------------------------xxxxx------------------QQQQQQQQQQQQQQQQQQQQQQQQQQQQQQQQQQQQQQQQQQ-----------------
---E----------------xx-[]--x-------------E----------------------------------Exx----x---------------------------------------------------------------------------x
-------------------xx--[]---x-----------------xxxxx-xxx-xxxx------xxxx------xx------x-xxxx------------------------------------------------------xxxx--------xxxx
xxxxxxxxxxxxxxxxxxxx---[]----xxxxxxxxxxxxxxxxxx----xx--xx---xxxxxxx---xxxxxxxX-------xx---xxxxxxxxxxxxxxxxxxxxxxxxxxxxxxxxxxxxxxxxxxxxxxxxxxxxxxx---xxxxxxxxx<>-
XXXXXXXXXXXXXXXXXXXXXXXXXXXXXXXXXXXXXXXXXXXXXXX----XX--XX--XXXXXXXX--XXXXXXXXX------XXX--XXXXXXXXXXXXXXXXXXXXXXXXXXXXXXXXXXXXXXXXXXXXXXXXXXXXXXXX--XXXXXXXXXX[]-