----------------------------------------------------------------------------------------------------------------------------------------------------------------
----------------------------------------------------------------------------------------------------------------------------------------------------------------
----------------------------------------------------------------------------------------------------------------------------------------------------------------
----------------------------------------------------------------------------------------------------------------------------------------------------------------
----------------------------------------------------------------------------------------------------------------------------------------------------------------
----------------------------------------------------------------------------------------------------------------------------------------------------------------
-----------------------------------------------------------------------------------------------------------------------------------------------?-Q--------------
--------------------------------------------------------------------------------------?-----------------------------------------------------S--------------o----
---------------------------------------------------------------------------------------------------------------------------------------------------E---E---o----
--------------------------------------------------------------------------------------------------------------------------------xxxx--xxxx-xxxx----xxxxxxxxxx---
-------------------------------------------------------------------------------------------------------------------------------xx---xxx---xx-E-xxxxxXXXXXXXX-x--
---------------xxx---------------------------------QQQQ?QQ?QQQQ?QQ?QQ?QQ?QQ?QQ?QQ?QQ------xxx-------------------SS------------xx----XXX--XXXE-XXXXXXX---------x-
--------------xxX-x----------------------xxxxxx-----------------------------------------xxx--xxx-------------E--------------xxx-----XX---XX--------------------x
-B-----------xx-X--x------------------xxxxE----xxxxx-----------------------------------xx<>--<>-x--------------------------xx<>-------------------------------XX
xxxxxxxxxxxxxx--X---xxxxxxxxxxxxxxxxxxxXX<>----XXEE-xxxxxxxxxxxxxxxxxxxxxxxxxxxxxxxxxxxx-[]--[]--xxxxxxxxxxxxxxxxxxxxxxxxxxx-[]-------------------------------XX
XXXXXXXXXXXXXX--XXXXXXXXXXXXXXXXXXXXXXXXX[]----XXXXXXXXXXXXXXXXXXXXXXXXXXXXXXXXXXXXXXXXXXXXXXXX--XXXXXXXXXXXXXXXXXXXXXXXXXXXXXXXX-------------------------------