----------------------------------------------------------------------------------------------------------------------------------------------------------------
----------------------------------------------------------------------------------------------------------------------------------------------------------------
----------------------------------------------------------------------------------------------------------------------------------------------------------------
----------------------------------------------------------------------------------------------------------------------------------------------------------------
----------------------------------------------------------------------------------------------------------------------------------------------------------------
-------------------------------------------------------------------------------------------------xxx-----xxx----------------------------------------------------
--------------E---E----E--------------------------------------------oo------------------------xxxx-oxoooxx--x-----------------xx--------------------------------
------------SSSSSSSSSSSSS--SSSSSSS------------SSSSSSSSSS-------------------------------------xx-XX---x-xx----x---------------xx-x--------------------------xxx--
-------------------------------------------------------------------o------------------------xx--------xx------x-------------xx---x-------------------------xB-x-
-----------E--------------------------------------xxxx------------------------------xxxxxxxxx---------XX-------x---------xxxx-----x-----------------------xxb---
----------------------------E--E----------------xxxSS-x----------------------xxxxxxxx------<>-------------------x------xxx-<>------xo--------------------xxXXX-x
---------S?S----xxx---SSS--SSSSSSS------------xxxSS----x-----E--xxx---------xx-----<>------[]--------------------xxxxxxx-?-[]----E--x--------QQQQQ------xxXXXX--
------E--------xxX-x-------------------------xx<>-------x----E-xxX-x-------xx------[]------[]---------------------x---<>---[]----X---x-----------------xxXXXXX--
--------------xx-X--x---------xxx-----------xx-[]--------x----xx-X--x-----xx-------[]------[]------------XXXXXEXXEX---[]---[]----X----x---xxxx--------xxXXXXXX--
xxxxxxxxxxxxxxx--X---xxxxxxxxxx--xxxxxxxxxxxx--[]-----EE--xxxxx--X--ExxxxxxX------X[]------[]-------------------------[]---[]----X-----xxxxEE-xxxxxxxxxXXXXXXXXX
XXXXXXXXXXXXXXXXXXXXXXXXXXXXXXX--XXXXXXXXXXXXXXXXXXXXXXXXXXXXXXXXXXXXXXXXXXX------XXXXXXXXXXX-XXX--XXXX---------------XXXXXXXXXXXXXXXXXXXXXXXXXXXXXXXXXXXXXXXXXX