----------------------------------------------------------------------------------------------------------------------------------------------------------------
----------------------------------------------------------------------------------------------------------------------------------------------------------------
----------------------------------------------------------------------------------------------------------------------------------------------------------------
----------------------------------------------------------------------------------------------------------------------------------xxxxxxxxxxxxxxxxxxxxxxxxxxxxxx
SSSSSSSSSSSSSSSSSSSSSSSSSSSSSSSSSSSSSSSSSSSSSSSSSSSSSSSSSSSSSSSSS?SSSSSSSSSSSSSSSSSSSSSSSSSSSSSSSSSSSSSSSSSSSSSSSSSSSS------------xXXXXXXXXXXXXXXXXXXXXXXXXXXXXX
------SS--SSSSS--SSSSSSSSSSS--SSSSSSSSSSSSSSSSSSSSSSS--SSSS---------------------SSSSSSSSSSSSSSSSSSSSSS---------------------------xxXXXXXXXXXXXXXXXXXXXXXXXXXXXXX
------SS--SSSSS--SSSSSSSSSSS--SSSSSSSSSSSSSSSSSSSSSSS--SSSS---------------------SSSSSSSSSSSSSSSSSSSSSS------------------XXXXXXX-xx-XXXXXXXXXXXXXXXXXXXXXXXXXXXXX
-----S-------SS-----------SS-----------------------SS---------oooo--------------SSSSSSSSSSSSSSSSSSSSSS--QQ--QQ---QQ----xxxxxxxx-xS-XXXXXXXXXXXXXXXXXXXXXXXXXXXXX
-----S-------SS-----------SS-----------------------SS-----------------------------------------------------------------xx-------xx--XXXXXXXXXXXXXXXXXXXXXXXXXXXXX
-----S-------SS-----------SS-----------------------SS---------SSSS---------------------xxx-----------xxx-xxx-xxxx-xxxxx---------x--XXXXXXXXXXXXXXXXXXXXXXXXXXXXX
-----S----oooSS---ooooooooSS--oooooooooooooooooooooSS---E-----SSSS--------------xxxxxxxx?-xxxxxxxxxxxx--xx--xx---xx--x----------S--XXXXXXXXXXXXXXXXXXXXXXXXXXXXX
-----SSS--SSSSS---SSSSSSSSSS--SSSSSSSSSSSSSSSSSSSSSSS--SSSS--------------------xx-SSSSSS??SSSSSSSSSSSS--QQ--QQ---QQ--Q-------------XXXXXXXXXXXXXXXXXXXXXXXXXXXXX
------SS----------------------------------------------EE----------------------xx--SSSSS---SSSSSSSSSSSS-----------------------------XXXXXXXXXXXXXXXXXXXXXXXXXXXXX
------SS--------------------------------------------------xxxx------xxxx-xxxxxx---SSSSS---SSSSSSSSSSSS---------------------------E-XXXXXXXXXXXXXXXXXXXXXXXXXXXXX
xxxxxxxxxxxxxxxxxxxxxxxxxxxxxxxxxxxxxxxxxxxxxxxxxxxxxxxxxxx---xxxxxxx---xx---x---------oooSSSSSSSSSSSS-----------------------------XXXXXXXXXXXXXXXXXXXXXXXXXXXXX
XXXXXXXXXXXXXXXXXXXXXXXXXXXXXXXXXXXXXXXXXXXXXXXXXXXXXXXXXXX--XXXXXXXX---XX---X---XXXXXXXXXXXXXXXXXXXXXXXXXXXXXXXXXXXXX----------XXXXXXXXXXXXXXXXXXXXXXXXXXXXXXXX