----------------------------------------------------------------------------------------------------------------------------------------------------------------
----------------------------------------------------------------------------------------------------------------------------------------------------------------
----------------------------------------------------------------------------------------------------------------------------------------------------------------
----------------------------------------------------------------------------------------------------------------------------------------------S--------SSSSSSSSS
-----------------------------------xxxxx-----------------------------------------------------------------------------------------------------------------[]---[]
-----------------------------------x----x------------------------------------------------------------------x---------------------------------------------[]---[]
---------------------------------xxX-----x------------------xxxxxxxx------------------------------------------------------------------------XXXX---------[]---[]
-------------SSSS---------------xxXX------x----------------xxXXXXX--x-----------------------------------------xx------?Q--------------------XXX----------<>---[]
--------------------XX---------xxXXXXX---oox--------------xxXXXXXX---x---------------------------------------xx-x---------------------xxx---------------------[]
------------------------------xxXXXX--------x------------xxXXXXXXX----x-------------------------------------xx---x-----------------xxxx--x----------------E---[]
-----------xxxxxxxx----------xxXXXXX---------xo---------xxXXXXXXXX-----xxxxx-------------------------------xx-----x--QQ-------S---xxXXX---x-------------------[]
----------xxXXXXXX-x--------xxXXXXXX----------x--------xxXXXXXXXXX-----<><>-x-----------------------------xxX------x-------------xx--------x------------------<>
---------xx-X-------x-----ExxXXXXXXX-E---------x------xxXXXXXXXXXX-----[][]--xx--------------------------xx-XX------x-----------xx----------xx----------xxx-----
--------xx--X--------x----xxXXXXXXXX<>----------x----xxXXXXXXXXXXX-----[][]-<>-x-----------xxxxx--------xx--XXX------xxxxxxxxxxxx----------XX-xxxxxxxxxxx--xxxxx
xxxxxxxxx---X---------xxxxxXXXXXXXXX[]-----------xxxxxXXXXXXXXXXXX-----[][]-[]--xxxxxxxxxxxx----xxxxxxxxx---XXXX----XXXXXXXXXXXXE-----XXX--XXXXXXXXXXXXXX--XXXXX
XXXXXXXXXXXXXXXX-----XXXXXXXXXXXXXXX[]---XXXXXXXXXXXXXXXXXXXXXXXXXXXXXXXXXXXXXXXXXXXXXXXXXXX----XXXXXXXXXXXXXXXXX---X----------------------XXXXXXXXXXXXXX--XXXXX