----------------------------------------------------------------------------------------------------------------------------------------------------------------
----------------------------------------------------------------------------------------------------------------------------------------------------------------
----------------------------------------------------------------------------------------------------------------------------------------------------------------
----------------------------------------------------------------------------------------------------------------------------------------------------------------
----------------------------------------------------------------------------------------------------------------------------------------------------------------
-----------------------------------------xxx--------------------------------------------------------------------------------------------------------------------
-------------E-----------------------xxxxx--x-------------------------------------------------------------------------------------------------------------------
-------SQQQQQQQQ?QQQQQQQQQ----------xxXXXX---x-----------------------------xx--------E--------------------QQQQQQX-----------------------------------------------
-----------------------------------xx-XXXX----x---------------------------xx-x----------------------------------X--------------------------------xxx------------
----------------------------------xx--XXXX-----x------xxxx---------------xx---x------xx-------------------------X-------------------------------xx--x-----------
--------------E-E----------------xxXX-XXXX------x-xxxxx---x---------xxxxxx-----xx---xx-xxx------xxxxxx----------X-----------oo-----------------xx----xo--------o
--------?QQQQQQQ-QQQQQQQQQ------xxXXX-XXXX-------xx--<>----xx------xxXSSS?----XX-x-xx--XX-x----xx-----x--E?QQQQQX--------------xxxx-----xxxxxxxx------x-------xx
-------------------------------xxXXXX-XXXX-------<>--[]---<>-x----xx-X------------xx-------x--xx-------x----------------------xx<>-x---xx-----x--------x-----xx-
-xxxx-------------------------xxXXXXX-XXXX-------[]--[]---[]--x--xx--X---S-------XXX--------xxx---------x-------E------------xx-[]--x-xx-----XX---------x---xx--
xxEE-xxxxxxxxxxxxxxxxxxxxxxxxxxXXXXXX-XXXX-------[]--[]---[]--ExxxE-EX---------------------XXXX----------xxxxxxxxxxxxxxxxxxxxx--[]---xxX-----------------xxxx---
XXXXXXXXXXXXXXXXXXXXXXXXXXXXXXXXXXXX--XXXXXXXXXXXXX--XXXXXXXXXXXXXXXXXXXXXX----------------------------XXXXXXXXXXXXXXXXXXXXXXXXXXXXXXXXX-----------XXXXXXXXXX---