----------------------------------------------------------------------------------------------------------------------------------------------------------------
----------------------------------------------------------------------------------------------------------------xxx--------xxx----------------------------------
---------------------------------------------------------------------------------------------------------------xx--x------xx--x---------------------------------
-------------------------------------------------------------x------------------------------------------------xx----x----xx----x--------------------------------
----------------------------------------------------------------------------------------------xxx------------xx------x--xx------x-------------------------------
--------------------------------------------------------------xxxxxxxxxxxxxxxxxxxxxxxxxxxxxxxxx--x---------xxxE-------xxx--------x------------------------------
-------------------------------------SSSSSSS--------SSSSSSSSS-SSSSSSSSSSSSSSSSSSSSSSSSSSSSSSSSS---x-------xx-<>-------XXX---------x-----------------------------
--------------------------------------[]-------------[]-----[--------------------------------------x-----xx--[]------------------oox----------------------------
-----o--------------------------------[]-------------[]-----[---------------------------------------xxxxxx---[]---------------------x---------------------------
--------------------------------------[]-------------[]-----[-----E-----E----E-------E-----E---------x--xE---[]----------------------x-----------------SSSSSSSSS
---oo---oooooooo----------------------[]-------------[]-----[E---<>----<>---<>------<>----<>---------X--<>---[]------------>----------x-------------------------
--------------------------------------<>-------------<>-----[>---[]----[]---[]------[]----[]------------[]---[]------------]-----------x-----------xxxx---------
--------------------------------------xxx------------xxx----<]---[]----[]---[]------[]----[]------------[]---[]------------]------------x---xxx---xx<>-x--------
-------------------------xxxxxxxxxxxxxxE-xxxxxxxxxxxxxE-xxxxx]---[]----[]---[]------[]----[]------------[]---[]----------o-]-------------xxxx--xxxx-[]--xxxxxxxx
xxxxxxxxxxxxxxxxxxxxxxxxxxEEXXXXXXXXXXXXXXXXXXXXXXXXXXXXXXXXXXXXXXXXXXXXXXXXXXXXXXXXXXXXXXXXXXXX--------[]---XX-XXXX-----X-X-----XXXXXXXXXXXX--XXXXXXXXXXXXXXXXX
XXXXXXXXXXXXXXXXXXXXXXXXXXXXXXXXXXXXXXXXXXXXXXXXXXXXXXXXXXXXXXXXXXXXXXXXXXXXXXXXXXXXXXXXXXXXXXXX--------[]---XX-------------------------------------------------