----------------------------------------------------------------------------------------------------------------------------------------------------------------
----------------------------------------------------------------------------------------------------------------------------------------------------------------
----------------------------------------------------------------------------------------------------------------------------------------------------------------
----------------------------------------------------------------------------------------------------------------------------------------------------------------
----------------------------------------------------------------------------------------------------------------------------------------------------------------
-------------------------xxxxx-------------------------------xxx------------------------------------------------------------------------------------------------
----------------------xxxx----x----------------------------xxx--x-----------------------------------------------------------------------------------------------
-------XSSS----------xx?SS-----xxxx-----------------------xxXX---x-----XX--------------------------------------------------------Q-----------SSSSSS-------------
-------X--------xxx--x----------x--x---------------------xx-XX----x-------XXXX-------------------------------------------------------------E----------------E---
-------X-------xx--xxx---------<>---x-------------------xxXXXX-----x-xxxxxx-----------------------------------------------------------------xxxxx---------------
------EX------xx----xE---------[]----x-----------------xx-XXXX------xx-----x--SSSSSSSSSSSSSS----------------------------------------------xxx----xx----------XX-
-------XSSS-xxx-----<>---ES----[]-----x---------------xxXXXXXX-----XXX------x-------------------------------ooooo--------------S?SQS-----xx<>---<>-x------------
-----------xx<>-----[]--<>---E-[]------x-------------xx-XXXXXX---------------x----------------------------------------------------------xx-[]---[]--x-----------
----------xx-[]-----[]--[]--<>-[]-------x-----------xx--XXXXXX----------------x---------------------B-----------xxx------------------B-xx--[]---[]---x----------
xxxxxxxxxxx--[]-----[]--[]--[]-[]--------xxxxxxxxxxxx---XXXXXX-----------------xxxxxxxxxxxxxxxxxxxxxxxxxxxxxxxxxx--xxxxxxxxxxxxxxxxxxxxx---[]---[]----xxxxxx----
XXXXXXXXXXXXXXXXXXXXXXXXXXXXXXXXXXXXXXXXXXXXXXXXXXXXXXXXXXXXXX----------------XXXXXXXXXXXXXXXXXXXXXXXXXXXXXXXXXXX--XXXXXXXXXXXXXXXXXXXXXXXXXX---XX--XXXXXXXX----