----------------------------------------------------------------------------------------------------------------------------------------------------------------
----------------------------------------------------------------------------------------------------------------------------------------------------------------
----------------------------------------------------------------------------------------------------------------------------------------------------------------
----------------------------------------------------------------------------------------------------------------------------------------------------------------
----------------------------------------------------------------------------SSSSSSSSSSSSSSSS?SSSSSSSSSSSSSSSSSSSSSSSSSSSSSSSSSSSSSSSSSSSSSSSSSSSSSSSSSSSSSSSSSSS
----------------------------------------------------------------------------------------------------------SS--SSSSSSS--SSSSSSSSSSSSSSSSSSSSS--SSSS--SSSSSSS--SSS
---------------------------------------------XX-----------------------------------------------------------SS--SSSSSSS--SSSSSSSSSSSSSSSSSSSSS--SSSS--SSSSSSS--SSS
-------------------------------------------------------------------SSSSSSSSSS-----------ooooo-----------SS--------SSS---------------------SS----SS-------SS---S-
-------------------------------------------E------------------------------------------------------------SS---------SS---------------------SS----SS-------SS---S-
---------------------------------------XXXXXX-------------------------------------------SSSSS-----------SS---------SS---------------------SS----SS-------SS---S-
-------------------------------xxx-----xxxxx------------------------E-------------------SSSSS-----------SS----oooooSS--oooooooooooooooooooSS--ooSS--oooooSS---So
---------------------------QQ-xx--xxxxxx----x----------------------SSSS---------------------------------SSSS--SSSSSSS--SSSSSSSSSSSSSSSSSSSSS--SSSS--SSSSSSS---SS
-----------------------------xx---XXXXXX-----x------------------------------------------------------------SS----------------------------------------------------
----------------------------xx----------------x-------------------------xxxx-xxxxxx-xxxx------------------SS----------------------------------------------------
xxxxxxxxxxxxxxxxxxxxxxxxxxxxx------------------xxxxxxxxxxxxxxxxxxxxxxxxxx---xx-----xx---xxxxxxxxxxxxxxxxxxxxxxxxxxxxxxxxxxxxxxxxxxxxxxxxxxxxxxxxxxxxxxxxxxxxxxxx
XXXXXXXXXXXXXXXXXXXXXXXXXXXXX------------------XXXXXXXXXXXXXXXXXXXXXXXXXX---XX-----XX--XXXXXXXXXXXXXXXXXXXXXXXXXXXXXXXXXXXXXXXXXXXXXXXXXXXXXXXXXXXXXXXXXXXXXXXXX