----------------------------------------------------------------------------------------------------------------------------------------------------------------
----------------------------------------------------------------------------------------------------------------------------------------------------------------
----------------------------------------------------------------------------------------------------------------------------------------------------------------
----------------------------------------------------------------------------------------------------------------------------------------------------------------
----------------------------------------------------------------------------------------------------------------------------------------------------------------
----------------------------------------------------------------------------------------------------------------------------------------------------------------
---------xxxxxxxxxx-----------------------------------------------------------------xxxxxxxxxx------------------------------------------------------------oo----
--------xx--QQQ?QQ-x---------------------------------------------------------------xx--QQQ?QQ-x-------QQQX-----------------------------X------------------------
-------xx-----------x--------oooooooooooooooooooooooooooooooooooo-----------------xx-----------x---------X------------------------------------------------------
------xx------E------x---------------------------------------------------------xxxx------E------x--------X------------------------------------xxx-Exxxxx--------
----xxx-----SSSSSS----xo-----------------------------------------------------xxx-<>----SSSSSS----x-------X-------------------xxxxxxxxxx-xxxxxxx--xxx----xxx-----
---xx<>-------------S--x---------------------------------------------------xxx-?-[]------------X--x--E?QQX-----------------xxx----XXXX-xx--XXXX--XXX---XXX-x-xxx
--xx-[]-------X---------x-------------------------------------------------xx<>---[]------X-----X---x--------E-------------xx<>---------XX--------XX---------xx--
-xx--[]-------X----------x---------------------------------------------B-xx-[]---[]------X-----XX---x----E--B------xxxxx-xx-[]-----------------------------XXX--
xx---[]----E--X-----------xxxxxxxxxxxxxxxxxxxxxxxxxxxxxxxxxxxxxxxxxxxxxxxx--[]---[]---E--X-----XX----xxxxxxxxxxxxxxx----xx--[]-E--------------------------------
XXXXXXXXXXXXXXXXXXXXXXXXXXXXXXXXXXXXXXXXXXXXXXXXXXXXXXXXXXXXXXXXXXXXXXXXXXX-XXXXXXXXXXXXXXXXXXXXXXXXXXXXXXXXXXXXXXXX---XXXX-XXXXXX-------XX---------------------