----------------------------------------------------------------------------------------------------------------------------------------------------------------
---------------------------------------------------------------------------------xxxxx--------------------------------------------------------------------------
--------------------------------------------------------------------------------xxx---x-------------------------------------------------------------------------
-------------------------------------------------------------------------------xx------x-----xx-----------------------------------------------------------------
------------------------------------------------------------------?-----------xx--------x---xx-xxx--------------------------------------------------------------
-----------------------------------------------------------------------------xx----------x-xx--XX-x-------------------------------------------------------------
-------------------------------?QQQ?QQQSS---------------------------------xxxx------------xx---XX--x------------------------------------------------------------
-------------------------------------[]----------------------------------xxXXX-------------S---XX---x------------------------------------------------xx---------
-------------------------------------[]-----------------------------SS--xxXXXX-----------------XX----x----------------------------------------------xx-x--------
-------------------------------------[]--------------------------------xxXXXXX-----------------XX-----x--------------------------------------------xx---x----ooo
-------------------------------SSSSS-<>------------xxx----------SS----xxXXXXXX-----------------XX------x--------------------------oo----------xxxxxx-----x---ooo
------------Q-------------------------------------xxX-x--------------xxXXXXXXX-----------------XX----E--x----------S-------------xx----------xxXSSS?------x-----
------E-----------------xxx------E---xE----xxx---xx-X--x-----B------xxXXXXXXXX-----------------XX----X---x----------------------xx-x--------xx-X-----------xxxxx
---------------------xxxxE-xxxxxxxxxxxxxxxxxE-xxxx--X---x----b----xxxXXXXXXXXX---------E-------XX----X----x-----------xxxx-----xx---xxxx---xx--X---S-------XXXXX
xxxxxxxxxxxxxxxxxxxxxxXX<>XXXXXXXXXXX<XXXXX<>XX<>XXXX---Exxxxxxxxxx-XXXXXXXXXX-------X<>XXX----XX----X----ExxxxxxxxxxxxEE-xxxxxx-----x--xxxxE-EX-----------X----
XXXXXXXXXXXXXXXXXXXXXXXX[]XXXXXXXXXXX[XXXXX[]XX[]XXXXXXXXXXXXXXXXXX-XXXXXXXXXX---X---X[]XXXXXXXXXXXXXXXXXXXXXXXXXXXXXXXXXXXXXXXX-----X--XXXXXXXXXXXXX------X----