----------------------------------------------------------------------------------------------------------------------------------------------------------------
----------------------------------------------------------------------------------------------------------------------------------------------------------------
----------------------------------------------------------------------------------------------------------------------------------------------------------------
----------------------------------------------------------------------------------------------------------------------------------------------------------------
----------------------------------------------------------------------------------------------------------------------------------------------------------------
-------------E--------------------------------------------------------------------------------------------------------------------------------------------------
----------------------------------------------------------------------------------------------E-----------------------------------------------------------------
--------------------------------------------------------------------SSSS?SS?SS--------------SSSSSS--------------------------------------------------------------
----------------------------------------------------------------------------------------------------------------------------------------------------------------
----------------------------------------------------------------------------------------------------------------------------------------------------------------
----xxxxx-------------------------------------------------------------------------------------E-----X------------------xxxxxx-----------------------------------
---xx----x-----------------QQQQ?QQ-----------------QQ?QQ?QQQQ-------SSSSSSSSSSS---------------QQ?QQQX-----------------xxXSSS-xx---------------------------------
--xx------x---xxx----------------------------------------------------------------------xxxx--------------------------xx-X----S-x--B---------------------------xx
-xx--------xxxx--x------xxxx----------------------------------------------------------xx<>-x------------------------xx--X-------x-b--------------------------xx-
xx--------XXXXX---xxxxxxxEE-xxxxxxxxxxxxxxxxxxxxxxxxxxxxxxxxxxxxxxxxxxxxxxxxxxxxxxxxxxx-[]--xxxxxxxxxxxxxxxxxxxxxxxxxE-EX--------xxxxxxxxxxxxxxxxxxxxxxxxxxxxxX-
XX--------XXXXX--XXXXXXXXXXXXXXXXXXXXXXXXXXXXXXXXXXXXXXXXXXXXXXXXXXXXXXXXXXXXXXXXXXXXXXXXXXXXXXXXXXXXXXXXXXXXX<>XXXXXXXXXXXXXXXXXXXXXXXXXXXXXXXXXXXXXXXXXXXXXXX-