----------------------------------------------------------------------------------------------------------------------------------------------------------------
----------------------------------------------------------------------------------------------------------------------------------------------------------------
----------------------------------------------------------------------------------------------------------------------------------------------------------------
----------------------------------------------------------------------------------------------------------------------------------------------------------------
----------------------------------------------------------------------------------------------------------------------------------------------------------------
----------------------------------------------------------------------------------------------------------------------------------------------------------------
---------------------------------------------------------------------?-------o-o-----------------o-o----------------------E-------------------------------------
-------------------------------X--EX---------------------------------E------------XXXXXXXXXXXXX--------------------------SQS------------------------------------
-------------------------------X---X------------------------------------E-----------------------------------------------------------xxx-------------------------
-----------------------------X-X---X-----------------------------------<>--------------------------------------------------------xxxx--xx-----------------------
---------------------------SSX-XSS?X---------------Q-------------------[]---------------------------------------xxxxx-----------xxXSS-SQ-x----------------------
-----------------------------------------QQQQQ?------------------------[]----XXX-----------------XXX-----------xxX<>-x---SQS---xxXXX------x-----------------xxx-
---------------------------------------------------------xxxxxx--------[]-------------------------------------xx--[]--x-------xxXXXX-------x---------------xxX-x
---------xxx-------xxxx-xxxxxxxxxxxxxxxxxxxxxxxxxxxxxxxxxxE----xxxxxxxx[]------------------------------------xx---[]---x-----xxXXXXX--------x-------------xx-X--
xxxxxxxxxx--xxxxxxxx---xxXXXXXXXXXXXXXXXXXXXXXXXXXXXXXXXX<>----XXXXXXXXXX--------------------------------xxxxxE-E-[]---ExxxxxxXXXXXX--SSSSS--xxxxxxxxxxxxxx--X--
XXXXXXXXXX--XXXXXXXX--XXXXXXXXXXXXXXXXXXXXXXXXXXXXXXXXXXX[]----XXXXXXXXXX-----------------------------XXXXXXXXXXXXXXXXXXXXXXXXXXXXX-------XX-XXXXXXXXXXXXXX--XXX