----------------------------------------------------------------------------------------------------------------------------------------------------------------
----------------------------------------------------------------------------------------------------------------------------------------------------------------
----------------------------------------------------------------------------------------------------------------------------------------------------------------
----------------------------------------------------------------------------------------------------------------------------------------------------------------
----------------------------------------------------------------------------------------------------------------------------------------------------------------
------------------------------------------------------------------------------------------------------oo----------------------------------------xxx-------------
------------------------------------------------------------------------------------------------------oo-----------------------oooo-----------xxx--x------------
---------------------------------------------------EQ-------------S-----------------xxx----------------------------------------XXXX-----------xXX---x-----------
-----------------------------------------------------------------------------------xx--x-----xxx--xx------------------------------------------xXX----x----------
----------------------------------------------------------------------------------xx----xxxxxx--xxx-x-----------------------------------------xXX-----x---------
------------------------------oooooooooooooooo-----------------------------------xx-----XXXXXX--XXX--x---?---oo----xxx-----------------------xxXX------xxxxx----
------------------xxx-------------------------------Q-----------QQQQQ?QQ?QQQQQ?-xx--------------------x-----xx----xx--xxxxxxxx--------------xxXXX------XXXX-x-QQ
------------------xB-x---------------------------------B-----------------------xxE---------------------x---xx-x--xx---XXXXXXXx?------------xx-XXX------------x--
-----------------xxb--x--------------------------------b----------------------xx-X----------------------x-xx---xxx------------x---xx------xx--XXX-------------x-
xxxxxxxxxxxxxxxxxx-BEE-xxxxxxxxxxxxxxxxxxxxxxxxxxxxxxxxxxxxxxxxxxxxxxxxxxxxxxxx--X-----------XXX--XX-----xx-----x--------------xxxx-xxxxxxxE--XXX--------------x
XXXXXXXXXXXXXXXXXXXXXXXXXXXXXXXXXXXXXXXXXXXXXXXXXXXXXXXXXXXXXXXXXXXXXXXXXXXXXXX--X-----------------------XX-----X-------------XXXXX-XXXXXXXXXXXXXXXXXXX----XXXXX