----------------------------------------------------------------------------------------------------------------------------------------------------------------
----------------------------------------------------------------------------------------------------------------------------------------------------------------
-------------------------------------------------------------------------------------------------------------------------xxx------------------------------------
------------------------------------------------------------------------------------------------------------------------xx--x-----------------------------------
SSSSSSSSSSSSSSSSSSSSSSSSSSSSSSSSSSSSSSSSSS--[]SSSSSSSSSSSSSSSSSSSSSSSSSSSS---------------------------------------------xx----x-----xxx--------------------------
--------------------------------------------[]SSSSSSSSSSSSSSSSSSSSSSSSSSSS--------------------------------------------xx------xxxxxx--x-------------------------
--------------------------------------------[]SSSSSSSSSSSSSSSSSSSSSSSSSSSS----o-o---------------------------------xxxxx-------XXXXXX---x------------------------
------------------QQ--QQ--QQ----------------[]SSSSSSSSSSSSSSSSSSSSSSSSSSSS-----------------------XQQ?QQX---------xxXXXX-----------------x-----------------------
---------------xx---------------------------[]SSSSSSSSSSSSSSSSSSSSSSSSSSSS-----------------------X-----X--------xx-XXXX----------------oox----------------------
--------------xx-x-xxx-xxx-xxx--------------[]SSSSSSSSSSSSSSSSSSSSSSSSSSSS-----------------------X-----X-------xx--XXXX-------------------x---------------------
-------------xx---xx--xx--xx--x--------------]SSSSSSSSSSSSSSSSSSSSSSSSSSSS-----------------------XE-E--X------xxXX-XXXX--------------------x-------SSSSSS-------
-QQQQQQQ---xxx----QQ--QQ--QQ---x------xxxxxx-]SSSSSSSSSSSSSSSSSSSSSSSSSSSS----XXX----------------XQQ-QQX-----xxXXX-XXXXS--------------------xxxxxx--------------
----------xx<>------------------xxx--xxSSSSSSSSSSSSSSSSSSSSSSSSSSSSSSSSSSS----------------------------------xxXXXX-XXXX---------------------XXXXX-x-------------
---------xx-[]------------------<>-xxx-SSSSSSSSSSSSSSSSSSSSSSSSSSSSSSSSSSS-------------<>--------------E---xxXXXXX-XXXX----------------------------x------------
xxxxxxxxxx--[]----------------E-[]--x--SSSSSSSSSSSSSSSSSSSSSSSSSSSSSSSSSSS-------------[]---xxxxxxxxxxxxxxxxXXXXXX-XXXX-----------------------------xxxxxxxxxxxx
XXXXXXXXXXXXXXXXXXXXXXXXXXXXXXXXXXXXX--XXXXXXXXXXXXXXXXXXXXXXXXXXXXXXXXXXX-------------XXXXXXXXXXXXXXXXXXXXXXXXXX--XXXXXX--------------XXXX--------XXXXXXXXXXXXX