----------------------------------------------------------------------------------------------------------------------------------------------------------------
----------------------------------------------------------------------xxx-----------------------xxxxxx----------------------------------------------------------
---------------------------------------------------------------------xx--x------------xxx------xx----xxxxxxxxxxxxxxxxxxxxxxxxxx---------------------------------
--------------------------------------------------------------------xx----x----------xx--x----xx-------SSSSSSSSSSSSSSSSSSSSSSSSS--------------------------------
-------------------------------------------------------------------xx------x--xxx---xx----x--xx--------------------------------SSSSSSSSSSSSSSSSSSSSSSSSSSSSSSSSS
------------------------------------------------------------------xx--------xxx--x-xx------xxx------------------------------------------------------------------
---------------------------------------------------------------xxxx---------XXX---xx-------XXX------------------------------------------------------------------
--------------Q---------------------------------------------xxxx-x----------------XX----------------X-----------------------------------------------------------
-----------------------------------------------------------xx--E-X-------------------------------------------------------------------------------xx-------------
----------------------------------------------------------xx---XXX------------------------------------------------------------------------------xx-x-xxx--------
-----------------------oo------oo------------------------xx----XXX--------------------------------------------<>-----<>------<>----------------xx---xx--x-------
--S-----------Q-------o--o----o-------------------------xx-----XXX--------------------------------------------[]-----[]------[]---------QQ---xxx----<>---x----xx
-------------------------------------------------------xxE-----XXX-------------------------------------oo-----[]-----[]------[]-------------xx<>----[]----x--xx-
----B------------------------------------------------Exx-X-----XXX------------------------o---o--------oo-----[]-----[]------[]------------xx-[]----[]-----xxx--
xxxxxxxxxxxxxxxxxxxxxxxxxxxxxxxxxxxxxxxxxxxxxxxxxxxxxxx--X-----XXX-----XXX----------------X---X--------XX-----[]-----[]------[]-xxxxxxxxxxxx--[]----[]--EE--xX--
XXXXXXXXXXXXXXXXXXXXXXXXXXXXXXXXXXXXXXXXXXXXXXXXXXXXXXX--X--XXXXXX----------------------------------X--XX-----[]-----[]------[XXXXXXXXXXXXXXXXXXXXXXXXXXXXXXXX--