----------------------------------------------------------------------------------------------------------------------------------------------------------------
----------------------------------------------------------------------------------------------------------------------------------------------------------------
----------------------------------------------------------------------------------------------------------------------------------------------------------------
----------------------------------------------------------------------------------------------------------------------------------------------------------------
----------------------------------------------------------------------------------------------------------------------------------------------------------------
-------------------------------------------------------------------------------xxx------------------------------------------------------------------------------
-----------------------------------------------------------------------------xxx--x-----------------------------------------------------------------------------
-------------------------------------------------------------?SS------------xxXS---x----------------------------------------------------------------------------
------------------------------xxx------------------------------------------xx-X-----x---------------------------------------------------------------------------
---------------------------xxxx--xx---------------------------------------xxXXX------x--------------------------------------------------------------------------
-------------oo-----------xxXSS-SQ-x-------------------------------------xx-XXX-------x----------------ooo---------------------xxxxx----------------------------
-------------------------xxXXX------x-----------------------------------xxXXXXX-----E--x-----------------------------S--------xxXSS-x---------------------xxxxxx
------------------------xxXXXX-------x--------------------E---B--E-----xx-XXXXX-----X---x------------------------------------xx-X----x-------------------xxXXXXX
------xxxxxxxxxxx------xxXXXXX--------x----B----xxx-----------b-------xx--XXXXX-----X----x-----------------------------B----xx--X-----xxxxx-------------xxXXXXXX
xxxxxxx----x-----xxxxxxxXXXXXX--SSSSS--xxxxxxxxxx--xxxxxxxxxxxxxxxxxxxx---XXXXX-----X-----xxxxxxxxxxxxxxxxxxxxxxxxxxxxxxxxxxxE-EX------x---xxxxxxxxxxxxxxXXXXXXX
XXXXXXX-XX-X----XXXXXXXXXXXXX-------XX-XXXXXXXXXX--XXXXXXXXXXXXXXXXXXXXXXXXXXXXXXXXXXXXXXXXXXXXXXXXXXXXXXXXXXXXXXXXXXXXXXXXXXXXXXXXX---X---XXXXXXXXXXXXXXXXXXXXX