----------------------------------------------------------------------------------------------------------------------------------------------------------------
----------------------------------------------------------------------------------------------------------------------------------------------------------------
----------------------------------------------------------------------------------------------------------------------------------------------------------------
--------------------------------------------------------------------------------------------------------------------------------------SSSSSSSSSSSSSSSSSSSSS-----
------------------------------------------------------------------------------------------------------------------------------------------------------SSSSS-----
---------------------------------------------------------------------------------------------------------------------?--------------------------------SSSSS-----
--------------------------------------------------?----------------------XXXXX---------------------------------------E--------------------------------SSSSS-----
----Q-----------------------------------SS------------------------------------------------------------------------------E--------------------xx-------SSSSS-----
-----------------------------------------------------------------------------------------------------------------------<>-------------------xx-x-xxx--SSSSS-----
----------------------------------------------------------------------------------------xxxxxx-------------------------[]------------------xx---xx--x-SSSSS---xx
-------------------------------------xxxxxxx--E--S-------------------------------------xxXSSS-x------------------------[]-----?----------xxx----<>---x---SS--xxX
----Q----------------------------QQ-xx-XXXX-x-----------------------------------------xx-X-----x-----------------------[]---------------xx<>----[]----x--SS-xx--
-----------------------------------xx--XX----x-----------------------------xxx-------xx--X------xxxxxxxxxxxxxxxxxxxxxxx[]--------<-----xx-[]----[]-----x-SSxx---
----------------------------------xx----------xxxxxxxxxxxxxxxxxxxxxxxxxxxxxx--xxxxxxxxE-EX------XXXXXXXXXXXXXXXXXXXXXXXXX--------[>-xxxx--[]----[]--E---xxxx----
xxxxxxxxxxxxxxxxxxxxxxxxxxxxxxxxxxx-----------XXXXXXXXXXXXXXXXXXXXXXXXXXXXXX--XXX<>XXXXXXXXXXX--XXXXXXXXXXXXXXXXXXXXXXXXX--------X]XXXXXXXXXXXXXXXXXXXXXXXXXXXX-
XXXXXXXXXXXXXXXXXXXXXXXXXXXX<>XXXXX------XX---X-----------------------------------------------------------------------------------------------------------------