----------------------------------------------------------------------------------------------------------------------------------------------------------------
----------------------------------------------------------------------------------------------------------------------------------------------------------------
----------------------------------------------------------------------------------------------------------------------------------------------------------------
----------------------------------------------------------------------------------------------------------------------------------------------------------------
-----------------------------------------------------------------E---E------------------------------------------------------------------------------------------
---------------------------------------------<>-----------------------------------------------------------------------------------------------------------------
---------------------------------------------[]-----------XXXXXXEXXXEXXX----------oo----------------------------------------------------------------------------
-----------SSS?SS----------------------------XX----------------------------------------XXX--------------SSS?SS?SS?SS?SSS--SSSSS?SS------------------------------
----------------------------------------------------------------------------------------------------------------------------------------------------------------
----------------------------------------------------------------------------------------------------------------------------------------------------------------
--------------------------<SSS----------------------------XXXEXEEXXEEXXXXX-------------------------------------------------E-----------------------------------X
-----------SSSSSSSSSSSS-------------------------------------------------------XXX--XX-------E-----------SSSSSSSSSSSSSSSS--SSSSSSSS----------------------------XX
--------------------------------------------------------------------------------------------------XXXX----------------------------------------------------E--XXX
-----------------------------------B-------------X---X------------------------------------------------------------------------------------------------------XXXX
-------------------------------------------------XXXXX-------------------XXX----------------XXXXX----------------------------------------------------------XXXXX
XXXXXXXXXXXXXXXX-XXXXXXXXXXXXXXXXXXXXXXXXXX------XXXXX--------------------------------------------------XXXXXXXXXXXXXX-XXXXXXXXXXXXXXXXXXXXXXXXXXXXXXXXXXXXXXXXX