----------------------------------------------------------------------------------------------------------------------------------------------------------------
----------------------------------------------------------------------------------------------------------------------------------------------------------------
----------------------------------------------------------------------------------------------------------------------------------------------------------------
----------------------------------------------------------------------------------------------------------------------------------------------------------------
--------------------------------------------------o-------------------------------------------------------------------------------------------------------------
---------------------------------XXXXXXXXXXXXXXXXXXX------------------------------------------------------------------------------------------------------------
--------------------------------XX------------------------------------------------------------------------------------------------------------------------------
-------------------------------XXX--------------------------------------------XXX---------------XXX---------------------------------------E-----E--XXX----------
------------------------------XXXX--------------------------------------------XXX------------------------------------------------------E------------------------
-----------------------------XXXXX--------------------------------------------XXX-------------------------------------------------------------------------------
----------------------------XXXXXX-----------------------------------------X--XXX----------------------------------QQQQQQQQQQ-------XSSSSSSSSSSS----------------
---------------------------XXXXXXX----------------------------------------EX--XXX--QQ-------------XXXX-----------------------------XX------------------------XXX
--------------------------XXXXXXXX---------------------------------------XXX--XXX----------E--------------------------------------XXX----ooooo---------------XX-
-----------X-------------XXXXXXXXX---------------------B----------------XXXX-----------------------------------------------------XXXX---------------------------
XXXXXXXXXXXX------------XXXXXXXXXX-------------------------------------XXXXX-----------------------------XXXXXXXXXXXXXXXXXXXXXXXXXXXX----ooooo------------------
XXXXXXXXXXXX--XXXXXXXXXXXXXXXXXXXXXXXXXXXXXXXXXXXXXXXXXXXXXXXXXXXXXXXXXXXXXXXXXXXXXXXXXXXXXXXXXXXXX------XXXXXXXXXXXXXXXXXXXXXXXXXXXXXXXXXXXXXXX-----XXXX-------