----------------------------------------------------------------------------------------------------------------------------------------------------------------
----------------------------------------------------------------------------------------------------------------------------------------------------------------
----------------------------------------------------------------------------------------------------------------------------------------------------------------
----------------------------------------------------------------------------------------------------------------------------------------------------------------
----------------------------------------------------------------------------------------------------------------------------------------------------------------
----------------------------------------------------------------------------------------------------------------------------------------------------------------
--------------------------------------------------------------------------oo-o-----------------------------------------------------------------------------o-oo-
-------------------------------XX---------------------------------------------XXoo----------------------------------------------------------------------XX------
---------------oo-------------XXX-----------------------------------------------------------------------------E-------------------------------------------------
-E---------------------------XXXX----------------------------------------------------------------------------<>----oooo-----------------------------------------
--XXXX----------------------XXXXX-------------------------E-----XXX------------------------------X-----------[]----oooo---QQQQQ---------------------------------
---------------------------XXXXXXS--------------------QQQQQQ---------------XXX----XX------------XX-----------[]--------------------X----------------------------
-------------X------------XXXXXXX--------------------------------------------------------------XXX-----------[]--------------E----XX----------------------------
-------------X------<>---XXXXXXXX-------------------------------------------------------------XXXX-----------[]------------------XXXX---------------------------
-------------X------[]--XXXXXXXXX-------------------------------------------------------XXXXXXXXXX-----------XXXXXXXXXXXXXXXXXXXXXXXX---------------------------
X-----XXXXXXXXXXXXXXXXXXXXXXXXXXXXXXXXXXXXXXXXXXXXXXXXX-<><>---------X------------------XXXXXXXXXXXXXXXXX----XXXXXXXXXXXXXXXXXXXXXXXXXXXXXXXXXXXXXXXXXXXX--XXXXX