----------------------------------------------------------------------------------------------------------------------------------------------------------------
----------------------------------------------------------------------------------------------------------------------------------------------------------------
----------------------------------------------------------------------------------------------------------------------------------------------------------------
-----------------------------------------------------------------------------------------------------------------------------------------------------S----------
----------------------------------------------------------------------------------------------------------------------------------------------------------------
----------------------------------------------------------------------------------------------------------------------------------------------------------------
------------------------XXXXXXXXXX---------------------------------XXXX----------------------------------SSSSSSSSSSSS------------------------------XXXX-XX------
-------------------------------------------------------------XX------------------------------------------------------------------------------------XXX--[]------
--------------------------------------------------------------------------------------------------------------------------------------------------------[]------
------------ooooooo-------------------oooo-----------------------------------oooooooooo-----------------------------------------------------------------[]------
---------------------------------------ooo------oooo-----------XXXXXXXX--------------------------------S--------------------------XX--------------------<>SSSSS-
------------------------------------------------oooo----XXX---------------------------------------------------E------------------XXX----------XX----------------
-------------------------------------------------------------------------------------------------------------<>-----------------XXXX---------------------E------
------------------------------------XXXXXXX--XXXXXEXXX-------------------------------------------------------[]----------------XXXXX----X---------XX-------E----
-----------<>------XX---------------X--------XX----------------------------------------XX--------------------XXXXXXXXXXXXXXXXXXXXXXXXXXXX---------XXXXXXXX<>XXXX
XXXXXXXXX--[]-------X---------------X--------XX-----------------------------------------XXXXXXXXXXXX---------XXXXXXXXXXXXXXXXXXXXXXXXXXXX---------XXXXXXXX[]XXXX