----------------------------------------------------------------------------------------------------------------------------------------------------------------
----------------------------------------------------------------------------------------------------------------------------------------------------------------
----------------------------------------------------------------------------------------------------------------------------------------------------------------
-----------------------------------------------SSSSSSSSSSSX-----------------------------------------------------------------------------------------------------
----------------------------------------------------------------------------------------------------------------------------------------------------------------
----------------------------------------------------------------------------------------------------------------------------------------------------------------
----------------------------------------------------------------------------------------------------------------------------------------------------------------
------Q-------------------------------------X-----------------------E--------------------------XX----------?---------------XXX------------Q---------------------
----------------------------------------------------------------------------------------------XXX-------------------------XXXX-----------------oo---------------
--------------------------------------------------------------------------oo-----------------XXXX------------------------XXXXX----------------------------------
----------------------------------oooo-----------------<>-----------------oo----------------XXXXX-----------------------XXXXXX----------------------------------
------?--------X------------XX----oooo-----------------[]----------------------------------XXXXXX----------S-----------XXXXXXX------<>----?---------------------
--<>-----------X-----------XXXX----------------ooooo---[]---------------------------------XXXXXXX------<>-------------XXXXXXXX------[]-------X-----------------X
--[]-----------X----------XXXXXXXXXXEXXXX------ooooo---[]--------------------------------XXXXXXXX------[]---X--------XXXXXXXXX------[]-------X----------------XX
--[]-----------X---------XXXXXXXX-------X------XXXXX---[]XXXXXXXXXXXXXXXXXXXXXXXXXXEEXXXXXXXXXXXX------[]E--X--XXXX-XXXXXXXXXX------[]-------X---------------XXX
XXXXXXXXXXXXXXXXXXXXXXXXXXXXXXXXX-------X---X--XXXXX---[]XXXXXXXXXXXXXXXXXXXXXXXXXXXXXXXXXXXXXXXXXXXXXXXXXXXX--XXXXXXXXXXXXXXXXXXXXXXXXXXXXXXXXXXXXXXXXXXXXXXXXX