----------------------------------------------------------------------------------------------------------------------------------------------------------------
----------------------------------------------------------------------------------------------------------------------------------------------------------------
----------------------------------------------------------------------------------------------------------------------------------------------------------------
---------------------------------------------------------------------------?------------------------------------------------------------------------------------
----------------------------------------------------------------------------------------------------------------------------------------------------------------
----------------------------------------------------------------------------------------------------------------------------------------------------------------
--E-E---------------------------------------------------------------------XXXXXX--------------------------------------------------------------------------------
SSSSSSSSS---?----------------------------------?-----------------------------------------------------------------------------------------S----------------------
----------------------------------------------------------------------------------------------------------------------------------------------------------------
-------------------------------------------------------------------------------------------------------------XX-------------------------------------------------
-----------------------?-----XX-------XXX----------------------S---------------------XXXXX-------------------XX------------------------------------------?-----S
-------------------<>--------X-------E-------------oo------<>-----------------------E--------------------S---XX-----------E------------S-S-----------<>---------
-E--------E--------[]---------------<>-------E-------------[]----------------------<>------------------E-----XX----------<>----------E---------------[]---------
-------------------[]---------------[]---------------------[]----------------------[]------------------------XX----B---------B-----------------------[]--E--<>--
-------------------[]---------------[]-----------------EE--[]-----XXXXEEX----------[]------------------------XX--------------------------------------[]-----[]--
XXXXXXXXXXXXXXXXXXXXXXXXX-----------[]--XXXXXXXXXXXXX--XXXXXXXXX-------------------[]-----------XXXXXXXXXXXXXXXXXXXXXXXXXXXXXXXXXXXXXXXXXXXXXXXXXXXXXXXXXXXXXXXX