----------------------------------------------------------------------------------------------------------------------------------------------------------------
----------------------------------------------------------------------------------------------------------------------------------------------------------------
----------------------------------------------------------------------------------------------------------------------------------------------------------------
----------------------------------------------------------------------------------------------------------------------------------------------------------------
----------------------------------------------------------------------------------------------------------------------------------------------------------------
-----------------------------------<----------------------------------------------------------------------------------------------------------------------------
-----------------------------------[----------------------------------------------------------------------------------------------------------------------Eoo---
--------------------------------SSSXSSSS--------------------------------Q-Q-Q-----------------------------------------------------------------------------XXXX--
----------------------------------------------------------------------------------------------------------------------------------------------------------------
-------------------------------------------------------------------------------------------XSS--o----------------------------------------S----------------------
-----ooooo--------------------------------------------------------------------------------XXX---------------------------------------------SSS-------------------
-------------------------------S----------------------------------------Q-Q-Q------------XXXX-SS--------------------------------------<>----------------XXXXXXXX
B---------------------------E-----------------------------------------------------------XXXXX-----------------------------------------[]--------X---------------
b---------------------------------------------------<>-------------------------------<>-XXXXX--SSS------B------------------<>---------[]--------X-----X---------
----------------------------------------------------[]-------------------------------[]XXXXXX------------------------------[]---------[]-X------X--XXXX---------
XXXXXXXXXXXXXXXXXXXXXXXXXXXXXXXXXXXXXXXXXXXXXXXXXXXXXXXXXXXXXXXXXXXXXXXXXXXXXXXXXXXXXXXXXXXX------XXXXXXXXXXXXXXXXXX-XXXXXXXXXXXXXXXXXXXXXXXXXXXX--XXXX---------