----------------------------------------------------------------------------------------------------------------------------------------------------------------
----------------------------------------------------------------------------------------------------------------------------------------------------------------
----------------------------------------------------------------------------------------------------------------------------------------------------------------
----------------------------------------------------------------------------------------------------------------------------------------------------------------
----------------------------------------------------------------------------------------------------------------------------------------------------------------
----------------------------------------------------------------------------------------------------------------------------------------E-----------------------
------------------------------------------------------------------------------------------------------SSS------------------------------<>-----------------------
--------Q--------------------------------------------------------------------------------------------------------------------oooo------[]----------<>-----------
----------------oo---------------------------------------------------------------------------------------------------------------------[]----------[]-----------
---------------------------------------------------------------------------------------------------------XX----------------------------[]----------[]-----------
-------------------------oooo----------------------------------------?---oo-----ooo---------------------XXX-----?----------------------[]---------S[]-----------
--------?----<>-------------------------S?S----E-----------------<>-----o----------------XXXXXX--------XXXX----------------------------[]-----B----[]-----------
----<>-------[]-----<>-------------------------E-----------------[]-----------------------------------XXXXX-----------------XX--XX-----[]-----b----[]-----------
----[]-------[]-----[]-------------------------------<>----------[]----------------------------------XXXXXX----------------------------[]-----B----[]-----------
----[]-------[]-----[]-------------------------------[]-------E--[]----------------------------------XXXXXX----------------------------XXXXXXXXXXXXXXXXXXXXXXXXX
XXXXXXXXXXXXXXXXXXXXXXXXXXX-XXXXXXXXXXXXXXXXXXXXXXXXXXXXXXXXXXXXXXXXXXXXXXXXXXXXXXXXXXXXX------------XXXXX--XXXXXXXXXXXXX--------------XXXXXXXXXXXXXXXXXXXXXXXXX