----------------------------------------------------------------------------------------------------------------------------------------------------------------
----------------------------------------------------------------------------------------------------------------------------------------------------------------
----------------------------------------------------------------------------------------------------------------------------------------------------------------
----------------------------------------------------------------------------------------------------------------------------------------------------------------
----------------------------------------------------------------------------------------------------------------------------------------------------------------
--------------------------------------------------------------------------------------------------------------------------oooooooooooooooooooooooooooooooooooooo
----------------E-----E--E------------------------------------------------------------------------------------------------XXXXXXXXXXXXXXXXXXXXXXXXXXXXXXXXXXXXXX
--------------SSSSSSSSSSSSSS-------------SSSSSS------------------------SSS?SSS----------------------------------------------------------------------------------
------------------------------------------------------------oo--------------------------------------------------------------------------------------------------
-------------E--------------------------------------------------------------------------------------------------------------------------------------------------
-----------------------------------------------------------------------------------------------E----------------------------------------------------------------
-----------S?S--QQ?Q---------<>--------XX----------------<>------------SSSSSSS------------------------------XX------E-------------------------------------------
--------E--------------------[]--------XX----------------[]-----------------------------------------------------------------------------------------------------
-----------------------------[]-<>-----XXX---------------[]-----------------------------------------------------------------------------------------------------
-----------------------------[]-[]-----XXX------------E--[]------------------------------------XXX------------------XXXXXXXXXXXXXXXXXXXXXXXXXXXXXXXXXXXXXXXXXXXX
XXXXXXXXXXXXXXXXXXXXXXXXXXXXXXXXXXXX---XXXXX----XXXXXXXXXXXXXXXXXXXXXXXXXXXX-XXXXXXXXXXXXX-----X----------------------------------------------------------------