----------------------------------------------------------------------------------------------------------------------------------------------------------------
----------------------------------------------------------------------------------------------------------------------------------------------------------------
----------------------------------------------------------------------------------------------------------------------------------------------------------------
----------------------------------------------------------------------------------------------------------------------------------------------------------------
----------------------------------------------------------------------------------------------------------------------------------------------------------------
----------------------------------------------------------------------------------------------------------------------------------------------------------------
---------------------------XX------------------------------------E-E---------------------------------------------------SSSSSS------XX------XXXXXXX--------------
---------------------------------XX--XX------------------------SSSSSSSQQS---------XQQ?QQX-----------------------------------------------------------------------
---------------------------------XX-----------------------------------------------X-----X----------------------------------------oooooooo-----------------------
---------------------------------XX-----------------------------------------------X-----X----------------------------------------oooooooo-----------------------
--------------------o------------XX-----------------------<>----------------------XE-E--X------------------------------SSSSSS-----------E-----------------------
---------------------------------XX------XXX--------------[]----------SS----------XQQ-QQX----------------------------------------------<>-----------------------
---------------------------------XX------XX---------------[]----E----------------------------------------------------------------E-----[]-----------------------
---------------------------------XX-----------------------[]----------------------------E---------------------------------------<>-----[]-----------------------
---------------------------------XX-----------------------[]--------------------------------------XXXXXXXXXXXXX-XXXXXXXXXXXXX---[]-----[]----------------------E
XXXXXXXXXXXXXXXXXXX--------------XX-------------XXXXXXXXXXXX-XXXXXXXXXXXXXXXXXXXXXXXXXXXXXXXX-XX--XXXXXXXXXXXXXXXXXXXXXXXXXXX---[]-----[]-------------XXXX<>XXXX