----------------------------------------------------------------------------------------------------------------------------------------------------------------
----------------------------------------------------------------------------------------------------------------------------------------------------------------
----------------------------------------------------------------------------------------------------------------------------------------------------------------
----------------------------------------------------------------------------------------------------------------------------?-----------------------------------
------------------------?---------------------------------------------------------------------------------------------------------------------------------------
--------------------------------------?--------------------o-o--------------------------------------------------------------------------------------------------
---------------------------------------------------XXXXXX--o-o-------------------------------------------------------------S------------------------------------
----------------------XXX---------------------------------------XXXXX--------------------------------------XX-----oo--------------------------------------------
-------------------------------ooo------Eo------------------------------------------------------------------------------------------oo--------------------------
------------------------------------XXXXXXX--------------------------------------------ooooo--------------------------------------------------------------------
------------------XXXXXXXXX---------------------------------XX---------XX-----oooooo---ooooo-----------------XX----XX---XXXXXX--X-------------------------------
-----------------E--------------XXXX------------------------------------------oooooo---E------------------------------------------------------------------------
----------------<>----------------------------------------------------------------------------------------------------------------------------<>----------------
------<>--------[]-----------------XXXXXXXXXXEX----------------------------XXXXXXXEXXXXXXXXXXXX-----------------------------------------------[]-------------B--
------[]--------[]--------XXXXXX-------------------------------------------XX-----------------X-----------------------------------------------[]----------------
XXXXXXXXXXXXXX--[]---------------------------------------------------------XX-----------------X----XXXXXXX--------------------------XXXXXXXXXXXXXXXXXX<>XXXXXXXX