----------------------------------------------------------------------------------------------------------------------------------------------------------------
----------------------------------------------------------------------------------------------------------------------------------------------------------------
----------------------------------------------------------------------------------------------------------------------------------------------------------------
-------------------------------------------------------------------------------S--------------------------------------------------------------------------------
----------------------------------------------------------------------------------------------------------------------------------------------------------------
----------------------------------------------------E------------------------------------------------------E----------------------------------------------------
---------------------------------------------------<>------------------------XXXX--------------------E-------XXXX-----------------------------------------------
-------------------------------XX------------------[]------------------------XXX--------------------------------------------------------------------------------
------------------------------XXX------------XXX---[]--------------------------------------------------XXX------------------------------------------------------
-----------------------------XXXX------------------[]-----------------------------------------------------------------------------------------------------------
----------S--------oo-------XXXXX------------------[]-----------------------------------------------------------------------------------------<>----------------
---------------------------XXXXXX------------------[]---------------oooooo---------------------XXXXX----------------------------------------?-[]----------------
----------------E---------XXXXXXX------XXXXXXX-----[]-------------------------------<>------------------------------------------E--------<>---[]----------------
-------------------------XXXXXXXX------------------[]-----------------------XX------[]-----------------------------XXX-------------------[]---[]----------------
------------X-----------XXXXXXXXX------------------XX-XXXXXXXXXXXXXXXXXXXX--XXXXXXXXXXXXXX---------------------------X--EE---------------[]---[]----------------
XXXXXXX-----XXXXX-----XXXXXXXXXXX------------------XX--------------------X--XXXXXXXXXXXXXXX--------------------------X--XXXXXXXXXXXXXXXXXXXXXXXXXXXXXXXXXXXXXXXX