----------------------------------------------------------------------------------------------------------------------------------------------------------------
----------------------------------------------------------------------------------------------------------------------------------------------------------------
----------------------------------------------------------------------------------------------------------------------------------------------------------------
-------------SSS------------------------------------------------------------------------------------------------------------------------------------------------
--------------[]SSSSSSSSSSS-------------------------------------------------------------------------------------------------------------------------------------
--------------[]SSSSSSSSSSS-------------------------------------------------------------------------------------------------------------------------------------
--------------[]SSSSSSSSSSS-------------------------------------------------------------------------------------------------------------------------------------
----------X---[]SSSSSSSSSSS-------------------------------------------------------------------------XQQ?QQX------------XX---------XSSSSS----------------------XX
--------------<>SSSSSSSSSSS-------------------------------------------------------------------------X-----X------------XX---------X---------------------------XX
---------------SSSSSSSSSSSS-------------------------------------------------------------------------X-----X----------XXXX---------X---------------------------XX
-----XX--------SSSSSSSSSSSS----------oo---------------------------------------XX--------------------XE-E--X----------XXXX--------EX--E-X----------------------XX
-----XXX-----S-SSSSSSSSSSSS---------o--------<>-----------------------------------XXX---------------XQQ-QQX--------XXXXXX---------XSS?SX--------------QQQQ----XX
-------------S-SSSSSSSSSSSS------------------[]-----------------------------E-----XX-------------------------------XXXXXX-------------------------------------XX
-------------S-SSSSSSSSSSSS--------------<>--[]-<>-----B-------------X-----------------XX-----------------E--------XXXXXX-----------------------------E-------XX
-X-----------S-SSSSSSSSSSSS--------------[]--[]-[]-------------------X-----------------XX--------------------------XXXXXX--------------------------------X----XX
XX--------X--S-XXXXXXXXXXXX-----XXXXXXXXXXXXXXXXXXXXXXXXXXXXXXXXXXXXXXXX-X-------------XXXXXXXX-XXXXXXXXXXXXXXXXXXXXXXXXXXXXXXXXXXXXXXXXXXXXXXXXXXXXXXXXXX----XX