----------------------------------------------------------------------------------------------------------------------------------------------------------------
----------------------------------------------------------------------------------------------------------------------------------------------------------------
----------------------------------------------------------------------------------------------------------------------------------------------------------------
----------------------------------------------------------------------------------------------------------------------------------------------------------------
----------------------------------------------------------------------------------------------------------------------------------------------------------------
----------------------------------------------------------------------------------------------------------------------------------------------------------------
----------------------------------------------------------------------------------------------------------------E-----------------------------------------------
--------------------------E------------E-----XXXXX---------------------------------------------------SSSS-----SSSS-----X--------------------------------E---XX--
-----------------------E------------------------------------------------------SSS-------------------------------------XX-----------------------------------XXX--
----------------------------------------------------------------------------XXX--------------------------------------XXX----------------------------------XXXX--
---------------------SSSSSSSSSSSSSSSSSS-------------------------------------XXS-------o------ooo------E-------------XXXX--------------o------------------XXXXX--
-------------------------------------------------------QQQQQQ---------------XXX---------------------SSSSS-----SSS--XXXXX---------QQ--------------------<>XXXXX--
-E-----------------------oooooooooooo--------------------------------------XXXX-SSS-------------------------------XXXXXX-------------------------------[]XXXXX--
-------------<>----------------------------------------E-------------------XXXX----------------------------------XXXXXXX------------------------------X[]XXXXX--
-------------[]----------oooooooooooo--------------------------------------XXXX---------------------------------XXXXXXXX-----------------------------XX[]XXXXX--
XXXXXXXXXXXXXXXXXXXXXXXXXXXXXXXXXXXXXXX------------XXXXXXXX-XXXXXXXXXXXXXXXXXXXXX---X---XXXXXXXXXXXXXX--XXXXXXXXXXXXXXXXXXXXXXXXXXXXXXXXXXXXXXXXXXXXXXXXXXXXXXXX