----------------------------------------------------------------------------------------------------------------------------------------------------------------
----------------------------------------------------------------------------------------------------------------------------------------------------------------
----------------------------------------------------------------------------------------------------------------------------------------------------------------
----------------------------------------------------------------------------------------------------------------------------------------------------------------
----------------------------------------------------------------------------------------------------------------------------------------------------------------
----------------------------------------------------------------------------------------------------------------------------------------------------------------
--------------------------------------------------------XS---------------------------------------------------------------------------SSS------------------------
----SSSSSS------------XX-------------------------------EX----------------XXXX---SS----------------------------------------------------------------------------S-
----------------------------E-------------------------XXX---------------XXXXX-----------------------------------------------------------------------------------
---------------------------<>------------------------XXXXS-------------XXXXXX---------------------------------------------E----------X--------------------------
---------------------------[]-----------------------XXXXX-------------XXXXXXX-------------------------SS-----------------<>----------XEE------------------------
------S--------------------XX--------S-------------XXXXXX------------XXXXXXXX---SS-----------------------------------<>--[]----------XSSSS-------------------QQQ
--------E-----------------------------------------XXXXXXX-----------XXXXXXXXX-----------<>---------------------------[]--[]-------------------------------------
-------------------------------------------------XXXXXXXX-----XX---XXXXXXXXXX-----------[]---------<>--------<>------[]--[]--------------------------X----------
---------------------------------------------XX-XXXXXXXXXXXXXXXXXXXXXXXXXXXXX-----------[]---------[]--------[]----E-[]--[]--------------------------X----------
XXXXXXXXXXXXXX<>XXXX------XXXXXXXXXXXXXXXXXXXXXXXXXXXXXXXXXXXXXXXXXXXXXXXXXXXXXXXXXXXXXXXXXXXXXXXXXXXXXXXXXXXXXXXXXXXXX--[]--XXXXXXXXXXXXXXXXXXXXXXXXXXXXXXXXXXX