----------------------------------------------------------------------------------------------------------------------------------------------------------------
----------------------------------------------------------------------------------------------------------------------------------------------------------------
----------------------------------------------------------------------------------------------------------------------------------------------------------------
----------------------------------------------------------------------------------------------------------------------------------------------------------------
----------------------------------------------------------------------------------------------------------------------------------------------------------------
----------------------------------------------------------------------------------------------------------------------------------------------------------------
SSS---------------------------------------------------------------E---------------------------------------E-E---------------------------XX----------------------
------------?SSS-------------------SQ----------------------------------------XX-------SSS---------------SSSSSSSSSSSS-------------------XXX----------------------
--------------------------------------------------------------------XXXX-----------------------ooo-------------------------------------XXX----------------------
X----o-----------<>------------------------------------------------------------------------------------------------------------------XXXXX----------------------
XEE-------E------[]------------------------------<>-----------------------X----------------------------------------------------------XXXXX----------------------
XSSSS----<>---E--[]-----------------S------------[]-------B---------------------------SSS---<>------------------S----X-------------XXXXXXX----------------------
---------[]--<>--[]---X----------------B---------[]-------b---------------------------------[]-----------E--------E--X-------------XXXXXXX----------------------
---------[]--[]--[]---X----------------b---------[]-------B---------------------------------[]-----------------------XX------------XXXXXXX----------------------
---------[]--[]--[]---X----------------BEEXXXXEXXXXXXXXXXXXXXXXX----------------------------[]-----------------------XX------------XXXXXXXXXXXXXXXXXXXXXXXXXXXXX
XXXXXXXXXXXXXXXXXXXXXXXXXXXXXXXXXXXXXXXXXXXXXXXXXXXXXXXXXXXXXXXX-----------------XXXXXXXXXXXXXXXXXXXXXXXXXXXXXXXXXXXXXXXXXXXXXXXXXXXXXXXXXXXXXXXXXXXXXXXXXXXXXXX