----------------------------------------------------------------------------------------------------------------------------------------------------------------
----------------------------------------------------------------------------------------------------------------------------------------------------------------
----------------------------------------------------------------------------------------------------------------------------------------------------------------
----------------------------------------------------------------------------------------------------------------------------------------------------------------
----------------------------------------------------------------------------------------------------------------------------------------------------------------
----------------------------------------------------------------------------------------------------------------------------------------------------------------
----------------------------------------------------------------------------------------------------------------------------------------XX--------E----XXXXXXX--
-----------------------------------SSSS?SS?S-----------------------------------------------------------------------------E--------E--X--------------------------
------------------------------------------------------------------------oo--------------------------------------------E-----------------------------------------
--------------------------------------------------------------------------------------------------------------------------------------------------X-------------
-----------------------------------------------------------------------------E---------------------o---------------XSSSSSSSSSSSSSS------------------------------
--------------------------------X--SSSSSSSSSS-------------------------------<>------------------------------------XX------------------------XXX-----------------
--------------------------------X------------------<>-------<>--------X---------------------------------X--------XXX----oooooooo--------------------------------
--------------------------------XX-----------------[]-------[]--------X---------------------------------X----<>-XXXX--------------------------------------------
--------------------------------XX-----------------[]-------[]--------X---------------------------------X----[]XXXXX----oooooooo--------------------------------
XX-------XXXXXXXXXXXXXXXXXXXXXXXXXXXXXXXXXXXXXXXXXXXXXXXXXXXXXXXXXXXXXXXXXXXXXXXXXXXXXX-XXXXXXXXXX---XXXXXXXXXXXXXXXXXXXXXXXXXXXXX------------------------------