----------------------------------------------------------------------------------------------------------------------------------------------------------------
----------------------------------------------------------------------------------------------------------------------------------------------------------------
----------------------------------------------------------------------------------------------------------------------------------------------------------------
----------------------------------------------------------------------------------------------------------------------------------------------------------------
----------------------------------------------------------------------------------------------------------------------------------------------------------------
----------------------------------------------------------------------------------------------------------------------------------------------------------------
--------------------------------------------------------------------------------------------------------------------XX------------------oo----------------------
-----SSSS?SS----------------------------X----------------------------------------------------------------------------------------------------------------SSS----
--------------------------------------------------------------------------------------------------------oo--------------------E---------------------------------
-----------------------------------------------------------o-----------------------------------------------------------------<>----------X----------------------
---------------------o-------------------------------------------------------------------------------------------X-----------[]-------oo----oo-------------X----
-----SSSSSSSS-------------------------------------------SSS----B------------------------------XX------------------------<>---XX--------------------------SSX----
--------------------------------------------------<>-----------b--------------------------------------------------------[]--------------------------------------
--------------------------XXXXXXXXXXXX------------[]-----------B---------------------<>---------------------------------[]--------------------------------------
--------------------------------------------------[]---------------------------------[]---------------------------------XX--------------------------------------
XXXXXXXXXXX-XXXXXXXX--------------------X------XXXXXXXXXXXXXXXXXXXXXXXXXXXXXXXXXXXXXXXXXXXX-------------XXXXXX----------XX--XXXXXXXXXXXXXX-----XXXXXXXXXXXXXXXXX