----------------------------------------------------------------------------------------------------------------------------------------------------------------
----------------------------------------------------------------------------------------------------------------------------------------------------------------
----------------------------------------------------------------------------------------------------------------------------------------------------------------
----------------------------------------------------------------------------------------------------------------------------------------------------------------
----------------------------------------------------------------------------------------------------------------------------------------------------------------
----------------------------E-----------------------------------------------------------------------------------------------------------------------------------
------------------------------XXE-------------------------------------------------------------------------------------------------------------------------------
-----------------------------------------------------------E----------------------SS----------------------------------------------------------------------------
----------------------------------------------------------------------------------------------------------------------------------------------------------------
----------------------------------------------E-----------------------------------------------------------------------------------------------------------------
--------------------Q-------------------------XXX-------------------------------------------------------------------XX------------------------------------------
----------------------------------------------------X----------------------------XXXX------------------------------XXX------------------------------E-----------
----------<>----------------------------------------XX-------------B----------XXXXX-------------------------------XXXX---------------------X-------<>-----------
----------[]---------------------XXXXX--------------XXX--------------------XXXXXX--------------------------------XXXXX---E-----------------X-------[]-----------
----------[]----------------------------------------XXXXXXXXXXXXXXXXXXXXXXXXXXX---------------------------------XXXXXXXX<>XXXXXX-----------X----XXXXXX----------
XXXXXXXXXXXXXXXXXXXXXX------------------------------XXXXXXXXXXXXXXXXXXXXXXXXX------XXXXXXXXXXXXXXXXXXXXXXXXXXXXXXXXXXXXX[]XXXXXXXXXXXXXXXXXXXX--X----------XXXXX