----------------------------------------------------------------------------------------------------------------------------------------------------------------
----------------------------------------------------------------------------------------------------------------------------------------------------------------
----------------------------------------------------------------------------------------------------------------------------------------------------------------
----------------------------------------------------------------------------------------------------------------------------------------------------------------
----------------------------------------------------------------------------------------------------------------------------------------------------------------
----------------------------------------------------------------------------------------------------------------E-----------------------------------------------
-----------------------------ooo---------------------------------------X-------------------------------------------X---XX-----XXXXXXX---------------------------
-----------------------------ooo----------XX--------------------------XX-------------------------------------------------------------------------------QQQQ-----
---------------------------------------------------------------------XXX---------------------------------------------ooooooo------------------------------------
--------------------------------------------------------------------XXXX-------------------oooo----------------------ooooooo------------------------------------
-----------------ooooooo-------------------------------------------XXXXX-------------------oooo----------------------------E--------------o---------------------
SSS?-------------ooooooo--E----XX---------------------------------XXXXXX--------------------------------------------------<>-------------------------QQ?SSQQQ---
-----------------------------------------------------------------XXXXXXX---------------------------------------------E----[]------------------------------------
---S-----------XXXXXXXEXXXXX------XXX---------------------------XXXXXXXX--------------------------------------------<>----[]------------------------------------
---------------X-----------X--------X--------------------------XXXXXXXXXXXXXXXXXXXXXXXXXXXXXXXXXXXXXXXXXXXXXXXXX----[]----[]------------------------------------
XXXXX-XXXXXX---X-----------X--------X-------------X----XXXXXXXXXXXXXXXXXXXXXXXXXXXXXXXXXXXXXXXXXXXXXXXXXXXXXXXXX----[]----[]------------X---XXXXXXXXXXXX--XXXXXX