----------------------------------------------------------------------------------------------------------------------------------------------------------------
----------------------------------------------------------------------------------------------------------------------------------------------------------------
----------------------------------------------------------------------------------------------------------------------------------------------------------------
--------------------------------SSSS----------------------------------------------------------------------------------------------------------------------------
----------------------------------[]----------------------------------------------------------------------------------------------------------------------------
----------------------------------[]----------------------------------------------------------------------------------------------------------------------------
----------------------------------[]-------------------------------------------------------------------------------------------------------------------------E--
------------------XX--------------[]----XX----XSSSSSSSS-----------------------------Q----------------------------------------------------------------------SSSSS
-----------------XXX--------------[]----------X-----------------------------------------------------------------------------------------------------------------
----------------XXXX--------------[]----------X-------------------X---------------------------------------------------------------------------------------E-----
---------------XXXXX--------------[]---------EX------------------XX---------SSS------------X------------------------------------------------------oo------------
--------------XXXXXXS----Q--------<>----------XSSSSSSSSS--------XXX-----------------Q-----XX-------------------X----------------------------------------S?S-----
-------------XXXXXXX-------------------------------------------XXXX-------------<>-------XXX-------------------X------SSS---------------------------------------
------------XXXXXXXX--B----------------------------------B----XXXXX------<>-----[]------XXXX-----------<>------X----X-------------------------------------------
--------XXXXXXXXXXXX---------XXXXXXXX------------------------XXXXXX------[]-----[]-----XXXXX-----------[]-EEXXXXXXXXXX-------E----------------------------------
XXXXXXXXXXXXXXXXXXXXXXXXXXX<>XXXXXXXX-----XXXXXXXXXXXXXXXXXXXXXXXXXXXXXXXXXXXXXXXXXXXXXXXXXXXXXXXXXXXXXXXXXXXXXXXXXXXXX---XXXXXXXXXXXXXXXXXXXXXX-----XXXXXXXXXXX