----------------------------------------------------------------------------------------------------------------------------------------------------------------
----------------------------------------------------------------------------------------------------------------------------------------------------------------
----------------------------------------------------------------------------------------------------------------------------------------------------------------
----------------------------------------------------------------------------------------------------------------------------------------------------------------
-----<>---------------------------------------------------------------------------------------------------------------------------------------------------------
-----[]---------------------------------------------------------------------------------------------------------------------------------------------------------
---XX[]X----------------------------------------------SSS-------------------------------------------------------------------------------------------------------
--------------------X--EX----------------------------------XX----------------------------------E-----------------SSSSS?SS-----SSSSS-------------------------SSSS
--------------------X---X---------------------------------XXX---------------------------------<>---------------------------------------oo-----------------------
-----------X------X-X---X--------------------------------XXXX---------------------------------[]----------------------------------------------------------------
-----------XSSSSSSX-XSS?X-------------------------------XXXXX----------------------o------<>--XXX-----------------E------------------------------------------E--
-------------------------------X-----------------------XXXXXX--------------------------X--[]-----------<>-------SSSSSSSSSSSS--------<>---------------------SSSSS
-------------------------------X----------------------XXXXXXX--------------------------X--[]-----------[]----------------------E----[]-----------<>-------------
-------------E-----------------X----X----------------XXXXXXXX--------------------------X--[]-----<>----[]--<>-----------------<>----[]-----------[]-------------
----------X><>XXXXXXXXXXXXXXXXXXXXXXX----------------XXXXXXXX--------------------------X--[]-----[]-E--[]--[]-----------------[]----[]-----------[]-------------
----------XX[]XXXXXXXXXXXXXXXXXXXXXXX-----XXXX-------XXXXXXXXXXXXXXXXXXXXXXXXXXXXX---XXXXXXXXXXXXXXXXXXXXXXXXXXXXXXXXXXX-XXXXXXXXXXXXXXXXXXXXXXXXXXXXXXXXXXXXXXX