----------------------------------------------------------------------------------------------------------------------------------------------------------------
----------------------------------------------------------------------------------------------------------------------------------------------------------------
----------------------------------------------------------------------------------------------------------------------------------------------------------------
----------------------------------------------------------------------------------------------------------------------------------------------------------------
----------------------------------------------------------------------------------------------------------------------------------?-----------------------------
----------------------------------------------------o-----------------------------------------------------------------------------------------------------------
--------------o-oo-ooo------------------------------o----------XXX-------------------ooo---o-oo---------------------------------------------------------------Eo
-----------XX-------------------------E---------------------------------------oooo---XXX--------------oo------------------------------------------------------XX
---------------------------------------------------------------------ooo------------------------------X-----------------------------SS------------------E-------
--------------------XX-----oooo---XX----------------------------------------------------------------------------------------------------------------------------
---------------------------oooo-----------------------?--------XXXXX-------------------------------------------E----------------SS------XSS-SQ------------------
----------------------------------------XXXXX--E----------------------XXXX-----------------XX-----------XX----<>-----------------------XXX------------------XXXX
-----------------------------------------------------------------------------XX--XX-?-------------------------------------------------XXXX----------------------
--B--------------------XXXXXXXXX--------------------------------------------------------------XXXX---------------------------<>------XXXXX----------------------
--b----------------------------------ooo-------XXX-----------------XXX---------------------------X--------------------E------[]-----XXXXXX--SSSSS---------------
XXXXXXXXXXXX--XXXXXXX----------------XXX--------------XX<>XX------------------------XXXX---------X---------XXXXXXXXXXXXXXXXXXXXXXXX-XXXXX-------XX--X-----------