----------------------------------------------------------------------------------------------------------------------------------------------------------------
----------------------------------------------------------------------------------------------------------------------------------------------------------------
----------------------------------------------------------------------------------------------------------------------------------------------------------------
--------------------------------------------------------------------------------------XXXX-----------------------------------SS---------------------------------
---------------------------------------------------------------------------------------[]------------------------------------[]---------------------------------
---------------------------------------------------------------------------------------[]------------------------------------[]---------------------------------
------------------------------------------XS--XS--------XX-----------------------------<>--------<>------SSSS----------------<>-------?QQQQ---------------------
-----------------------------------------EX--EX--------XXX--------------------------------------X[]-------------------------------------[]----------------------
----------------------------------------XXX-XXX-------XXXX------------------------------E------XX[]---------------------------E---------[]----------------------
---------------------------------------XXXXXXXXS-----XXXXX-------------------------------------XX[]------------------o------------------[]--------ooo-----------
--------------------------<>----------XXXXXXXXX-----XXXXXX-----------------------------------<>XX[]------SSSS--------oo-----<>--------S-<>--------ooo--<>------X
------------------------?-[]---------XXXXXXXXXX----XXXXXXX----------------------X-----------X[]XX[]-------------------------[]-------------------------[]-----XX
---------X----------<>----[]-----E--XXXXXXXXXXX---XXXXXXXX----------------------X--------<>XX[]XX[]-------------------------[]-------------------------[]----XXX
---------X----------[]----[]-------XXXXXXXXXXXX--XXXXXXXXX-----------X----------X--------[]XX[]XX[]-------------------------[]-----------E-------------[]---XXXX
---------X----------[]----[]------XXXXXXXXXXXXXXXXXXXXXXXXXXXXXXXXXXXX--XXXXXXXXXXXXX----[]XXXXXXXXXXXXXXXXXXXXXXXXXXXXXXXXXXXXXXXXXXXXX<>-XXXXXXXXXXXXXXXXXXXXX
XXXXXXXXXXXXXXXXXX--[]XXXXXXXXXXXXXXXXXXXXXXXXXXXXXXXXXXXXXXXXXXXXXXXX--XXXXXXXXXXXXX----[]XXXXXXXXXXXXXXXXXXXXXXXXXXXXXXXXXXXXXXXXXXXXX[]-XXXXXXXXXXXXXXXXXXXXX