----------------------------------------------------------------------------------------------------------------------------------------------------------------
----------------------------------------------------------------------------------------------------------------------------------------------------------------
----------------------------------------------------------------------------------------------------------------------------------------------------------------
----------------------------------------------------------------------------------------------------------------------------------------------------------------
-----------------------------------------------------------------------------oo-----------------------------------------------------------oo--------------------
----------------------------------------------------------------------------------------------------------------------------------------------------------------
-----------------------------------------------------------------ooo------------XXXXXE----------------XX--------oo-o-o-------------------XXXX-------------------
------------S----------------------?-----------------------------ooo-----------------------------o--------------------------------------------------------------
----------------------XXX---------------------------------------------------------------------------------------------------------------------------------------
------------------------------------------------------------------------------------------------------------------------------------------------------E---------
-------------S------------XXX---------------------------S------------------XXXXX-----------------XXXX----XXX--------------XXXXXXX-----------------XXXXXXXXX-----
--------<>-------------------------S----------------------------XX--XXXX-----------------------------------------XXXXXXX-----------------E----------------------
---<>---[]------XXXXXXX--------<>-----------------------------------X-------------------------------------------------------------------<>----------------------
---[]---[]---------------------[]---X-------------------------------X----o------------XXXXXXXXXXX---------------------------------------[]-------------------XXX
---[]---[]-E-------------------[]E--X-XXXEEXEXXXXXXXXXXXXXEXXX------X---XXX-----------------------------------------------------XXX----X[]XXXXX--------------X--
XXXXXXXXXXXXXXX----------------XXXXXX-------------------------------X-----------------------------------XXX--------------------------------------------------X--