----------------------------------------------------------------------------------------------------------------------------------------------------------------
----------------------------------------------------------------------------------------------------------------------------------------------------------------
----------------------------------------------------------------------------------------------------------------------------------------------------------------
-----------------------------------------------------------------------------S-----------------------------------------------------------SS---------------------
------------------------------------------------------------------X>---------------------------------------------------------------------[]---------------------
------------------------------------------------------------------[]---------------------------------------------------------------------[]---------------------
------------------------------------------------------------------[]X------XXXX----------------------------------------------------<>----<>---------------------
---------------------------------------------E-----SQ-----------S-<--------XXX---------------------------------------------------XX[]---------------------------
--------------------------------------------------------------------------------------------------------------------------------XXX[]-----E---------------------
-----------------------------------------------X-------------------------------------------------------------------------------XXXX[]---------------------------
-----------------------------X----------------XX---------------S-----------------------------------Q--------------------------XXXXX[]---<>----------------------
---------------------------SSX----<>--------<>XX----S------<>----------------------------------QQ-E--------------------------XXXXXX[]---[]-----QQQQQQQQQQ-------
---------------------<>-----------[]--------[]XX-----------[]-------------------------------------E-------------------------XXXXXXX[]---[]----------------------
---------------------[]-----------[]-------X[]XX-------B---[]---E---------XX-----------------------------------------------XXXXXXXX[]---[]----------------------
--SSS----------------[]--EE-------[]------XX[]XX-----------[]-------------XXXXXXXXXXXXE-----------------------------------XXXXXXXXXXXXXXXXXXXXXXXXXXXXXXXXXXXXXX
XX--XXXXXXXXXXXXXXXXXXXXXXXXXXXXXXXXXXXXXXXXXXXXXXXXXXXXXXXXXXXXXX--------XXXXXXXXXXXXXXXXXXXXXXXXXXXXXXXXXXXXXXXXXXXXXXXXXXXXXXXXXXXXXXXXXXXXXXXXXXXXXXXXXXXXXX