----------------------------------------------------------------------------------------------------------------------------------------------------------------
----------------------------------------------------------------------------------------------------------------------------------------------------------------
----------------------------------------------------------------------------------------------------------------------------------------------------------------
----------------------------------------------------------------------------------------------------------S-----------------------------------------------------
-------------------------------------------------------------SSSSSSSSSSSSSSSS?SSSSSS--[]SSSSSSSSSSSS------------------------------------------------------------
--------------------------------------------------------------------------------------[]SSSSSSSSSSSS--------------oo--------------------------------------------
-------------------------XXX----------------------------------------------------------[]SSSSSSSSSSSS--------------oo--------------------------------------------
--?---------------------XEXX---------------------XX----------------------ooooo--------[]SSSSSSSSSSSS---X--SSSSS-------------------------------------------------
-----------------------EXXXX---------------------XX-----------------------------------[]SSSSSSSSSSSS------------------------------------------------------------
----------------------EXXXXX------------X--------XX----------------------SSSSS--------[]SSSSSSSSSSSS--------------------------X---------------------------------
---------------------XXXXXXX-<>--Q?SSSSSX-----XX-XX----------------------SSSSS---------]SSSSSSSSSSSS-----------------?-------XX-----XX--------------------------
--------------------XXXXXXXX-[]--------------XXX-XX---------------E--------------------]SSSSSSSSSSSS------S-----------------XXX-------------------------------XX
E------------------XXXXXXXXX-[]-------------XXXX-XX--------------<>--------------SSSSSSSSSSSSSSSSSSS-----------------------XXXX----------------------------XX---
------------------XXXXXXXXXX-[]------------XXXXX-XX--------------[]--------------SSSSSSSSSSSSSSSSSSS----------------------XXXXX---------------------------XXX---
-----------------XXXXXXXXXXXXXXXXXXXXXXXXXXXXXXX-XX--------------[]--------------SSSSSSSSSSSSSSSSSSS------X--------------XXXXXX-----------------EEXXXXXXXXXXX---
XXXXXXXXXXXXXXXXXXXXXXXXXXXXXXXXXXXXXXXXXXXXXXX--XXXXXXXXXXXXXXXXXXXXX--XXXXXXX--XXXXXXXXXXXXXXXXXXX---X--X----------XXXXXXXXXX--------XXXXXXXXXXXXXXXXXXXXX----