----------------------------------------------------------------------------------------------------------------------------------------------------------------
----------------------------------------------------------------------------------------------------------------------------------------------------------------
----------------------------------------------------------------------------------------------------------------------------------------------------------------
----------------------------------------------------------------------------------------------------------------------------------------------------------------
----------------------------------------------------------------------------------SSSSSSSSSSSSSSSSSSSSSSSSSSSSSSSSSSSSSSSSSSSSS---------------------------------
----------------------------------------------------------------------------------SSSS---------SSSSSSSSSSSSSSSSSSSSSSSSSSSSSSSS---------------------------------
------o-oo-oo-ooo-----------------------------------------------------------------SSSS---------SSSSSSSSSSSSSSSSSSSSSSSSSSSSSSSS---------------------------------
---XX----------------------XXX----------------------------------------SSSSS-------SSSS---------SSSSSSSSSSSSSSSSSSSSSSSSSSSSSSSS-------------------------SS----SS
-----------------------------------------------------------------------------------------------SSSSSSSSSSSSSSSSSSSSSSSSSSSSSSSS---------------------------------
---------------XX-------------------------------------------<>--------------<>-----------------SSSSSSSSSSSSSSSSSSSSSSSSSSSSSSSS---------------------------------
------------------------------------------------------------[]--------------[]-----o-----------SSSSSSSSSSSSSSSSSSSSSSSSSSSSSSSS---------------------------------
--------------------XXX-----------------QQQQQQQQQQQQQQQQQQ?-[]------X?---E--[]----S?SS---------------------------------------SS---------QQQQ-----------SSS------
------------------------------------------------------------[]-----XX---<>--[]----SSS------<>--------------------------------SS--------------------------------E
------------------------------------------------------------[]----XXX---[]--[]----SS-------[]--------------------------------SS---------------------------------
--------------------------------XXXXXXXXXXXXXXXXXXXXXXXXXXXXXXXXXXXXX---[]--[]------E-EE---[]-------------------------------------------------------------------
XXXX--XXXXXXXXXX----------------XXXXXXXXXXXXXXXXXXXXXXXXXXXXXXXXXXXXXXXXXXXXXXXXXXXX-XXXXXXXXXXXXXXXXXXXXXXXXXXXXXXXXXXXXXXXXXXXXXXXXXXXXX-XXXXXXXXXXX-XXXXXXXXX