----------------------------------------------------------------------------------------------------------------------------------------------------------------
----------------------------------------------------------------------------------------------------------------------------------------------------------------
----------------------------------------------------------------------------------------------------------------------------------------------------------------
----------------------------------------------------------------------------------------------------------------------------------------------------------------
----------------------------------------------------------------------------------------------------------------------------------------------------------------
------------------------------o-------------------------------------------------------------------------------------------------------------------------XXXSXXXX
-----------------------------XXX-----------------------------------------------------------------------------------------------------------------------XX-------
---------------------------------o------XXX--oo------------------SS-----------------------------------?SSS--------------------------------------------XXX-------
---------------------------------XXXX----------------------------------------------------------------------------------------------------------------XXXX-------
-------------------------XXX------------------------------------------------------------------------------------------------------------------------XXXXX-------
----------------------E-----------------------XX----------------------------<>----------------------E------<>----<>--------------------------------XXXXXX-------
----------------------X-----------------------------------------XXXX--------[]-----<>--------------<>---E--[]--?-[]---------ESSS----E----X--------XXXXXXX-------
-------------------E--X--------------------------------------XXXXX----------[]-----[]-----E--------[]--<>--[]----[]----------------<>---XXX------XXXXXXXX-------
-------------------X--X-----------------------------------XXXXXX------------[]-----[]--------------[]--[]--[]----[]--B-------------[]--XXXXXX---XXXXXXXXX-------
-------------------X--X-----------------------------------XXXX--------------[]-----[]--------------[]--[]--[]----[]----------------[]-XXXXXXXX-XXXXXXXXXX-------
XXXXXXXXXXXXXXXXX--X--X--XXXXXXXX-------------------------XX------XX--------XXXXXXXXXXXXXXXXXXXXXXXXXXXXXXXXXXXXXXXXXXXXXXXXXXXXX--XXXXXXXXXXXXXXXXXXXXXXXXXXXXX