----------------------------------------------------------------------------------------------------------------------------------------------------------------
----------------------------------------------------------------------------------------------------------------------------------------------------------------
----------------------------------------------------------------------------------------------------------------------------------------------------------------
----------------------------------------------------------------------------------------------------------------------------------------------------------------
---------------------------------------------------------------------------------------------------------XX-----------------------------------------------------
---------------------------------------------------------------------------------------------------------XX-----------------------------------------------------
-----------------------------------?---------------------------------------------------------------------XX-----------------------------------------------------
-----------------------XX----------E---------------------------------XXXXXX----------------------------S-XX----------E-----------------E----------------------SS
----------------------XXX--------------------------------------------------------------------------------XX---------------------------<>------------------------
---------------------XXXX----------------------------------------------------------XXXXX-----------------XX-------E-------------------[]------------------------
----------oo--------XXXXX----------------------E------------------------------------------------------S--XX---------------------------XXX-----------------------
-------------------XXXXXX----------------------------ooooo----------------XXXXXXXX-----------------------XX-----------------------<>------------------------QQQQ
-------<>---------XXXXXXX------------------XX------------------------------------------------------------XX-----------------------[]----------------------------
-------[]--------XXXXXXXX-----------------XXX-----------------X----------------------------------------E-XX-----------------------[]-----<>---------------------
-------[]-------XXXXXXXXX-------XXXXXXXXXXXXX--XXXXXXXXXXX----X------------------------------------------XX-----------------------[]-----[]----------E----------
XXXXXXXXXXXXXXXXXXXXXXXXXXXXXXXXXXXXXXXXXXXX---X---------X----X--XXXXXXXXXX---------------XXXXXXXXXXXXXXXXX--------------<>XXXXXXXXXXXXXXXXXXXXXXXXXXXXXXXXXXXXX