----------------------------------------------------------------------------------------------------------------------------------------------------------------
----------------------------------------------------------------------------------------------------------------------------------------------------------------
----------------------------------------------------------------------------------------------------------------------------------------------------------------
----------------------------------------------------------------------------------------------------------------------------------------------------------------
-----------------?----------------------------------------------------------------------------------------------------------------------------------------------
----------------------------------------------------------------------------------------------------------------------------------------------------------------
--------------------------------------------------------------------------XX------------------------------------------------------------------------------------
---------------------------------------------?----------------------------------------------------------------------SSSS-----------------?----------------------
-------------------SS-------------------------------------------------------------------------------------------------------------------------------------------
-----------------------------------------------------------E------E----------------------------------------------------------------------------------o----------
---------------SS-------------------------------------------XXXXXXXXXX----XX--------?--------------------------------E------------------------------------------
---------<>-----------XXX--XXXXXXXXXX---QQQ----------------------------------------------------S?S-----------------SSSSS--------------Q--Q--QQQ-----S-----------
---------[]----------XXXXE--------------------------------------------------------------------------------------------------------------------------------B-----
---------[]-<>------XXXXX-----------------------------------------------------------E---------------------B-----------------------------------------------b-----
------E--[]-[]-----XXXXX----------------------------------------------------------------E-----------------------------------E-----------------------------BEE---
XXXXXXXXXXXXXXXXXX-XXXXX----------------X-XXXXXXXXXXXXXXXXX--------------------XXXXXXXXXXXXXXXXXXXX-XX-XXXXXXXXXXXXXX--XXXXXXXXXXXXXXXXXXXXXXXXXXXXXXXXXXXXXXXXX