----------------------------------------------------------------------------------------------------------------------------------------------------------------
----------------------------------------------------------------------------------------------------------------------------------------------------------------
----------------------------------------------------------------------------------------------------------------------------------------------------------------
----------------------------------------------------------------------------------------------------------------------------------------------------------------
----------------------------------------------------------------------------------------------------------------------------------------------------------------
----------------------------------------------------------------------------------------------------------------------------------------------------------------
----------------------------------o-ooo------------------------------------------------------------------------------XXX-------ooo-oo---------------------------
----------------------------XXXXX------------------------------------------------------------------XXX---XXXX---------------------------------------------------
----------------------------------------------------------------------------------------------------------------------------------------------------------------
-------------------------------------XX-----------------------------------------------------------------------------------------------------X----X-----------?--
------------oooooooo-------------------------------------------------------------------------------------------------------------------------SSSSX-------------<
------------------------XXXX--------------------------------------------E------XXX-------XX-----X-------------------------------------?-------------------B----[
---<>----<>------------------------------------------------------------<>-X-X-XXXXXXXXXX------------------------------------------------------------------b----[
---[]----[]-----------------------------XX-----------------------------[]-X-X-XXXXXXXXXX-----------------------------------------------------------------------[
---[]----[]------------------------------------------XXXXXXXXXXXXXXXXXXXXXXXXXXXXXXXXXXX---------------------------------------------------XXXXXXXXXXXXXXXXXXXXX
XXXXXXXXXXXXXXXXXXXXXXX-----XXXX--XXXX------XXXXXXXXXXXXXXXXXXXXXXXXXXXXXXXXXXXXXXXXXXX------------------------------------------XXXX------XXXXXXXXXXXXXXXXXXXXX