----------------------------------------------------------------------------------------------------------------------------------------------------------------
----------------------------------------------------------------------------------------------------------------------------------------------------------------
----------------------------------------------------------------------------------------------------------------------------------------------------------------
----------------------------------------------------------------------------------------------------------------------------------------------------------------
----------------------------------------------------------------------------------------------------------------------------------------------------------------
----------------------------------------------------------------------------------------------------------------------------------------------------------------
----oo------------------E---------------------------------------------------------------------------------------------------------------------------------------
--------------------SSS------------------------------------------------------------------------------------E-----------Q------------XX--------------------------
----------------------------------------------------------------------------------------------------------SSSS---------------------XXX--------------------------
----------------------------------------------------------------------------------------------------------------------------------XXXX--------------------------
------------------------------------------------------------------------------------------------------X-E--E---------------------XXXXX-----o----B---------------
--------------------SS-----------------<>---------------------------------------------------------X---XS?SSSSS---------?--------XXXXXX----------b---------------
------------<>-------------------------[]----------------------------<>---------------------------X-----------EES--------------XXXXXXX----------------E---------
------------[]-------------------------[]--------------<>------------[]---------------------------XX--SSSSSSSSSS--------------XXXXXXXX--------------------------
--E-E-------[]-------------------------[]--------------[]------------[]E--------------------------XX------------S------------XXXXXXXXX--------------------------
XXXXXXXXXXXXXXXXXXXXXXXXXXXXXXXXXXXXXXXXXXXXXXXXXXXXXXXXXXXXXXXXXXXXXXXXXXXXXXXXXXXXXXXXXXXXXXXXXXXXXXXXXXXXXXXX-XXXXXXXXXXXXXXXXXXXXXXXXXXXXXXXXXXXXXXXXXX-XXXX