----------------------------------------------------------------------------------------------------------------------------------------------------------------
----------------------------------------------------------------------------------------------------------------------------------------------------------------
----------------------------------------------------------------------------------------------------------------------------------------------------------------
----------------------------------------------------------------------------------------------------------------------------------------------------------------
----------------------------------------------------------------------------------------------------------------------------------------------------------------
----------------------------------------------------------------------------------------------------------------------------------------------------------------
------------------------------------------------------------------------------------------------------------------------------o-oo------------------------------
-----------------------------------------Q------------------------------------------------------------------------oo------XXX---------------------------------E-
-----------------------------------------------------------------------------------------------------------------XX---------------------------------------------
------------------------------------------------------------------------------------------------------------------------------------------------------XXXXXX----
----------------------------------------------------------------------------------------------------------------------------------------------------------------
---Q-------------S-----------------------?-----------------XX-------------------------------------------------------XXXXXX---------?----------------------------
---------------E------B-----------BXX<>-------------------XXX--------------------------------------------------------------------------------------XXXX---------
----------------------b----------XXXX[]----------B-------XXXX-------------------------X------B------------------------------------------XX----------------------
----------------------BEEXXXXXXXXXXXX[]-----------------XXXXX-------------------------X-------------------------------------------------XXX------------------ooo
XXXXX<>XXXXXXXXXXXXXXXXXXXXXXXXXXXXX-XXXXXXXXXXXXXXXXXXXXXXXX---XXXXXXXXXXXXXXXXXXXXXXXXXXXXXXXXXXXXX-XXXXXXXXXXX---------XX--XXXX------XXXXXXXXX------------XXX