----------------------------------------------------------------------------------------------------------------------------------------------------------------
----------------------------------------------------------------------------------------------------------------------------------------------------------------
----------------------------------------------------------------------------------------------------------------------------------------------------------------
----------------------------------------------------------------------------------------------------------------------------------------------------------------
----------------------------------------------------------------------------------------------------------------------------------------------------------------
----------------------------------------------------------------------------------------------------------------------------------------------------------------
-------E-E---E-----------------------------------E-----------------------------------XS-------------------------------------------------------------------------
-----SSSSSSSSSSS-------------XX---------XX--XX----------------------------------E---EX----------------------------------------E---------------------------------
-----------------------------XX--------XXX-----------------------------------------XXX--------------------------------------------------------------------------
---------------------------XXXX-------XXXX-------X--------------------------------XXXXS------------------------------------E------------------------------------
---------------------------XXXX------XXXXX----------------ooooooo----------------XXXXX------XSS-SQ-----------ooo------------------------------------------------
-------------------------XXXXXX-----XXXXXX----------------ooooooo--------------<>XXXXX-----XXX-----------<>-----------------------------------------------------
------E-----X------------XXXXXX----XXXXXXX-------------------------------<>----[]XXXXX----XXXX-----------[]-----------------------------------------------------
-<>---------X-------X----XXXXXX---XXXXXXXX-------------XXXXXXXXEXXXXX----[]---X[]XXXXX---XXXXX-----------[]-----------------------------------------------------
-[]---------X-------X-E--XXXXXX--XXXXXXXXX-------------XX-----------X----[]--XX[]XXXXXXXXXXXXX--SSSS-----[]------------------------------------------E----------
XXXXXXXXXXXXXXXXXXXXXXXXXXXXXXX--XXXXXXXXX-------------XX-----------X----XXXXXXXXXXXXXXXXXXXX------XX-XXXXXXXXX-XXXXXX------------XXXXXXX-XXXXXXXXXX--XXXXXXXXXX