----------------------------------------------------------------------------------------------------------------------------------------------------------------
----------------------------------------------------------------------------------------------------------------------------------------------------------------
----------------------------------------------------------------------------------------------------------------------------------------------------------------
---------------------------------------------------------------------------------------------XXX----------------------------------------------------------------
----------------------------------------------------SSSSSSSSSSSSSSSSSSSSSSSSSSSSSSSSSSSSSSS---------------------------------------------------------------------
----------------------------------------------------SSSS--------------------------------------------------------------------------------------------------------
----------------------------------------------------SSSS-------------------------------------------------------------ooo-------ooo---------o-oo-----------------
----------------------------------------------------SSSS----------------------------------------------oo-------------ooo-------XXXX--XXXXX----------------------
---------------------------------------------------------------------------------------E------------------------------------------------------------------------
------------------------------------<>------------------------------------------------<>------------------------------------------------------------------------
------------------------------------[]----------------E----------------XX----------E--[]---------------------------------------------------------------oo-------
------------------------------------[]---------------<>---------------------------<>--[]-----------XXX--XX-XX-----E-----XXXX-XXXXXXXX---------------------------
----------------------------------E-[]---------------[]----------XX------------XX-[]--[]--XXX---------------------------X---------------------------------------
-----------X-----------------<>--<>-[]---------------[]-----X--XXXX----------XXXX-[]--[]--XXXXXX----------------XXXX----X---------------------------------------
-----------X-----------------[]--[]-[]---------------[]---E--XXXXX---------XXXXXX-[]--[]--XXX----------------------X----X---------------------------------------
XXXXXXXXXXXXXXXXXXXXXXXXXXXXXXXXXXXXXXXXXXXXXXXX-XXXXXXXXXXXXXXXXX---------XXXXX--XX--XX--XX-----------------------X----X------------XXXX--XXXXXXXXXXXXXXXXXXXXX