----------------------------------------------------------------------------------------------------------------------------------------------------------------
----------------------------------------------------------------------------------------------------------------------------------------------------------------
----------------------------------------------------------------------------------------------------------------------------------------------------------------
----------------------------------------------------------------------------------------------------------------------------------------------------------------
-----------------------------------------SSSSSSSSSSSSSSSSSSSSSSSSSSSSSSSSSSSSSSSSSSSSSSSSSSSSSSSSSSSSSSSSSSSSSSSSSSSSSSSSSSSSSSSSSSSSSSSSSSSSSSSSS??????SSSSSSSS
-----------------------------------------SSSS---------------------SS--SSSSSSSSSSSSSSSSSSSSSSSSSSSSSSSSSSSSSSSSSSSSSSSSSSSSSS------------------------------------
-----------------------------------------SSSS---------------------SS--SSSSSSSSSSSSSSSSSSSSSSSSSSSSSSSSSSSSSSSSSSSSSSSSSSSSSS------------------------------------
-----------------------------------------SSSS-------------------SS------SSSSSSSSSSSSSSSSSSSSSSSSSSSSSSSSSSSSSSSSSSSSSSSSSSSS--QQ--------------------------------
----------------------------------------------------------------SS----------------------------------------------------------------------------------------------
----------------------------------------------------------------SS----------------------------------------------------------------------------------------------
------------<>---------------XSS-SQ--------E--------------------SS----o?oooooooooooo--------------?-------------------------------------------XXXXXXXXX---------
<>--------?-[]--------<>----XXX-----------<>------------E-------SSSS--SSSSSSSSSSSSSSSSSSSSSSSSSSSS??SSSSSSSSSSSSSSSSSSSSSSSS--QQ-----XXXXXXX--XXXXXXXXX---------
[]-----<>---[]--------[]---XXXX-----------[]-----------<>---------SS----------------SSSSSSSSSSSSS---SSSSSSSSSSSSSSSSSSSSSSSS--------XXXXXXXXXXXXXXXXXXX---------
[]-----[]---[]--------[]--XXXXX-----------[]-----------[]---------SS----------------SSSSSSSSSSSSS---SSSSSSSSSSSSSSSSSSSSSSSS-------XXXXXXXXXXXXXXXXXXXX---XXX---
[]-----[]---[]-E------[]-XXXXXX--SSSSS----[]-----------[]-------------------E---EE---------------oooSSSSSSSSSSSSSSSSSSSSSSSS------XXXXXXXXXXXXXXXXXXXXX---------
XXXXXXXXXXXXXXXXXXXXXXXXXXXXXX--------XXXXXXXXXXXXXXXXXXX---XXXXXXXXXXXXXXXXXXXXXXXXXXXXXXXXXXXXXXXXXXXXXXXXXXXXXXXXXXXXXXXXXXXXXXXXXXXXXXXXXXXXXXXXXXXX-------X