----------------------------------------------------------------------------------------------------------------------------------------------------------------
----------------------------------------------------------------------------------------------------------------------------------------------------------------
----------------------------------------------------------------------------------------------------------------------------------------------------------------
----------------------------------------------------------------------------------------------------------------------------------------------------------------
----------------------------------------------------------------------------------------------------------------------------SS?????????SSSSSSS------------------
--------------------------------------------------------------------------------------------------------------------------SS------------------------------------
-----------------------------------------------------------------------------------------------------------------------SSS--------------------------------------
-------------------------------------XX----------------E---XX---------------------------------------------------------------------------------------------------
------------------------------------XXX-------------------XXX---------------------------------------------------------------------------------------------------
----------------<>-----------------XXXX------------------XXXX---------------------------------------------------------S-----------------------------------------
----------------[]----------------XXXXX-----------------XXXXX-----------XXXX--------------E---ooo---------------------------XXXXXXXXXX--------------------------
----------o----QQQQQQQ-----------XXXXXX---------------<>XXXXX------XX--------------------<>------------------------<>------XXXXXXXXXXX--------------------------
----<>--------------------<>----XXXXXXX---------------[]XXXXX--------------------<>---------------------<>---------[]-----XXXXXXXXXXXX-------------------?-B----
----[]--------------------[]---XXXXXXXX--------------X[]XXXXX---------o----------[]---------------------[]---------[]----XXXXXXXXXXXXX---------------------b----
----[]--------------------[]--XXXXXXXXX-------------XX[]XXXXX--------XXX---------[]-E-------------------[]---------[]---XXXXXXXXXXXXXX--------------------------
XXXXXXXXXXXXXXXXX-X--XXXXXXXXXXXXXXXXXX------XXXXXXXXXXXXXXXXXXXX----------------XXXXXXXXXXXXXXXXXXXXXXXXXXXXXXXXXXXXXXXXXXXXXXXXXXXXXX--X----XXXXXXXXXXXXXXXXXX