----------------------------------------------------------------------------------------------------------------------------------------------------------------
----------------------------------------------------------------------------------------------------------------------------------------------------------------
----------------------------------------------------------------------------------------------------------------------------------------------------------------
----------------------------------------------------------------------------------------------------------------------------------------------------------------
----------------------------------------------------------------------------------------------------------------------------------------------------------------
----------------------------------------------------------o-o---------------------------------------------------------------------------------------------------
------------------------------------XX----XXXX--E---XXXX--o-o---------o-----------------------------------------------------------------------------------------
-------------------E-----------------------------------------------XX-----------------------------------------------Q-------------------------------------------
--------------------------------------------------------------------------------ooo-----------------------------------------------------------------------------
--------------------------------E---------------X------------------------------------XX---------------<>--------------------------------------------------------
---------------------------------XX----XX------------------XX-----------------------------------------[]----------------------------------------------Q---------
---------------------------------------------------------------------------------XXXX-----------------[]------Q---S?SQS----oXXX---------------------------------
----------------------------------------------------------------------------------------------------E-[]--------------------------------------------------------
------------------------------------------------------------------------------------X--------------<>-[]---B----------------------------------------------------
---------------------------------------------------------------------------XXXXXX------------------[]-[]--------------------------------------------------------
XXXXXXXXXXXXXXXXXXXXXXXXXXXXXXXX---------------------------------XXX--XXX----------------XXXXXX-XXXXXXXXXXXXXXXXXXXXXXXXXX-------X-XXXXXXXXXXXXXXXXXXXXXXXXXXXXX