----------------------------------------------------------------------------------------------------------------------------------------------------------------
----------------------------------------------------------------------------------------------------------------------------------------------------------------
----------------------------------------------------------------------------------------------------------------------------------------------------------------
-----------------------------------------------------------------------------------------------------------------------------?-----ooo--------------------------
-----------------------------------------------------------------------------------------------------------------------------------o-o--------------------------
----------------------------------------------------------------------------------------------------------------------------------------------------------------
-----------------------------------------------------------------------------------------------E----------------------------S------XXX------------------------XX
--------S------------------------?SSS-------------------------------E----------------------SSSSSS-----XXX--------------o----------------------------------------
------------------------------------------------------------------------------------------------------XXX--------ooo--XX----------------------------------oo----
--------------------------------------<>--------------------------------------------------------------XXX-------------------------------------------------SS----
--------------------------------------[]----------------------------------------------------E------XX-XXX----------------XXXXXX------------ooooo----------------
-------SS--------------------------E--XXX--------------------------------------XX----------SSSSS--XXX-XXX-----<>---------------------------ooooo----------------
----E-----------X-------------E---<>----------<>------------------------------XXX---<>-----------XXXX-XXX-----[]------------------------------------------------
----------------X-----------------[]----------[]-----------------------------XXXX---[]----------XXXXX-XXX-----[]-------------------------XXXXXEXXXEXXXX---------
----------------X-----------------[]----------[]-E--------------------------XXXXX---[]-E-------XXXXXX-XXX-----[]-------------------------X------------X---------
XXXXXXXXXXXXXXXXXXXXXXXXXXXXXXXXXXXXXXXXXXXXXXXXXXXXXXXXXXXXXXXXXX-XXXXXXXXXXXXXX---XXXXXXXXXXXXXXXX--XXXXXXXXXXXXXXXX-------------------X------------X----XX---