----------------------------------------------------------------------------------------------------------------------------------------------------------------
----------------------------------------------------------------------------------------------------------------------------------------------------------------
----------------------------------------------------------------------------------------------------------------------------------------------------------------
----------------------------------------------------------------------------------------------------------------------------------------------------------------
----------------------------------------------------------------------------------------------------------------------------------------------------------------
----------------------------------------------------------------------------------------------------------------------------------------------------------------
----------------------------------------------------------------------------------------------------------------------------------------------------------------
-----------------?SS------------XX-------------------------------------SSS-----------------------------------------------------------------?--------------------
-------------------------------XXX------------------------------------------------------------------------------------------------------------------------------
----------------------E-------XXXX------------------------------------------------------------------------------------------------------------------------------
---------------------<>------XXXXX--------------------------ooooooo----------------------------------------oooooo----------------------------------oooooooo-----
---------------------[]-----XXXXXX--------------E-------<>-----------------SSS-----<>-------X--------------oooooo--------------------------S-------oooooooo-----
------------------B--[]----XXXXXXX-------------<>-------[]-------------------------[]------XXX-----------------------------------------<>-----------------------
------------------b--[]---XXXXXXXX---------X------------[]-------------------------[]-----XXXXXX---XXXXXXXXXXXXEXXXX-------------------[]---X---XXXXXXXXXEXXXXXX
---------------------[]--XXXXXXXXX-------E-X---------E--[]-------------------------[]----XXXX--X--------XX-----------------------------[]E--X---XX-------------X
XXXXXXXXXXXXXXXXXXXXXXXXXXXXXXXXXXXXXXXXXXXXXXXXXXXXXXXXXXXXXXXXXXXXXXXXX--XXXXXXXXXXXXXXXXXX--X--------XX-------------XXXXX-XXXXXXXXXXXXXXXX---XX-------------X