----------------------------------------------------------------------------------------------------------------------------------------------------------------
----------------------------------------------------------------------------------------------------------------------------------------------------------------
----------------------------------------------------------------------------------------------------------------------------------------------------------------
----------------------------------------------------------------------------------------------------------------------------------------------------------------
----------------------------------------------------------------------------------------------------------------------------------------------------------------
----------------------------------------------------------------------------------------------------------------------------------------------------------------
------------------------------------------------------------------------------------------------ooo-------------------------------------------------------------
XQQ?QQX---------E-----------------------------------SQ---------------------------o-o-----oooo---XXX--------?SSS------------------------------------------XX-----
X-----X--------<>---------------------------------------------------------------------------------------------------------------------------------------XXX-----
X-----X--------[]-------------------------------------------------XXX--------------------------------------------E-------------------------------------XXXX-----
XE-E--X--------XXX----------------------------?----------------------------------XXXX--------------------E------<>-----------------Q------XX----------XXXXX-----
XQQ-QQX----<>-----------------------------<>---------S--------------------------------------------------<>---E--[]-----------------------XXX---------XXXXXX---S?
-----------[]-----------------------------[]-------------------------SS-S---------------XX--XX-?--------[]--<>--[]----------------------XXXX--------XXXXXXX-----
------E----[]-----<>----------------------[]-------------------------SS-S-----XXX-----------------------[]--[]--[]---------------------XXXXX-------XXXXXXXX-----
-----------[]-----[]----------------------[]--------------E-E--------SS-S-------------------------------[]--[]--[]--------------------XXXXXXXXXXX-XXXXXXXXX-----
XXXXXXXXXXXXXXXXXXXXXXXXXXXXXXXXXXXXXXXXXXXXXXXX--XXXXXXXXXXXXX---XXXSS-S----------------------XXXX-XXXXXXXXXXXXXXXXXXXXXXXXXXXXXXXXXXXXXXXXXXXXXXXXXXXXXXXXXXXX