----------------------------------------------------------------------------------------------------------------------------------------------------------------
----------------------------------------------------------------------------------------------------------------------------------------------------------------
----------------------------------------------------------------------------------------------------------------------------------------------------------------
----------------------------------------------------------------------------------------------------------------------------------------------------------------
----------------------------------------------------------------------------------------------------------------------------------------------------------------
----------------------------------------------------------------------------------------------------------------------------------------------------------------
-------------------------------------------XXXX--------------------------------ooo-----------------------------------------------------------------XXXXXXXXXXX--
-----------------------SSSS----------XXX--------------E------------------------ooo-------------XX--------------------------------E------------------------------
------------------------------------------------------------E-------------------------------------------------------------------SSSS----------------------------
----------------------------------------------------------------------------------------------------------------------------------------------------------------
----------------------------------------XXX-------XX-----XXXXXXXX---------------------------------------Q-------------------X-E--E---------------XX------------S
---------------------S?S----X----------------------------X------------------E----XX-----XXXXX--------Q-E----------------X---XS?SSSSS----------------------------
-------------------------E--X--------------------------------------------------------------------------E----------------X-----------EE--------------------------
----------------------------X------------------------------------------XXEXXXX-------------------------------------B----XX--SSSSSSSSSSS-------------------------
----------------------------X------------------------------------------------X------------------------------------------XX----------------XX--------------------
XXXXXXXXXXXXXXXXXXXXXXXXXXXXXXXXXX-------------------------------------------X--------------------XXXXXXXXXXXXX-XXXXXXXXXXXXXXXXXXXXXXXX--X---------------------