----------------------------------------------------------------------------------------------------------------------------------------------------------------
----------------------------------------------------------------------------------------------------------------------------------------------------------------
----------------------------------------------------------------------------------------------------------------------------------------------------------------
----------------------------------------------------------------------------------------------------------------------------------------------------------------
----SSSSSSSSSSSSSSSSSSSSSSSSSSSSSSSSSS--------------------------------------------------------------------------------------------------------------------------
----SSSS------------------------------------------------------------------------------------------------------------------------------------------------ooo-----
----SSSS--------------------------------------------------------------------------------------------------------------------XXX------Eoo----------------XXX-----
----SSSS----------------------------------------------------------------------------------------------------------oooo---------------XXXX-----------------------
----------------------------------------------------------------------------------------------------------------------------------------------------------------
----------------------------------------oo----------------------------------------------------------------------------------------------------------------------
-----o----------------------------------------------------------o------------------------------?---------------------------------------------XXXXXXX------------
----S?SS----------------------------XXX--------X---------------------------------------S-------------------------------------------XXXXXXX----------------------
----SSS------XX-------------E------EXXX--------X-------B-----------------------------E-------------------E-------XX--XX-----------------------------------------
----SS-------XXXXX----------------XXXXX--------XX------b-----------------------------------------------------------------------------------o--------------------
------E-EE---XXXXX-----------X--XXXXXXX--------XX------BEE--------------------------------------------------------------------------------XXX------XXXXXXXXXXXXX
XXXXXX-XXXXXXXXXXXXXXXXXXXXXXX--XXXXXX---XXXXXXXXXXXXXXXXXXXXXX---XXXXXXXXXXXXXXXXXXXXXXXXXXXXXXXXXXXXX-X-XXX---------------------------------------------------