----------------------------------------------------------------------------------------------------------------------------------------------------------------
----------------------------------------------------------------------------------------------------------------------------------------------------------------
----------------------------------------------------------------------------------------------------------------------------------------------------------------
----------------------------------------------------------------------------------------------------------------------------------------------------------------
----------------------------------------------------------------------------------------------------------------------------------------------------------------
---------------------------------------------------------------------------------------------E------------------------------------------------------------------
---------------------------------------------------------------------------XX--oo-o---------<>------------------------------------------------------------------
--------?-----------------------------------SSQSS?SSS--------XXX---------------------XX-----[]----------------------------?---------------?SSS------------------
--------------------------------------------------------------------------------------------[]------------------------------------------------------------------
--------------------------------------------------------------------------------------------[]-------------------------------------------------<E---------------
---------------------------------------------------------------------XXXX--------------X----[]-----------QQQ------X---------------------E------[>--------------X
--QQQQ--Q--------------------------------S--SSSSSSSSS----XXXXX-XXX--------------XXX---------[]-------------------XX--------------------<>---E--[]-------------XX
---------------------------------------E----------------------------------------------------[]------------E-----XXX-----E--------------[]--<>--[]------------XXX
----------------B-----B--------------------------------------------o------------------------[]-----------------XXXX----------B---------[]--[]--[]-----------XXXX
EE---------------------------------------------------------------XXXX-----------------------XXXXEXXXXXXXXXXXXXXXXXX-----------------E--[]--[]--[]----------XXXXX
XXXXXXXXXXXXXXXXXXXXXXXXXXXXXXXXXXXXXXXXXXXXXXXXXXX-XXXX------------------------------------XXXXXXXXXXXXXXXXXXXXXXXXXXXXXXXXXXXXXXXXXXXXXXXXXXXXXXXXXXXXXXXXXXXX