----------------------------------------------------------------------------------------------------------------------------------------------------------------
----------------------------------------------------------------------------------------------------------------------------------------------------------------
----------------------------------------------------------------------------------------------------------------------------------------------------------------
----------------------------------------------------------------------------------------------------------------------------------------------------------------
----------------------------------------------------------------------------------------------------------------------------------------------------------------
------------------------------------------------------------------------------------------------------------------------------------oo--------------------------
-----------------------------------------------------------------------------------------------------------------------XXX----------------XXXXXXXE--------------
-----------------------------------------------------------------------------------------------?Q-------------------------------------XX------------------------
----------------------------------------------------------------------------------------------------------------------------------------------------------------
----------------------------------------------------oooo---------------------------------------------------------------------------------------------------oooo-
----------------------------------------------------------------------------------------------QQ----------------------------------------------------------------
-----<>---------------E--------------------ooo------------------------------------------------------------------------------?XXXXX------------------------------
-----[]-------------------------------------------------------------------------XXXXXXXXXX----------------------------------------------------------------------
-----[]------------------------------X-----------------------------------------XXXXXXXX-----------------------------------------------------------XXXX----------
--E--[]-EEXXXXXEXXXXXXXXXXXXXXXEXXXXXX-XXXXXXX-----<>---XXXXXXXXXXXXXXXXXXXXXXXXXXXXXXX------XXXXXXXXXXXXXXXXXXXXXXXXEXXXXXXXX----------------------------<>---X
XXXXXXXXXXXXXXXXXXXXXXXXXXXXXXXXXXXXXX-------X-----[]----XXXXXXXXXXXXXXXXXXXXXXXXXXXXXX------X------------------------------------------------------------[]----