----------------------------------------------------------------------------------------------------------------------------------------------------------------
----------------------------------------------------------------------------------------------------------------------------------------------------------------
----------------------------------------------------------------------------------------------------------------------------------------------------------------
----------------------------------------------------------------------------------------------------------------------------------------------------------------
----------------------------------------------------------------------------------------------------------------------------------------------------------------
----------------------------------------------------------------------------XXXXXXXXXXXXXXXXXXXXXXXXXXXXXXXXXXXXXXXXXXXXXXXXXXXXXXXXXXXXXXXXXXXXXXXXXXXXXXXXXXXX
-------------------------------------------------------------------E-------XX-----------------------------------------------------------------------------------
-----------------------------------------------------SSS-------XSSSSS-----XXX-----------------------------------------------------------------------------------
---------------------------------------------------------------X---------XXXX-----------------------------------------------------------------------------------
---------------------------------------------------------------X--------XXXXX-----------------------------------------------------------------------------------
----------------------------------------------E---------------EXE------XXXXXX-----------------------------------------------------------------------------------
-E---X-----------------------------------QQQQQQQ---------X-----XSSSS--XXXXXXX-----------------------------------------------------------------------------------
<>---XX-XXXXXXXXXXXXXXXXXXXXXXXXXXXXXXXXX-------------E--X-----------XXXXXXXX--------<>------------------------------<>-----------------------------------------
-----XXX-------------------------------------------------XX---------XXXXXXXXX--------[]------------------------------[]-----------------------------------------
-----XX--------------------------------------------------XX--------XXXXXXXXXX--------[]------------------------------[]-----------------------------------------
XXXXXXXXXXXXXXXXXXXXXXXXXXXXXXXXXXXXXXXXXXX-<><>---XXXXXXXXXXXXXXXXXXXXXXXXXXXXXXXXXXXXXXXXXXXXXXXXXXXXXXXXXXXXXXXXXXXXXXXXXXXXXXXXXXXXXXXXXXXXXXXXXXXXXXXXXXXXX