----------------------------------------------------------------------------------------------------------------------------------------------------------------
----------------------------------------------------------------------------------------------------------------------------------------------------------------
----------------------------------------------------------------------------------------------------------------------------------------------------------------
----------------------------------------------------------------------------------------------------------------------------------------------------------------
----------------------------------------------------------------------------------------------------------------------------------------------------------------
-----------------------------------------o----------------------------------------------------------------------------------------------------------------------
----------------------------------------------------------------------------------------------------------------------------------------------------------------
-------------------------------------E-SSS------XX-------------------------------------?----XX---------XX----------E--XXXX--------------------------------------
-oo---------------------------------------------XX-----------------------------------------------------XX-------------------------------------------------------
----------------------------------------------XXXX-----------------------------------------------------XX-------------------------------------------------------
---------------Q----------------XXX-----------XXXX---------------------------oooo----------------XX----XX-------------------------------------------------------
-----------QQ-E------S------------------S---XXXXXXS------------------------------------S---------XXX---XX-------------------------------X-----------------------
--------------E----E------------------------XXXXXX----------------------E----------<>------------------XX-------------------------------XX----------------------
-------------------------XXEX---------------XXXXXX-------------<>------------------[]---X--------------XX-----XXXX-----------XXXXXXX----XXX---------------------
-----------------------------------------E--XXXXXX-------------[]------------------[]E--X--------------XX-----X-------------------------XXXX----------------E---
XXXXXXXXXXXXXXXXXXXXXX----------------XXXXXXXXXXXXXXXXXXX-XXXXXXXXX--XXXXXXXXXXXXXXXXXXXX--------------XX-----X-------------------------XXXXXXXXXXXXXXXXXXXXXXXX