----------------------------------------------------------------------------------------------------------------------------------------------------------------
----------------------------------------------------------------------------------------------------------------------------------------------------------------
----------------------------------------------------------------------------------------------------------------------------------------------------------------
----------------------------------------------------------------------------------------------------------------------------------------------------------------
--------SSSSSSSSSSSSSSSSSSSSSSSSSSSSSSSSSSSSSSSSSSSSSSSSSSSSSSSSSSS--[]SSSSSS-----------------------------------------------------------------------------------
--------SSSS------------SS--SSSSSSS--SSSS----SS----SSSSSS--SSS-------[]SSSSSS---------------------------------------------------------------------oooo----------
--------SSSS------------SS--SSSSSSS--SSSS--E-SS--E-SSSSSS--SSS-------[]SSSSSS---------------------------------------------------------------------XXXX----------
--------SSSS----------SS---------SS---S----SS----SS----SS------------[]SSSSSS-----XX--------------SQ------------------------------------------------------------
----------------------SS---------SS---S----SS----SS----SS------------[]SSSSSS----------------------------XXX---------------------------------------------------E
----------------------SS---------SS---S----SS----SS----SS------------[]SSSSSS-----------------------------------------------------ooo---------------------------
----------E-----------SS----oooooSS---So??-SSo??-SSooooSS-------------]SSSSSS-----------------------------------------------------ooo-------XXX----------X------
---------<>-----------SSSS--SSSSSSS---SSS--SSSS--SSSSSSSS--SSS--------]SSSSSS--------------<>------S------------------------------------------------------------
---------[]-------------SS--------------------------------------SSSSSSSSSSSSS--------------[]-------------------------------------------------------------------
---------[]-----XXX-----SS--------------------------------------SSSSSSSSSSSSS--------------[]--------------------------------XXEXXXXXX--------------------------
---E-----[]---XXXXX---------------------------------------------SSSSSSSSSSSSS--------------[]-------------------------------------------------XXXXXXXXXXXXXXXX--
XXXXXXXXXXXXXXXXXXXXXXXXXXXXXXXXXXXXXXXXXXXXXXXXXXXXXXXXXXXXXX--XXXXXXXXXXXXX--------------XXXXXXXXXXXX--------------XXXXX-----------------------------------X--