----------------------------------------------------------------------------------------------------------------------------------------------------------------
----------------------------------------------------------------------------------------------------------------------------------------------------------------
----------------------------------------------------------------------------------------------------------------------------------------------------------------
----------------------------------------------?-----------------------------------------------------------------------------------------------------------------
----------------------------------------------------------------------------------------------------------------------------------------------------------------
-------o---------------------------------------------------------------------------------------------------------------------------------------o----------o-----
-------o-------------------------------------S--------------------E---------------------------------------------------------------------------XXX--------XXX----
----------------------------------------------------------------SSSSSSSSSSSSSSSSSSSSSSSSSSSSSSSSSSSSSSSS------S----------------------------------------------o--
-------------------------------------------------------------------------------------------------------------------------------------------o------o---o------XXX
---------------------------------------------------------------E-----------------------------------------------------------ooo----ooooo---XXX-----XX-XXX--------
---------?------------------------------XXXXXXXX--------------------------SSSSSSSSSSSSSSSSSSSSSSSSSS-----------------------ooo----ooooo-------------------------
-------------------------------------------------------------S?S--------SS-----------------------------------SS-------------------E-----------------------------
-----------------------------E--------------------------E-------------<>-------------------------------------------------E--------------------------------------
-------------------------------------------------------<>-------------[]-------------------------------------------------XXXXXXXXXXXXXXX------------------------
------------------E-E-----------------E-------------------------------[]----E--E--E--E--E--E--E--E---EE------------------X------X-------------------------------
XXX------XX<>XXXXXXXXXXXXXXXXXXXXXXXX--------------XXXXXXXXXXXXXXXXXXXXXXXXXXXXXXXXXXXXXXXXXXXXXXXXXXXXXXXXXXXXXXXXXXXX--X------X---------XXXXXXXXXXXXXXXXXXX---