----------------------------------------------------------------------------------------------------------------------------------------------------------------
----------------------------------------------------------------------------------------------------------------------------------------------------------------
----------------------------------------------------------------------------------------------------------------------------------------------------------------
----------------------------------------------------------------------------------------------------------------------------------------------------------------
-----------------------oo---------------------------------------------------------------------------------------------------------------------------------------
----------------------------------------------------------------------------------------------------------------------------------------------------------------
----------------------XXXX---XX---------------------------------------------------------------------------------------------------------------------------------
------------------------------------------------XQQ?QQX------------------------------------------------------------------SSSSSSSS?SSSQSS?SS?SS------------------
------------------------------------------------X-----X---------------------------------------------------------------------------------------------------------
------------------------------------------------X-----X---------------------------------------------------------B-----------------------------------------------
-------?----------------------------------------XE-E--X---------------------------X-----------------------------b-----------------------------------------------
---<>-----------------E-------------------------XQQ-QQX-----------oooo---------SSSX--S-------------SS---ESSSSSSSXS--------X---SSSSSSSSSSSSSSSS----SS------------
---[]----------------<>-----------------------------------------------------E---------------------------------------------X-------------------------------------
---[]----------------[]-------------------------------E-------------------------------------------------------------------X-------------------------------------
---[]---------------X[]XXXXEXXXXXXX---------------------------------------------------------------------------------------X-------------------------------------
XXXXXXXXXXXXXXXX------------------XXXXXXXXXXXXXXXXXXXXXXXXXXXXXXXXXXXX---XXXXXXXXXXXXXXXXXXXXXXXXXXXXXXXXXXXXXXXXXXXXXXXXXXXXXXXXXXXXXXXXXXXXXXXXXXXXXXXXXXXXXXX