----------------------------------------------------------------------------------------------------------------------------------------------------------------
----------------------------------------------------------------------------------------------------------------------------------------------------------------
----------------------------------------------------------------------------------------------------------------------------------------------------------------
---------------------------------------------------------------------------------------------------S------------------------------------------------------------
----------------------------------------------------------------------------------------------------------------------------------------------------------------
----------------------------------------------------------------------------------------------------------------------------------------------------------------
----------------------------------------------------------------------------------------------------------------------------------------------------------------
---------------------------SS-----SSSSSSSSSSSSSSSSSSSSSS-------------------SSSSSSS----------------------E-------------------------------------------------------
----------------------------------------------------------------------------------------------------------------------------------------------------------------
------------------------------------------------------------------------------------E---------------------------------------------ooooooooo----XXXXXXXXXXXXXXXXX
-----------------------------------------------------------------------------------<>---------------------------------------------ooooooooo---------------------
----<>------------X-------XXXX-------------------------S---------------<>---E---E--[]-------------------------------X-------------E-----------------------------
----[]------<>----XX---XXXXX-------------------------------------------[]------<>--[]------------------------------XXX------------------------------------------
----[]------[]----XXXXXXXX-------------------------------------B-------[]------[]--[]-----------------------------XXXXXX------XXXXXXXXXXXXXXX-------------------
-E--[]------[]-E--XXXXXX--------------------------X--------------------[]------[]--[]----XXXXX-XXXXXXXXXXXXXXXXXXXXXX--X--------X-------------------------------
XXXXXXX----XXXXXXXXXXX------XX-X------------------XXXXXXXXXXXXXXXXXXXXXXXXXXXXXXXXXXXXXXXXXXXXXXXXXXXXXXXXXXXXXXXXXXX--X--------X--------------XXXXXXXXXXXXXXXXX