----------------------------------------------------------------------------------------------------------------------------------------------------------------
----------------------------------------------------------------------------------------------------------------------------------------------------------------
----------------------------------------------------------------------------------------------------------------------------------------------------------------
--------------------------------------------------------------------------------SSSSS-----SSSSSS----------------------------------------------------------------
----------------------------------------------------------------------------------------------------------------------------------------------------------------
----------------------------------------------------------------------------------------------------------oo----------------------------------------------------
----------------------------------------------------------------------------------------------------------------------------------------------------------------
-------------------------------------QQ?-----------XX-----------------------------SSSS-X----SSSSS-XX--------XXXXX-----------------------------------------------
----------------------------------------------------------------------------------SSS-------SSSS---------------------------------------------------------------X
----------------------------------------------------------------------------------SS--------SSS---------------------------------------------------------------XX
-------------------------------------SSS---------------------------XX------------?S--------?SS--------XX-----------------------------------------------------XXX
------------------------------------------------------------------------------------------------------------------------------------------------------------XXXX
----------<>------------?-B--------------------------------------------------------------------------------------------------------------------------------XXXXX
----------[]--------------b---------------<>------------------------------------------------------------------------------------------XXEXXX--------------XXXXXX
----------[]E-----------------------------[]------------------------------------XXXXX-----XXXXXX---------------------------------------------------------XXXXXXX
XXXXXXXXXXXXXXXXXXXXXXXXXXXXXXXXXXX-------XXXXXXXX---XXXXXX-XXX---------X-------XXXXX--X--XXXXXX-----------------XXXXXXXXXXXXXXXXX---------------XXXXXXXXXXXXXXX