----------------------------------------------------------------------------------------------------------------------------------------------------------------
----------------------------------------------------------------------------------------------------------------------------------------------------------------
----------------------------------------------------------------------------------------------------------------------------------------------------------------
------------------------------------------------------------------------------------XXX-------------------------------------------------------------------------
------------------------------------------------------------------------------------[]--------------------------------------------------------------------------
------------------------------------------------------------------------------------[]--------------------------------------------------------------------------
----------------------------------SSS--------XXXX-----------------------------------<>--------------------------------------------------------------------------
--------------------XX-------------------------------------------------------E---------------------------------------------------------------XX-----------------
-------------------XXX----------------------------------------------------E-----S----E--------------------------------------------------------------------------
------------------XXXX--------------------------------------------------------------------------------------------------X---------------------------------------
-----------------XXXXX--------------X-----------------------------XEXX--------------------<>----------------------------XSSS------------------------------------
------------S---XXXXXX---------SSSSSX----------------------------------------------------X[]---------------------XX--------------------------------------------X
---------------XXXXXXX----------------------------------------------------------------<>XX[]--------------------XXXX------------------------------------------XX
--------------XXXXXXXX-----B----------------------------------------------------X-----[]XX[]-------------------XXXXXX-------------------X--------------------XXX
-------------XXXXXXXXX--------------------------------XXXXXXXXEEXX--------------X-----[]XXXXXXXXXXXXXXXXX-XXX-XXXXXXXXXXXXXXXXXXXXEXXXXXX-------------------XXXX
XXXXXXXXXXXXXXXXXXXXXXXXXXXXXXXXXXXXX-------------------------------------------X-----[]XXXXXXXXXXXXXXXXX-XXXXXXXXXXXXXXXXXXXXXXXXXXXXXXX--------XXXXXXXXXXXXXXX