----------------------------------------------------------------------------------------------------------------------------------------------------------------
----------------------------------------------------------------------------------------------------------------------------------------------------------------
----------------------------------------------------------------------------------------------------------------------------------------------------------------
----------------------------------------------------------------------------------------------------------------------------------------------------------------
-----------------------------------------------------------------------------------oo---------------------------------------------------------------------------
------------------------------------------------------------------------------------------ooooooooo-------------------------------------------------------------
------------------------------------------E-----------------XXXXX----------XXXXX--XXXX----XXXXXXXXXX------------------------------SSS---------------------------
-----------------------------------------<>---------------------------------------------------------------------------------------------------------------------
-----------------------------------------[]---------------------------------------------------------------------------------------------------------------------
-----------------------------------------[]--E------------------------------------------------------------------------------------X-----------------------------
-------------------------------X---------[]-------------------------------------------------------------XXXXXXXX------------------XEE------o--------------------
-S---------------------------------------[]---------------------------------------E--------------------------------XX-------------XSSSSS-----------S-----------X
-----------------------------------------[]--------------------------------------<>--------------------------------XXX----------------------------------------XX
----------------------X--------XX--<>----[]------X------------------XXXX---------[]--------------------------------XXXX------------------------B-------------XXX
----E-------E-EXXXXXXXX-------XXX--[]----XXXXXXXXX-XXXXX------------X-----------X[]XXXXXXXXXXXXXXXXXXXXX-----------XXXXX------------------------------------XXXX
XXXXXXXXXXXXXXXXXXXXXXX------XXXX--[]----XXXXXXXXX------------------X----------------------------------------------XXXXXXXX---XXXXXXXXXXXXXXXXXXXXXXXXXXXXXXXXXX