----------------------------------------------------------------------------------------------------------------------------------------------------------------
----------------------------------------------------------------------------------------------------------------------------------------------------------------
----------------------------------------------------------------------------------------------------------------------------------------------------------------
----------------------------------------------------------------------------------------------------------------------------------------------------------------
----------------------------------------------------------------------------------------------------------------------------------------------------------------
----------------------------------------------------------------------------------------------------------------------------------------------------------------
X----------------------oooo---------------------------------------------------------------------------------------------EE-E-E----------------------------------
XQQX-------------------XXXX-------------------------------------------------SSSSS----SQS-----------SSSS-----------------<><><>----------------------------------
X--X--------------------------------------------------------------------------------------------------------------------[][][]----------------------------------
X--X-----------------------------------------------------------------------------------------------------------------?--QQQQQQ------------XX--------------------
X--X-------------------------------------------------------------------------E---------------E-------------------------------------------XXX--------------------
XQQX--------------------------------<>--QQQ?-------------------------------SSSSSSS---S?S----<>--S--S----X---------B--------------X------XXXX-------------QQ-----
-------------XXXXXXXXX?-------------[]----------------E---------E------------------------------------E--XX--------b--------------X-----XXXXX--------------------
---E--------------------------------[]--------------------------X---------------------------------------XXX----------------------X----XXXXXX--------------------
----------------------------------E-[]-----B--------------------X---------------------------------------XXXXXXXXXXXXXX--XXXXXXXXXXXXXXXXXXXX--------------------
XXXXXXXXXXXX----------XXXXX-XXXXXXXXXXX-X-XXXXXXXXXXXXXXXXXXXX--XXXXXXXXXXXXXXXXXXXXXXXXXXXXXXXXXXXXXXXXXXXXXXXXXXXXXX--XXXXXXXXXXXXXXXXXXX--XXXXXXXXXXXXXXXXXXX