----------------------------------------------------------------------------------------------------------------------------------------------------------------
----------------------------------------------------------------------------------------------------------------------------------------------------------------
----------------------------------------------------------------------------------------------------------------------------------------------------------------
------------------------------------------------------------------------------------------------?---------------------------------------------------------------
----------------------------------------------------------------------------------------------------------------------------------------------------------------
-------------------------------------------------------------------------------------------------------------------------------o--------------------------------
--------------------------------------------S---------XXX--------------------------------------S------------------------------XXX-------------------------------
----E---X---------------------------------------------------SSS?SSSS----------XX--------------------------------------------------o------------------Q----------
-------XX-------------------------------E-------------------------------------XX--------------------------------E--o---o---o------XXXXX-------------------------
------XXX------------------------------<>-----------------------------B-----XXXX----------------------------------XXX-XXX-XXX-----------XX----------------------
-----XXXX-------------Q---------Q------[]-----------------------------b-----XXXX-------------XXXXX---XXX--------------------------------------------------------
---<>XXXX---------------------E--------[]----<>-------------SSSSSSSSSSXS--XXXXXX----------------------------------------------------------S--------S?SQSSSSSSSSS
---[]XXXX---------<>---------<>--------[]----[]---------------------------XXXXXX--------------------------------------------------------------------------------
--X[]XXXX---------[]---------[]--------[]----[]---------------------------XXXXXX--------------------------------------------------------------------------------
-XX[]XXXXXXXXXXXXXXXX-XXXXXXXXX-XXXXXXXXXXXX-XX---------------------------XXXXXX-----------------------XXXXXXXX---------------------------------X---------------
XXXXXXXXXXXXXXXXXXXXX-XXXXXXXXX-XXXXXXXXXXXX-XX-------------XXXXX-XXXXXXXXXXXXXXXXXXXXXXX---------------------X---XXXXXXXXXXXXXXXX------XXXXXXXXXXXXXXXXXXXXXXXX