----------------------------------------------------------------------------------------------------------------------------------------------------------------
----------------------------------------------------------------------------------------------------------------------------------------------------------------
----------------------------------------------------------------------------------------------------------------------------------------------------------------
----------------------------------------------------------------------------------------------------------------------------------------------------------------
----------------------------------------------------------------------------------------------------------------------------------------------------------------
----------------------------------------------------------------------------------------------------------------------------------------------------------------
-------------------------------------------------------oo-----------------------?-------------------------------------------------------------------------------
--------------------E---------------------------------XXXX--------------------------------------------------------------------------------------------XXX-------
-------------------<>--------------------------------------o--------------------------S--------------------------------------------E----------------------------
-------------------[]-------------------------------------XXX---------------------------------------------------------------------------------------------------
-------------------[]---------?----------------------------------------------XXEX----------------------------------------------------------------------------XXX
------<>-----------XXS----<>--------------------X---------------------------------------------------------------------------------------------XXXXXXXXX------XX-
------[]------------------[]--------------------X---------------------------------------------------------------------------------------------------------------
X-----[]------------------[]--------------------X--XXX---XXXXX------X-----------------X--------------X--------------------------------XXXXXXX-------------------
X-----[]-E----------------[]--------------------X----------------XXXX-XXXXX-----------X--XXEXEXXXXXXXX-----------E----------------------------------------------
XXXXXXXXXXXXXXXXXXXXXXXXXXXXXXXX-XXXXXXXXXXXXXXXX----------------XXXX-----------------X--XXXXXXXXXXXXX----XXXXXX--XX-XXX----------------------------------------