----------------------------------------------------------------------------------------------------------------------------------------------------------------
----------------------------------------------------------------------------------------------------------------------------------------------------------------
----------------------------------------------------------------------------------------------------------------------------------------------------------------
-------------------------------------------------------------------------?--------------------------------------------------------------------------------------
----------------------------------------------------------------------------------------------------------------------------------------------------------------
----------------------------------------------------------------------------------------------------------------------------------------E-----------------------
-------------------------------------------------------------------------XXXXXXX--------------------------Eoo-----------------------------XXXXXEXX--------------
----------SSS--S-------------------------------------------------S----------------XX----------------------XXXX------------XXX-----------------------------------
--------------------------------oo----------------------------------------------------------------------------------------XXX-----------------------------------
--------------------------------------------------------------------------------------------------------------------------XXX-----------------------------------
-------------------------------------------------E----------------------------------------------------------------XXX-----XXX---ooo-----------------------------
----------SSS--S------<>-----<>-------E--S------<>--------------SS------------------------XXX----XXX----XXXXXXXX----------XXX------oo-------------------------<>
----------------------[]-----[]------<>----------------------E------X----------------------------XX-----------------------XXX---------------------XXXX--------[]
----------------------[]-<>--[]-------------------------------------X-----------------------------------------------------XXX-----X---------------------------[]
----------------------[]-[]--[]-------------------------------------X------------------------------------------XXX--------XXX------XX-------------------------[]
XXXXXXXXXXXXXXXXXXXXXXXXXXX--XXXXXXXXXXXXXXXXXXXXXXXXXXXXXXXXXXXXXXXX-----------------------------------------------------XXXXXXXXX-X----------------------XXXXX