----------------------------------------------------------------------------------------------------------------------------------------------------------------
----------------------------------------------------------------------------------------------------------------------------------------------------------------
----------------------------------------------------------------------------------------------------------------------------------------------------------------
-----------------------------------------------------------------------------------------------------------?----------------------------------------------------
--------------------------------------------------------------------------------XXX-----------------------------------------------------------------------------
--------------------------------------------------------------------------------XXX-----------------------------------------------------------------------------
--------------------------------------------------------------------------------XXX------------XXXX-------XXXXXXX-----------------------------------------------
-----------------------------------XXX--------------------------XX------------S-XXX------------------------------------------------XX---------------------------
-----------------------------------XXX------------------------------------------XXX-----------------------------------S-----------------------------------------
-----------------------------------XXX------------------------------------------XXX-----------------------------------------------------------------------------
--------------------------------XX-XXX-------------------------------ooo-----S--XXX-----------------------------------------------------------------------------
--------------------SS---XX----XXX-XXX--X---------------------------------E-----XXX--------------------------------------XX-------------------------------------
---XXXXXXXX-------------XXX---XXXX-XXX--XX--------------------------------E-----XXX--------------------------------------XXX------------------------------------
-----------------------XXXX--XXXXX-XXX--XXX----X------------------------------E-XXX------------------------------o----X--XXXX----------------B--B---------------
----------------------XXXXX--XXXXX-XXX--XXXXXXXX--------------------------------XXX---XXXXXXXEXXXXXXXXEEX--------X----X--XXXXX---------E------------------------
XXXXXXXXXXXXXXXXXXXXXXXXXXX--XXXX--XXX--XXXXXXXX-----XXX-XXXXXXXXXXXXXXXXXXXXXXXXXX-----------------------------------X--XXXXXXXXXXXXXXXXXXXXXXXXXXXXXXXX-XXXX--