----------------------------------------------------------------------------------------------------------------------------------------------------------------
----------------------------------------------------------------------------------------------------------------------------------------------------------------
----------------------------------------------------------------------------------------------------------------------------------------------------------------
----------------------------------------------------------------------------------------------------------------------------------------------------------------
----------------------------------------------------------------------------------------------------------------------------------------------------------------
----------------------------------------------------------------------------------------------------------------------------------------------------------------
-------------------------------------------------------E-E------------------------------------------------------------------------------------------------------
------------XQQ?QQX----------------S----------E------SSSSSSSSSSS?SS?SS?SSS-------------------------------------------------------?SS----------------------------
------------X-----X-------------------------------------------------------------------XX------------------------------------------------------------------------
------------X-----X---------------------------------------------------------------------------------------------E-----------------------------------------------
------------XE-E--X---------------------ooo-------------------------------------------------------oo-----------<>--------------------<>-------------------------
-----<>-----XQQ-QQX----------------S----------------------E--SSSSSSSSSSSSS---XXXXXX----------------------------[]-------------Q------[]----E--S------------QQ---
-----[]-----------------------------------------------E--------------------------------------------------------[]-----------------B--[]----E----------B---------
-----[]-----------E------------------------------<>------------------------------------------------------------[]-----------------b--[]----------<>---b---------
-----[]------------------------------------------[]------------------------------------------------------------[]--------------------[]----------[]---BEE-------
XXXXXXXXXXXXXXXXXXXXXXXXXXXXXXXXXXXXXXXXXXXXXXXXXXXXXXXXXXXXXXXXXXXXXXXX-XXX-----------XXXXXXXXX-----XXXXXXXXXXXXXXXXXXXXXXXXXXXXXXXXXXXXXXXXXXXXXXXXXXXXXXXXXXX