----------------------------------------------------------------------------------------------------------------------------------------------------------------
----------------------------------------------------------------------------------------------------------------------------------------------------------------
----------------------------------------------------------------------------------------------------------------------------------------------------------------
---------------------------------------------------------------------------------------?------------------------------------------------------------------------
----------------------------------------------------------------------------------------------------------------------------------------------------------------
----------------------------------------------------------------------------------------------------------------------------------------------------------------
--------------SS----------------------------------------------------------------------S-------------------------------------------------------------------------
-----------------------------------XXX---------------------------------------------------------------------------------XX----------------------QQQQ--?----------
-----------------------------------XXX------------------------------------------------------oo-------------------------XX---------------------------------------
-------------o---------------------XXX-------------oo---------------------------------E------------------------------XXXX---------------------------------------
-------------XXX----------------XX-XXX------------------SSSSS--------------XXXX--XXXXXXXX----------------------------XXXX---------<>-----------E---------<>-----
-------------------------------XXX-XXX---------XXX--------------SS?------------------------------------------------XXXXXX---------[]-----------?QQQ--S---[]-----
------------------------------XXXX-XXX--------XXXX-------------------------------------------------------<>-----<>-XXXXXX---------[]---------------------[]-----
-----------------------------XXXXX-XXX-------XXXXX----------------S--------------------------------------[]-----[]-XXXXXX--<>-----[]------------------X--[]-----
--------------------XXXXXXXXXXXXXX-XXX------XXXXXX-------------------------------------------------------[]-----[]-XXXXXX--[]-----[]------------------X--[]-----
XXX-----------------XXXXXXXXXXXXX--XXXXXXXXXXXXXX---XXXXXXXXXXXXXXXX------------------------XXXXXXXXXXXXXXXXXXXXXXXXXXXXX--XXXXXXXXXXXXXXXXXXXXXXXXXXXX--XX-XXXX