----------------------------------------------------------------------------------------------------------------------------------------------------------------
----------------------------------------------------------------------------------------------------------------------------------------------------------------
----------------------------------------------------------------------------------------------------------------------------------------------------------------
-------------------------------------------------------------XXXX-----------------------------------------------------------------------------------------------
--------------------------------------------------------------[]------------------------------------------------------------------------------------------------
--------------------------------------------------------------[]------------------------------------------------------------------------------------------------
------------------------------------------------E-------------[]------------------------------------------------------------------o-----------------------------
--------------------------------------------SSSSSS------------[]---------------------------------------------------------------------------------E--------------
--------------------------------------------------------------[]------------------------------oo----------------------------------------------------------------
--------------------------------------------------------------[]------------------------------------------------------------------------------------------------
-----------------------SSSS---------------------------QQQQ?Q--<>-------XX---------------------------------------------------------------------------------------
---------------------------------------XSSS---SSSS-----------------------------------------<>-------------------------------------XXXXXXX---<>------------------
--X-----------------B-------<>----<>---X----------------------------------------E----------[]-----------------------------------------------[]-------------<>---
--X-----B-----------b-------[]----[]---X---------------------------------------<>----------[]-----------------------------------------------[]-------------[]E--
--X-------------------------[]----[]E-EX-------------XXXXEXEXXXXXXXX-----------------------[]-----------------------------------------------[]----------XXXXXXXX
XXXXXXXXXXXXXXXXXXXXXXXXXXXXXXXXXXXXXXXXXXXXXXXXXXX--XXXXXXXXXXXXXXX--------XXXXXXXXXXXXXXXXXXXXXXXXX-XXXXXXXXXXXXXXXXXXXXXX-X-----------XXXXXXXXX------XXXXXXXX