----------------------------------------------------------------------------------------------------------------------------------------------------------------
----------------------------------------------------------------------------------------------------------------------------------------------------------------
----------------------------------------------------------------------------------------------------------------------------------------------------------------
----------------------------------------------------------------------------------------------------------------------------------------------------------------
--------------ooo-----------------------------------------------------------------------------------------------------------------------------------------------
--------------XXXX----------------------------------------------------------------------------------------------------------------------------------------------
--------oo---------------XX-------------------------------------------o-------XXX-------------------------------------------------------------------------------
---XXXX--------------------------------XX-----------------------XXXXX------------------------S-----------------------------------XX---------------------------E-
--------------------------------------------------------------------------------------------------------------------------------XXX-----------------------------
-------------------------------------------------------------------------------------------------------------------------------XXXX---------------ooo---XXXX----
-------------------XXXX-----SSSSS-------------<>----------------------------------SSSSSSS-------------------------------------XXXXX---------------ooo-----------
---------XXXX---------------------------------[]------------------------?------------------QQQ-------------------------------XXXXXXS---Q------------------------
--------------XXXXXX--------------------------[]----------------------------------------------------------------------------XXXXXXX-----------------------------
----------------------------------------------[]----<>-----------------------o-------------------------------------B-------XXXXXXXX------------XXXXXXX----------
----------------------------------------------[]----[]-----------------------X-------------------------E-----------b------XXXXXXXXX------------X-------------ooo
XXXXXX----------------------XXXXXXXXXXXXXXXXXXXXX---[]------XXXXXXXX--X-----------XXXXXXXXXXXXXXXXXXXX--XXXXXXXXXXXXXXXXXXXXXXXXXXXXXXXXXX-----X-------------XXX