----------------------------------------------------------------------------------------------------------------------------------------------------------------
----------------------------------------------------------------------------------------------------------------------------------------------------------------
----------------------------------------------------------------------------------------------------------------------------------------------------------------
----------------------------------------------------------------------------------------------------------------------------------------------------------------
---------------------SS??SSSSSSSSSSSSSSSSSSSSSSSS????SSSSSSSSSSSSSSSSSSSSSSSSS-----------------------------E------E---------E-----------------------------------
-------------------SS-------------------------------------------------------------------------------------------------------------------------------------------
----------------SSS------------------------------------------------------------------------------------XXXEXXXXXXEXXXXXXXXXEXXX---------------------------------
----------------------------------------------------------------------------------------------------------------------------------------------------------------
----------------------------------------------------------------------------------S-----------------------------------------------------------------------------
----------------------------------------------------------------------------------------------------------------------------------------------------------------
---------SSSSSSS-----XXX----------------XXXXXXXXXXXX----------------------------------------------XXXXEXXEEXXXEXEEXXXXXXEXEEXXX---------------------------------
--------------------XXXX---------------XXXXXXXXXXXXX-------<>-------------QQQQ---------------------------------------------------------------------------<>-----
-------------------XXXXX--------------XXXXXXXXXXXXXX-------[]--------------------------------------------------------------------------------------------[]-----
-----B------------XXXXXX---XXXXX-----XXXXXXXXXXXXXXX-------[]---------------------X--------------------------------------------------------<>------------[]-----
-----------------XXXXXXX----------XXXXXXXXXXXXXXXXXX-------[]---------------------X--XXXXEEXEEXEXX-----------------------------------------[]------------[]-----
XXXXXXXXXXXXXXXXXXXXXXXXX---------XXXXXXXXXXXXXXXXXXX----XXXXXXXXXXXXXXXXXXXXX----X------------------------------------------------------XXXXXXXXXXXXXXXXXXX----