----------------------------------------------------------------------------------------------------------------------------------------------------------------
----------------------------------------------------------------------------------------------------------------------------------------------------------------
----------------------------------------------------------------------------------------------------------------------------------------------------------------
--------------------------------S?SSSSSSSSSSSSSSSSSSSSSSSSSSSSSSSSSSSSSSSSSSSSSSSSSSSSSSSSSSSSSSSSSSSSSSSSSSSSSSSSSSSSSSSSSSSSSSSSSSSSSSSSSSSSSSSSSSSSSSSSSSSSSS
---------------------------SSSS---SSSSS----[]---------------------------------------------------------------------------------------------------------------SSSS
-------------------------SS-------SSSSS----[]------E--------------------------------------------------------------------------------------------------------SSSS
----------------------SSS------S--SSSSS----[]---QQQQQ-------------------------------------------------------------------------------------------------------SSSS
-------------------------------------------[]--------------SSSSSSSSSSSSSSSSSSSSSSSSSSSSSSSSS------SSSS----------------------------------------------------------
-------------------------------------------[]--------------SSSSSSSSSSSSSSSSSSSSSSSSSSSSSSSSS--SSS-SSSS--SSS-----------------------------------------------------
---------------------S--------<E-----------[]--------------SSSSSSSSSSSSSSSSSSSSSSSSSSSSSSSSS--SSS-SSSS--SSS-----------------------------------------------------
----------oo---------------XXX[>---<><>----[]---SSSSSSSSS--SSSSSSSSSSSSSSSSSSSSSSSSSSSSSSSSS--SSS?SSSS--SSS?SS?SSSSSSSSSSSSSSSSSSSSSSSSSSSSSSSS?????????????SSSS
---X--------------<>------XXXX[]---[][]----<>---SSSSSSSSS-----------------------------------------------------SSSSSSSSSSSSSSSSSSSSSSSSSSSSSSSSSSSSSSSSSSSSSS----
---X--------------[]-----XXXXX[]---[][]---------SSSSSSSSS-----------------------------------<>--------<>------SSSSSSSSSSSSSSSSSSSSSSSSSSSSSSSSSSSSSSSSSSSSSS----
---X--------------[]----XXXXXX[]---[][]---------SSSSSSSSS-----------------------------------[]--------[]--------------------------------------------------------
---X--------------[]---XXXXXXXXXXX-XXXXXXXXXXE--XXXXXXXXXXXXXXXXXXXXXXXXXXXXXXXXXXXXXXXXXXXXXXXXXXXXXXXXXXXXXXXX-XX-XX-XX-XX-XX-XX-XX-XX-XX-XX-XXXXXXXXXXXXXXXXX
XXXXXXXXXXXXXXXXXXXXXXXXXXXXXXXXXX-XXXXXXXXXXX--XXXXXXXXXXXXXXXXXXXXXXXXXXXXXXXXXXXXXXXXXXXXXXXXXXXXXXXXXXXXXXXX-XX-XX-XX-XX-XX-XX-XX-XX-XX-XX-XXXXXXXXXXXXXXXXX