----------------------------------------------------------------------------------------------------------------------------------------------------------------
----------------------------------------------------------------------------------------------------------------------------------------------------------------
----------------------------------------------------------------------------------------------------------------------------------------------------------------
----------------------------------------------------------------------------------------------------------------------------------------------------------------
-----?----------------------------------------------------------------------------------------------------------------------------------------------------------
----------------------------------------------------------------------------------------------------------------------------------------------------------------
--------------------------------------------------------------------------------------------------------------------------------XX------------------------------
-----------------E----------------------------E-------Q-Q-Q-Q-Q-Q-Q-Q-Q-Q-Q-Q-Q-Q-Q-------------------Q-----------XXX------------------------------------E------
-------SS-----E-----------------------------------------------------------------------------------------------------------------------------------------<>------
--------------------------------------------------------------------------------------------------------------------------------------------------------[]------
---SS------XSSSSSSSSSSSSSSSSSSSSSSSSSSSSSSSSSS------------------------------------------------------------oo--------------XXXXXXXX----------------------[]------
----------XX------------------------------------------Q-Q-Q-Q-Q-Q-Q-Q-Q-Q-Q-Q-Q-Q-Q-------------------?-----------------E------------------------------SXXX-----
---------XXX----oooooooooooooooooooooooooooo------------------------------------------------------<>------------------------------------------------------------
--------XXXX--------------------------------------------------------------------------------------[]------------------------------------------------------------
-------XXXXX----oooooooooooooooooooooooooooo------------------------------------------------------[]---------------------------------X--------------------------
XXXXXX-XXXXXXXXXXXXXXXXXXXXXXXXXXXXXXXXXXXXXXX----XXXXXXXXXXXXXXXXXXXXXXXXXXXXXXXXXXXXXXXXXXXXXXXXXXXXXXXXXXXXXXX--------------------XXXXXXXXXXXXXXXXXXXXXXXXXXX