----------------------------------------------------------------------------------------------------------------------------------------------------------------
----------------------------------------------------------------------------------------------------------------------------------------------------------------
----------------------------------------------------------------------------------------------------------------------------------------------------------------
----------------------------------------------------------------------------------------------------------------------------------------------------------------
----------------------------------------------------oo----------------------------------------------------------------------------------------------------------
----------------------------------------------------------------------------------------------------------------------------------------------------------------
-------------------------------------------------------XXXXXXX-------------------------------------------------------------------------------------------XXXXXXX
------SSS-----------------XX-----------E-------------------------XXX-------E---------------E---------XX------------------------------------------XXXX-----------
-----------------------------------------------------------------XXX----------------E-----------------------------oo--------------------------------------------
-----------------------------------------------------------------XXX------------------XXX----------------------------------------XSS--o-------------------------
--------------------------------------------------XXXXX----------XXX------------------------------------------------------------XXX----------------------XXX----
-------E---------------------------------------------------------XXX-------------------------XXX-------------------------------XXXX-SS--------------------------
-------E---------XXX---------------------------------------------XXX----------------------------------------------------------XXXXX-----------------------------
-------------------X-------------XXXXX---------------------------XXX-----------<>--------------------------------------------XXXXXX--SSS------------------------
-------------------X-------------X----------XXXEXX---------------XXX-----------[]---------ooo-------------------------E-----XXXXXX------------------------------
XXXXXXXXXXXXXXX----X-X-----------X-------------------------------XXXXX-----X---XX---------XXX---------------------XXXXXXXXXXXXXXXX------XXXXXXXXXXX-------------