----------------------------------------------------------------------------------------------------------------------------------------------------------------
----------------------------------------------------------------------------------------------------------------------------------------------------------------
----------------------------------------------------------------------------------------------------------------------------------------------------------------
----------------------------------------------------------------------------------------------------------------------------------------------------------------
-----------------------------SSSSSSSSSSSSSSSSSSSSSSSSSSSSSSSSSSSSSSSSSSSSSSSSSSSSSSSSSSSSSSSSSSSSSSSSSSSSSSSSSSSSSSSSSSSSSSSSSSSSSSSSSSSSSSSSSSSS?SSSSSSSSSSSSSS
----------------------------------SSSSSS--SSS--SSSSSSSSSSSSSSSSS--SSSSS--SSSS----SS--SSSSSS--SSSS----SS--SSSSS--SSSSSSS--SSSSS--SSSSSSSS--SSSS----SS--SSSSS--SSS
----------------------------------SSSSSS--SSS--SSSSSSSSSSSSSSSSS--SSSSS--SSSS--E-SS--SSSSSS--SSSS--E-SS--SSSSS--SSSSSSS--SSSSS--SSSSSSSS--SSSS--E-SS--SSSSS--SSS
----------------E---------------------SS----------------------SS-----SS---S----SS--------SS---S----SS-------SS-------SS---------------SS---S----SS-------SS---S-
---------------SSSS-------------------SS----------------------SS-----SS---S----SS--------SS---S----SS-------SS-------SS---------------SS---S----SS-------SS---S-
--------------------------------------SS----------------------SS-----SS---S----SS--------SS---S----SS-------SS-------SS---------------SS---S----SS-------SS---S-
-----------X-E--E-----------------ooooSS-------oooooooooooooooSS---ooSS---So??-SS----ooooSS---So??-SS----oooSS---ooooSS---------ooooooSS---So??-SS----oooSS---So
-----------XS?SSSSS---X-----------SSSSSS---SS--SSSSSSSSSSSSSSSSS--SSSSS---SSS--SSSS--SSSSSS---SSS--SSSS--SSSSS--SSSSSSS--SSSSS--SSSSSSSS---SSS--SSSS--SSSSS---SS
-E-----------------EE-X--------------------SS------------------------------------SS------------------SS------------------SSSSS--------------------SS------------
<>------X--SSSSSSSSSSSX--------------------SS------------------------------------SS------------------SS------------------SSSSS--------------------SS------------
--------X-------------------------------------------------------------------------------------------------------------------------------------------------------
XXXXXXXXXXXXXXXXXXXXXXXXXXXXXXXXXXXXXXXXXXXXXXXXXXXXXXXXXXXXXXXXXXXXXXXXXXXXXXXXXXXXXXXXXXXXXXXXXXXXXXXXXXXXXXXXXXXXXXXXXXXXXXXXXXXXXXXXXXXXXXXXXXXXXXXXXXXXXXXX