----------------------------------------------------------------------------------------------------------------------------------------------------------------
----------------------------------------------------------------------------------------------------------------------------------------------------------------
----------------------------------------------------------------------------------------------------------------------------------------------------------------
----------------------------------------------------------------------------------------------------------------------------------------------------------------
-----------------------------------------------------------------------------------------------?----------------------------------------------------------------
----------------------------------------------------------------------------------------------------------------------------------------------------------------
--------------------------------------------------------------------------XXXXXXXXX----------------?----XXXXX-------------------------------------o-oo----------
------E-----------------------------------------------------XXX------XX---------------oooo---XXX--------------------------------------XXXXXXXXXXX---------------
-----SSSS---------------------------------------------------XXX-----------------------o--o----------------------------------------------------------------------
------------------------------------------------------------XXX-------------------------------------------------------------------------------------------------
-X-E--E----------XXXX------------------------------------XX-XXX--------------------------XXXXXXXXXEX--------------------------o---------------------------------
-XS?SSSSS---X-------------------------------------------XXX-XXX------------------------------------------------------------------XXXXX-----------------?--------
---------EE-X------------------------------------------XXXX-XXX--------------------XXX-------------------------------------------XX-----------------------------
-SSSSSSSSSSSX------------X----------------------------XXXXX-XXX-----------------------------------------------------<>--<>--------------------------------------
------------X-------X----XX--------------------------XXXXXX-XXX-----------------------------------------------------[]--[]--------------------------------------
XXXXXXXXXXXXX------------XXXXXXXXXXXXXXXXXXXXXXXXXXXXXXXXX--XXXXXXXX----------------------------------------------XXXXXXXXXXX---------XXXXXXXXXX--XXXX------XXXX