----------------------------------------------------------------------------------------------------------------------------------------------------------------
----------------------------------------------------------------------------------------------------------------------------------------------------------------
-------------------------------------------------------------------------------------------------------SXXXX----------------------------------------------------
---------------------------------------------------------------------------------------------------------[]-----------------------------------------------------
---------------------------------------------------------------------------------------------------------[]-----------------------------------------------------
---------------------------------------------------------------------------------------------------------[]-----------------------------------------------------
--------------------------------------------------------------------XXX----------------------------------[]-----------------------------------------------------
----------QQQQ-----------------------------------------------------XXXX---------------------E------------[]-----------------------------------------------------
-----------------------oooo---------------------------------------XXXXX--------------------<>--EE--------[]----------------E------------------------------------
-----------------------------------------------------------------XXXXXX-----------------X--[]--<>--------<>--------------------------------------QQQQ-----------
---------------------------------------------S?S----------------XXXXXXX--------------------[]--[]---------------------------------------E-----------------------
--QQ----QQ?SSQQQQ---<>--------------Q--------------------------XXXXXXXX--------------------[]--[]--------------------------------------<>-X--------E------------
--------------------[]----------------------------------------XXXXXXXXX------------X-------[]--[]------------------------------E-------[]-X---------------------
--------------------[]---------------------------------------XXXXXXXXXX------------X-------XXXXXXXXXXXXXXXXXXXXXXXXXXXXXXXXXXX<>XXXXXXXXXXX-XXXXXXXXXXXXXXXXEXXX
--------------------[]------------------XXXXXXXXXXXXXXXXXXXXXXXXXXXXXXXXXXXXXXX----X-------XXXXXXXXXXXXXXXXXXXXXXXXXXXXXXXXXXX[]XXXXXXXXXXX-XXXXXXXXXXXXXXXXXXXX
XXXXXXXXXXX--XXXXXXXXXXXXXXXXXXXXXXXXX<>------------------------------------------------------------------------------------------------------------------------