----------------------------------------------------------------------------------------------------------------------------------------------------------------
----------------------------------------------------------------------------------------------------------------------------------------------------------------
----------------------------------------------------------------------------------------------------------------------------------------------------------------
-------------------------------------------------------------------------------------------------------------------------?--------------------------------------
-------------------------------------------------------------------------------------------------------------------------------------------------SSSSSSSSSSSSSSS
------------------------o------------------------------------------------------------------o--------------------------------------------------------SSSSSSSSSSS-
------------------------------------------------------------------------------------------XXX---------------------------S----X---XX----XX-----------SSSSSSSSSSS-
---------XX--------S--SSS-------------------------------SSSSSSSSSSSSSSSSSSSS------------------o----------o-o----------------------------------SSS------------SS-
--------XXX-----------------------------------------------------------------------oo----------XXXXXXXXXX-----------------------oooooo--------o---------------SS-
-------XXXX-----------------------------------B----B---------------------------------------------------------------------------oooooo--------SS--------------SS-
------XXXXX-----------------------------------b----b------SSSSSSSSSSSSSS---------------------------------XXXXXEXXXXXXXXXXXX---------E--------S-S----oooooooooSS-
-----XXXXXX-------SS---S--------------------SSXSSSSXSS--SS---------------------<>--------------------------------------------------<>-----------S---SSSSSSSSSSS-
----XXXXXXX--------------------------------------------------------------------[]----------------------------------------------E---[]---------------------------
---XXXXXXXX--------------------------------------------------------------------[]----------------------XX---------------------<>---[]---------------------------
--XXXXXXXXX-------------E-----------------------------------E--E--E--E---EE----[]---------------------------------------------[]---[]---------------------------
XXXXXXXXXXXXXXXXXXXXXXXXXXXXXXXXXXXXXXXXXXXXXXXXXXXXXXXXXXXXXXXXXXXXXXXXXXXXXXXXXXXXXXXXXXXXXX--------------------------------[]---[]--------XXXXXXXXXXXXXXXXXXX