----------------------------------------------------------------------------------------------------------------------------------------------------------------
----------------------------------------------------------------------------------------------------------------------------------------------------------------
----------------------------------------------------------------------------------------------------------------------------------------------------------------
-----------------------------------------S------------------------------------------------------------------------------------------------------------SSSSSSSS--
----------------------------------------------------------------------------------------------------------------------------------------------------------------
-----------------------------------------------------------------------------------oo---------------------------------------------------------------------------
---------------------------------------XXXX-----------------------?----------------oo---------------------------------------------------------------------------
---E-----------E-----------------------XXX--------------------------------------------?SSSS-SSSSS-------------------------------------------------------SSSSSSS-
-------------------------------------------------XXXX-------------E-------------------------------------------------------------------------------------SSSSSS--
-----------E--------------------------------------------------------------------------------------------------------------------------------------------SSSSS---
--------------------------------------------------------------------------------------?-----------------------X--------B------------------XSS-SQ-------?SSSS----
-------oo--------------------------------------------------E-----------------------------------------<>------XX--------b-----------------XXX--------------------
-------oo-------------------------------------------------<>-----------------------------------------[]-----XXX---?-B-------X-----------XXXX--------------------
--------------------------------------XX------------------[]-----------------------------------------[]-<>-XXXX-----b-------X----------XXXXX--------------------
XXXXXXXXXXXXXXXXXXXXXEXEXEXEX---------XXXXXXXXX----------X[]X---------XXXXXXXXXXX--------------------[]-[]XXXXX-------------X---------XXXXXX--SSSSS---XXXXXXXX--
XXXXXXXXXXXXXXXXXXXXXXXXXXXXX---X-----XXXXXX------------------------------------------XXXX-------X---XXXXXXXXXXXXXXXXXXXXXXXXXX-XXXXXXXXXXX-------XX--XXXXXXXX--