----------------------------------------------------------------------------------------------------------------------------------------------------------------
----------------------------------------------------------------------------------------------------------------------------------------------------------------
----------------------------------------------------------------------------------------------------------------------------------------------------------------
----------------------------------------------------------------------------------------------------------------------------------------------------------------
----------------------------------------------------------------------------------------------------------------------------------------------------------------
-----------------------------------------------------------------------------------------------o----------------------------------------------------------------
--------------------------------------------------------------------------------------SS----XXX-o------------------------------------------XXXEXX---------oo-o--
-------------------------------------------------------------------------ooo-------------------------------------------------------oooo-------------------------
-------------------------------------------------------------------------o-----------------------oo-------------------------------------------------------------
---------------------------------------------------------ooo-------------------------o--------------------------------------------------------------------------
-<>--------------------------------S----------------oooo-ooo-------------------------XXXX-----------------------------XSS-SQ-----------------------S------------
-[]-------------------Q---------------------XXX-----oooo--------------------XXXXX------------------------------------XXX-----------------------------------XXX--
-[]-----------------------------------------XX-----------------------XXXX------------------------------------------EXXXX----------XX--XX------------------------
-[]----------------------------------------------XXXXXEXXXXXXXEXXX-------------------------------------------------XXXXX----------------------------------------
-[]---------------------------------------E------XX---------------------------------------------------------------XXXXXX--SSSSS----------------------XX---------
XXXXXXXXXXXXXXXXXXXXXXXXXXXXXXXXXXXXXXXXX--------XX-----------------------------------------XXXXXXXXXXXXXXXXXXXXXXXXXXX-------XX---------------------X----------