----------------------------------------------------------------------------------------------------------------------------------------------------------------
----------------------------------------------------------------------------------------------------------------------------------------------------------------
----------------------------------------------------------------------------------------------------------------------------------------------------------------
----------------------------------------------------------------------------------------------------------------------------------------------------------------
-------------------------------------------------------------------------SSSSSS---------------------------------------------------------------------------------
-------------------------------------------------------------------------SSSS-----------------------------------------------------------------------------------
---------o-ooo-------ooo--ooo-ooo----------------------------------------SSSS-----------------------------------------------------------------------------------
---------------------ooo---------------------------------XX--------------SSSSS----------------------E-----------XX---------------------------------E------------
--------------------------------------------------------------------------------XXX-----------------------------XX----------------------------------------------
------------XX-----------------XX-------------------------------------------------------------------------------XX----------------------------------------------
--------------------------------------------------------------------------o-----------------o----------------XX-XX------oo----o----------------SSSS----XX-------
----XXX-----------E----XX-------------------oooo--XXXXX-----XX-----------S?S?SS-----------------------------XXX-XX----------------------------------------------
-------------------------------------------------------------------------SSS-------------------------------XXXX-XX----------------------------------------------
---------------XXXXX--------------XXXX------------------------------X----SS-------------------------------XXXXX-XX-----------------B--------<>------------------
-------------------X--------------------XXXXXXXX--------------------X------E------------------------------XXXXX-XX--------------------------[]------------------
X-XX-----XXXX------X--------XXXX---------------X--------------------XXXXXXX-XXX-------XXXXXXXXXXXXXXXXX---XXXX--XXXXXX-----XXXXXXXXXXXXXXXXXXXXXXXX------XXXX---