----------------------------------------------------------------------------------------------------------------------------------------------------------------
----------------------------------------------------------------------------------------------------------------------------------------------------------------
----------------------------------------------------------------------------------------------------------------------------------------------------------------
--------------------------------------------------------------------------------------------ooo-----------------------------------------------------------------
--------------------------------------------------------------------------------------------o-o-----------------------------------------------------------------
----------------------------------------------------------------------------------------------------------------------------------------------------------------
--------------------------------------------------------------------------------------------XXX------------------------------------E----------------------------
---SSSS--SQS----------------------------?---SSSSS?SSS-----E-----------------------------------------------------------------------SQS----SSSSSSSSSSSSSSSSSS-----
---------------------------------------------------------<>----------------------------------------------------------------------------E------------------------
---------------------------------------------------------[]-----------------------------------------------------------------------------------------------------
-----------------oooooooo-------Q------------E-----------[]----------------------XXXXXXXX-----------------------------------------------------------------------
----------S--------------o-----------------SSSSSSSSSS----XXX------------XXXX------------------------------------------------------SQS--<>--------------SSS------
--------------------------------------E--------------------------------XXX---------------------------------------Q?-B------------------[]-----------------------
----------------------------------------------------------------------XXX-------------------------------------------b---------X--------[]-----------------------
---------------------------------------------------------------------XXXX----------------------------X------------------------X-E------[]---------X-------------
XXX----XXXXXXXXXXXXXXXXXXXXXXXXXXXXXXXXXXXXXXXXXXXX-XXXXXXXXXXXXXXXXXXXXX----------------------------XXXXXXXXXXXXXXXXXXXXXXXXXXXXXXXXXXXX---------XXXXXXXXXXXXXX