----------------------------------------------------------------------------------------------------------------------------------------------------------------
----------------------------------------------------------------------------------------------------------------------------------------------------------------
----------------------------------------------------------------------------------------------------------------------------------------------------------------
-------------------------------------------?--------------------------------------------------------------------------------------------------------------------
---------------------------------oo--------------oo-------------SSSSSSSSS--[]SSSSSSS----------------------------------------------------------------------------
---------------------------------------------------------------------------[]SSSSSSS----------------------------------------------------------------------------
---------XX-----------XXXXXX----XXXX------S-----XXXX-----XX----------------[]SSSSSSS----------------------------------------------------------------------------
-------------------------------------------------------------SSS-----------[]SSSSSSS----XX----------------XXXX--------------------------------------Q-----------
---------------------------------------------------------------------------[]SSSSSSS---------------------XXXXX--------------------------------------------------
-------------------------------------------------------------S-------------[]SSSSSSS--------------------XXXXXX--------------------------------------------------
--------------XX----------------------XXXXXXX---------------S-S-------------]SSSSSSS------XXXX---------XXXXXXX--------------------------Q-----------------------
--------------------------------E---------------E--------------S------------]SSSSSSS-------------------XXXXXXX-----------------------Q-E------------?----QQQQ---
-------------------------------<>--------------<>---------------------SSSSSSSSSSSSSS-----------------XXXXXXXXX-------------------------E--------<>--------------
-------------------------------[]--------------[]---------------------SSSSSSSSSSSSSS----------------XXXXXXXXXX----------------------------------[]--------------
------------------------------X[]XXXXX--------X[]XXXXXX---------------SSSSSSSSSSSSSS-------------------XXXXXXX----------------------------------[]--------------
XXXXX-------------------------------------------------------XXXXXXXX--XXXXXXXXXXXXXX---------XXXXXXXXXXXXXXXXXXXXXXXXXXXXXXXXXXXXXXXXXXXXXXXXXXXXXXXXXXXXXXXXXXX