----------------------------------------------------------------------------------------------------------------------------------------------------------------
----------------------------------------------------------------------------------------------------------------------------------------------------------------
----------------------------------------------------------------------------------------------------------------------------------------------------------------
-------------------------------------------------SS-------------------------------------------------------------------------------------------------------------
-------------------------------------------------[]------------oo------------?----------------------------------------------------------------------------------
-------------------------------------------------[]-------------------------------------------------------------------------------------------------------------
--------------------------------SSS-----E--------<>-----------XXXXXX--------------------------------------------------------------------------------------------
---------------------------------------SQS-----------------------------------XX---------------------------E-----------------------------------------------------
--------------------------------------------------E----------------------------------------------------E--------------------------------------------------------
--------------------------------X-------------------------------------------------------------------------------------------------------------------------------
-----------oooo---Q-------------XEE-------------<>----------------------E---------------------------XSSSSSSSSS--------------------------------------------------
-------<>-----------------------XSSSS--SQS------[]------------E-------XXX-----------------Q?-------XX-----------<>------------XX--------------------------------
-------[]---------------------------------------[]-----X-X---<>-----------------------------------XXX----oo-----[]----------------------------------------------
-------[]---------------------------------------[]-----X-X---[]----------------------------------XXXX-----------[]---------------------------------------<>-----
-------[]-----------------------------------EEXXXXXXXXXXXX--X[]XXXXX----------------XXXXXXXXXXXXXXXXX----oX-----[]---------------------------------------[]-----
XXXXXXXXXXXXX-XXXXXXXXXXXXXXXXXXXXXXXXXXXXXXXXXXXXXXXXXXXX--------------------------XXXXXXXXXXXXXXXXXXXXXXXXXXXXXXXXXXXXXXXXX------XXXXXXXXXXXXXXXXXXXXXXXXXXXXX