----------------------------------------------------------------------------------------------------------------------------------------------------------------
----------------------------------------------------------------------------------------------------------------------------------------------------------------
----------------------------------------------------------------------------------------------------------------------------------------------------------------
----------------------------------------------------------------------------------------------------------------------------------------------------------------
----------------------------------------------------------------------------?-----------------------------------------------------------------------------------
----------------------------------------------------------------------------------------------------------------------------------------------------------------
-------------oo-------------------------------------------------------------------------------------------------------------------------------------------------
-----------------------SSSSSQS-------------XXXX------?-------------------------------XX------XSSSSS----------------SSSS------------------------------SSSSS?SSS?S
------------------------------------------------------------------------------SS----XXX------X------------------------------------------------------------------
-----------------------------------------------------------------------------------XXXX------X------------------------------------------------------------------
--------------------------------------------------------------------------SS------XXXXX-----EX--E-X---------------------------------------------------E---------
---------------------X?---SS?S-----------------------S---------------------------XXXXXX------XSS?SX--------S-------S----------------------Q---------SSSSSSSSSSSS
--------------------XX---------------------------<>-----------------------------XXXXXXX------------------E------------------------------------------------------
-------------------XXX---------------------------[]---X----------------<>------XXXXXXXX-------------------------------------------------------------------------
-----------E-E----XXXX---------------------------[]E--X----------------[]-----XXXXXXXXX-----------------------------EE------------------------------------------
XXXXXXXXXXXXXXXXXXXXXXXXXXXXXXXXXXXXXXXXXXXXXXXXXXXXXXX--XXXXXXXXXXXXXXXXXXXX-XXXXXXXXXXXXXXXXXXXXXXXXXXXXXXXXXXXXXXXXXXXXXXXXXXXXXXXXXXXXXXXXXXXXXXXXXXXXXXXXXX