----------------------------------------------------------------------------------------------------------------------------------------------------------------
----------------------------------------------------------------------------------------------------------------------------------------------------------------
----------------------------------------------------------------------------------------------------------------------------------------------------------------
----------------------------------------------------------------------------------------------------------------------------------------------------------------
----------------------------------------------------------------------------------------------------------------------------------------------------------------
----------------------------------------------------------------------------------------------------------------------------------------------------------------
------------------------------------------------------------oo--------------------------------------------------------------------------------------------------
-----------------------------------------------------------XXXX-------------------XXoo--------------------------------------------------------------------------
----------------------------------------------------------------o-----------------------------------------------------------------------------------------------
---------------------------------------------------------------XXX----------------------------------------------------------------------------------------------
--<>----------------------XSS-S---------------------------------------------------------------------------------------------------------------------------------
--[]---------------------XXX-------------------------------------------------XXXXX----XXXXX-------------------------------------------------S----<>-------------
--[]-----------E--------XXXX------------<>---------------------------------------------------------------------<>-------------Q?QQQQQQQQQ------<>[]-------------
--[]-------------------XXXXX------------[]----------X---XXX---XXXXX----------------------------------XXXXXXXX--[]------------------------------[][]---------<>--
--[]------------------XXXXXX--XXXXXXXXXXXXXXXXXXXXXXX-----------------------------------------XXXX----------X--[]------------------------------[][]---------[]--
XXXXXXXXXXXXXXXXXXXXXXXXXXX----XXXXXXXXXXXXXXXXXXXXXX-----------------XXXXXXX-------------------------------X--[]XXXXXXXXXXXXXXXXXXXXXXXXXXXXX-XXXXXXXXXXXXXXXXX