----------------------------------------------------------------------------------------------------------------------------------------------------------------
----------------------------------------------------------------------------------------------------------------------------------------------------------------
----------------------------------------------------------------------------------------------------------------------------------------------------------------
----------------------------------------------------------------------------------------------------------------------------------------------------------------
----------------------------------------------------------------------------------------------------------------------------------------------------------------
----------------------------------------------------------------------------------------------------------------------------------------------------------------
-------------------------------------------------------------------------------------------------------------XXXXX----------------------------------------------
----------------------------------------------XSSSSS------------E---------------------------------------------------------------E-------------------Q-----------
----------------------------------------------X----------------SSSS------------oo-------------------------------------------------------------------------------
----------------------------------------------X---------------------------------------------------------------------------------------XSS--o--------------------
------------------------------?--------------EX--E-X-------X-E--E-----------------------------------------------------------XX-------XXX------------------------
--------------------------<>------------------XSS?SX-------XS?SSSSSS--X-----<>--------------------------------------XXX---E---------XXXX-SS-------S?SQS-------QQ
---------------------X----[]----------------------------X-----------E-X-----[]---------------------B--------------------------------XXXX------------------------
--B------------------X----[]----------------------------X--SSSSSSSSSSSX-----[]---------------------b--------------------------------XXXX--SSS-----------------E-
--b------------------X-E--[]----------------------------X-------------------[]---------------------BEE------------------------------XXXX------------------------
XXXXXXXXXXXXXXXXXXXXXXXXXXXXXXXX<>XXXXXXXXXXXXXXXXXXXXXXXXXXXXXXXXXXXXXXXXXXXXXXXXXXXXXXXXXXXXXXXXXXXXXXXX--------------------------XXX------XXXXXXXXXXXXXXXXXXX