----------------------------------------------------------------------------------------------------------------------------------------------------------------
----------------------------------------------------------------------------------------------------------------------------------------------------------------
----------------------------------------------------------------------------------------------------------------------------------------------------------------
----------------------------------------------------------------------------------------------------------------------------------------------------------------
----------------------------------------------------------------------------------S------------------------------------S------------SSSSSSSSSSSSSSSSSSSSSSSSSSSS
------------------------------------------------------------------------------------------------------------------------------------SSSS----------------------SS
------------------------------------------------------------------E---------------------------------------------------S-------------SSSS----------------------SS
--------------------------------------------------XX------------SSSSSSSSSSSSSSSSSSS--------------------------S---------S-------------SSS-------------oooo-------
--------------------------------------------------XX------------------------------------------------------------------------------------------------------------
--------------------oo----------------------------XX-----------E-----------------------------------------------------S-------------------------------SSSS-S-----
--------?---oo---------------------------------XX-XX----ooo---------------------------S-----oo----------------------------------------E------------SoS--SoS---oo
----<>----------------------------------------XXX-XX---------S?S----------------------SS--------------------------<>-----------------<>-------E-----SS--SSS---SS
----[]----------------------------------X----XXXX-XX---------------------------------------------------------<>---[]-----------------[]------<>-----------------
----[]--------------------------B-------X---XXXXX-XX---------------------------------------------------------[]---[]-----------------[]------[]---X-------------
----[]-----------XX---------------------X--XXXXXX-XX---------------------------------------------------------[]-E-[]-----------------[]------[]-E--E------------
XXXXXXXXXX-----X-----XXXXXXXXXXXXXXXXXXXXXXXXXXX--XXXXXXXXXXXXXXXXXXX------------XXXXXXXXXXXXXXXXXXXXXXXXXXXXXXXXXXXXXXXXXXXXXXXXXXXXXXXXXXXXXXXXXXXXXXXXXXXXXXX