------------------------------------------------------------------XXXXXXXXXXXXXXXXXXXXXXXXXXXXXXXXXXXXXX---------XXXXXXXXXXXXXXXXXXXXX---------------XXXX----X--
----------------------------------------------------------------------------------------------------------------------------------------------------------------
----------------------------------------------------------------------------------------------------------------------------------------------------------------
----------------------------------------------------------------------------------------------------------------------------------------------------------------
-SSSSSSSSS------------------------------------------------------------------------------------------------------------------------------------------------------
----------------------------------------------------------------------------------------------------------------------------------------------------------------
------------XXX-------------------------------------------------------------------------------------------------------------------------------------------------
--------------------------------------------------------------EXX<>---------------------------------------------------------------------------------------------
------------------------------------------------XSSS---------EXXX[]------E---------------------------XX-------XX----------------------------XXXXXX--XX----------
-----------------------------------------------XXX----------EXXXX[]---------------------------------XXX---------------------------------------------XX----------
----------------------------------------------XXXS-------X--XXXXX[]--------------------------------XXXX---------------------------------------------XX----------
--------XXX-------XX-------------------------XXXXX---------XXXXXX[]-------------------------------XXXXX---XX-----------------o----------------------XX----------
-------EXXX-XXX--------<>---------<>--------XXXXXX-SSS----XXXXXXX[]-----------------B----B-------XXXXXX------------------<>--------XX--XXX----------XX----------
------XXXXX------------[]---------[]-------XXXXXXX-------XXXXXXXX[]------------<>---b----b------XXXXXXX------------------[]-------XXX--XX-----------XX---XXXX---
-----XXXXXX------------[]---------[]---X---XXXXXXX------XXXXXXXXX[]----E-------[]--------------XXXXXXXX------------------[]------XXXX---------------XX------X---
XXXXXXXXXX-------------[]--XXXX---XXXXXX---XXXXXXXXX---XXXXXXXXXXXXXXXXXXXXXXXXXXXXXXXXXXXXXXXXXXXXXXXX------------------[]-----XXXXX---------------XX------X---