----------------------------------------------------------------------------------------------------------------------------------------------------------------
----------------------------------------------------------------------------------------------------------------------------------------------------------------
----------------------------------------------------------------------------------------------------------------------------------------------------------------
----------------------------------------------------------------------------------------------------------------------------------------------------------------
----------------------------------------------------------------------------------------------------------------------------------------------------------------
----------o-----------------------------------------------------------------------------------------------------------------------------------------------------
--------------------------------------X------------------------------E--------------XXXX---------------oo-oo----------------------------------------------------
--SSQ---SSS--------------------------XX----XXX--------E------------SSSSSSSQSS---------------------------------------Q-------------------------------------------
-------------------------------------XXXX------------<>---------------------------------------------------------------------------------------------------------
-----------------------------------XXXX--------------[]-----------E-----------------------------------------------------------X---------------------------------
-----------------------------------XXXX----------<>--XXX---------------------------------------------------------------------XX---------------------------------
--SSSS---S-----------------------XXXXXX----------[]-------------S?S-----SSSSSS--------------------------------------?-------XXX---------------------------------
---------------------------------XXXXXX-E--------[]-------------------------------------------------------------<>---------XXXX---------------------------------
--------------X-----------B------XXXXXX<>--------[]-----<>------------------------------------------------------[]--------XXXXX---------------------------------
----------E---X---------------E--XXXXXX[]--------[]-----[]------------------------------------------------------[]-------XXXXXX---------------------------------
XXXXXXXXXXXXXXXXXXXXXXXXXXXXXXXXXXXXXXX[]-----XXXXXXXXXXXXXXXXXXXXXXXXXXXXXXXXX------------XXXXXXXXXX-XXXXXXXXXXXXXXXXXXXXXXXXXXXXXXXXXXXXXXXXXXXXXXXXXXXXXXXXXX