----------------------------------------------------------------------------------------------------------------------------------------------------------------
----------------------------------------------------------------------------------------------------------------------------------------------------------------
----------------------------------------------------------------------------------------------------------------------------------------------------------------
----------------------------------------------------------?-----------------------------------------------------XXX---------------------------------------------
------------------------------------------------------------------<>------------------------------------------------SSSSSSSSSSSSSSSSSSSSSSSSSSSSSSSSSSSSSSSSSSSS
------------------------------------------------------------------[]------------------------------------------------SSSSSSSSSSSSSSSSSSSS------------------------
---------------------------------------------------------S------XX[]X----SXS---------------------------------XX-----SSSSSSSSSSSSSSSSSSSS------------------------
-------------------------------------------------------------------------XSX----------------SSS---------------------SSSSSSSSSSSSSSSSSSSS------------------------
---------------------------------------------------------------------------X----------------------------------------S--------------------------o---o---o--------
------------------------------------------------------------------------------X-------------------------------------S-------------------------------------------
-----------------------------------------------------XXXXXXX-----------------XX-----------------------XXXXX----------?ooooooo?oooooo----------S---S---S---------
-----------<>------XSSS----QQQ----------------------------------------------XXX------------XXXXX---------------------??SSSSSSSSSSSSS----XXXX--------------XX-XXX
-----------[]------X-------------------------------------------------------XXXX------------X-------------------------------------------XXXXXXX--XX--XX--XXXXXXXX
-----------[]------X-------------------------------o--------------------XXXXXXX------?-----X--------------------XXX-------------------XXXXXXXX--XX--XX--XXXXXXXX
-----------[]-----EX----------------------XXXXXXXXXXX-------------------XXXXXXX------------X------------------------------EE----EE---XXXXXXXXXE-XXE-XXE-XXXXXXXX
XXXXXXXXXXXXXXXXXXXXXXXXXXXXXXXXXXXXXXXX--------------------------------XXXXXXXXXXXXX-XXXXXXXX----------------------XXXXXXXXXXXXXXXXXXXXXXXXXXXXXXXXXXXXXXXXXXXX