----------------------------------------------------------------------------------------------------------------------------------------------------------------
----------------------------------------------------------------------------------------------------------------------------------------------------------------
----------------------------------------------------------------------------------------------------------------------------------------------------------------
----------------------------------------------------------------------------------------------------------------------------------------------------------------
----------------------------------------------------------------------------------------------------------------------------------------------------------------
----------------------------------------------------------------------------------------------------------------------------------------------------------------
----------------------------------------------------------------------------------------------------------------------------------------------------------------
----------------Q-Q-Q-Q-Q-Q-------------------------------SSSSS--------------------------------------------------------------------------SS---------------------
------------------------------------------------------------------------------------------------------------------------------------------------------------XXXX
----------------------------------------------------------------------------------------------------------------------------------------------------------------
---------E-------------------------------------------------E----------------------------------------oo----------------------------------------------------------
----------------Q-Q-Q-Q-Q-Q-----------------------ESSSSS--SSSSS---------------------------X-------------------------<>----------X-------XXXX--------------------
--------------------------------------X--------------------------------------------------XX----<>-------<>---<>-----[]----------XX---XXXXX-----XXXXXXXXXXXXXX---
--------------------------------------X---------------------------------------------X---XXX----[]-------[]---[]-----[]--<>------XXXXXXXX------------------------
------------E-----------------E-------X---------------------------------------------X--XXXX----[]-------[]---[]--E--[]--[]------XXXXXX--------------------------
XXXXXXXXXXXXXXXXXXXXXXXXXXXXXXXXXXXXXXXXXXXXXXXXXXXXXXXXXXXXXXXXXXXXXXXXXXXXXXXXXXXXXXXXXXXXX-XXXXXXXXXXXXXXXXXXXXXXXXXXXX------XXXX------XX--------------------