----------------------------------------------------------------------------------------------------------------------------------------------------------------
----------------------------------------------------------------------------------------------------------------------------------------------------------------
----------------------------------------------------------------------------------------------------------------------------------------------------------------
----------------------------------------------------------------------------------------------------------------------------------------------------------------
----------------------------------------------------------------------------------------------------------------------------------------------------------------
----------------------------------------------------------------------------------------------------------------------------------------------------------------
---------------------------------------------------------------------------------------------------------o------------------------------------------------------
---------------------------------------------E-----------------------------------------------------------ooo----------------------------------------------------
--------------------------------------------<>--------------------------------------------ooo-------------------------------------------------------------------
--------------------------------------------[]--------------------------------------------------------------------------------------------------------------E---
----------E---------------------------------[]--------------------S------------------------------------oo------------------------------------------SSSSSSSSSSSSS
-------------------------------------------SXXS---------------<>-----------------------<>---------E-------------------------------------------------------------
-----------------XX<>-----------------------------------------[]------X----------------[]---------E--------XX-------E---------------------<>--------------------
----------------XXX[]-----------------<>---------<>-----------[]------X----------------[]---------------------------------X---------------[]----<>--------------
---------------XXXX[]---------------E-[]---------[]-----------[]------X----------------[]---------------------------------X---------------[]----[]--------------
XXXXXXXXXXXXXXXXXX-XXXXXXXXXXXXXXXXXXXXXXXXXXXXXXXXXXXXXXXXXXXXXXXXX--XXXXXXXXXXXXXXXXXXXXXXXXXXXXXXXXXX--------XXXXXXXXXXXXXXXXXXXXXXXXXXXXXXXXXXXXXXXXXXXXXXXX