----------------------------------------------------------------------------------------------------------------------------------------------------------------
----------------------------------------------------------------------------------------------------------------------------------------------------------------
----------------------------------------------------------------------------------------------------------------------------------------------------------------
----------------------------------------------------------------------------------------------------------------------------------------------------------------
----------------------------------------------------------------------------------------------------------------------------------------------------------------
--------------------------------------------------------------------------------------------------------------------------------------------------------------o-
-------------------XXXXX----------XXX--------------------------------------------------E---------------------------------------------------------------------XXX
--------------------------oo------XE--o-------------------E---XX-------------------SSSSSSSSSSSS-----------------------------------------------------------------
--------------------------------------XXXXXX-----------------XXX-------------------------------------------------------------------XXXXX--o---o---o---o---o-----
------------------------------------------------------------XXXX-------------------------------------------------------------------------XXX-XXX-XXX-XXX-XXX----
--------------E------------XX------------------------------XXXXX--------------------E-----SS-------------XX------XX---------------------------------------------
-----Q---QQQQQQQ-----------------------------------------<>XXXXX-------------------SSSSSSS-------<>--------------XXX-----------S--------------------------------
---------------------------------------------------------[]XXXXX--------<>-----------------------[]-------------------------------------------------------------
---------------------------------XX---------------------X[]XXXXX--------[]-----------------------[]-------------------------------------------------------------
---------------------------------XX--------------------XX[]XXXXX--------[]-------------------EE--[]---------XX--------------------------------------------------
XXXXXXXXXXX-<><>-----------------XXXXX----XXXXXXXXXXXXXXXXXXXXXX--XXXXX-XXXXXXXXXXXXXXXXXXXXXXXXXXX-XX---------------XXXXXXXXXXXX--------XXXXXXXXXXXXXXXXXXXXXXX