----------------------------------------------------------------------------------------------------------------------------------------------------------------
----------------------------------------------------------------------------------------------------------------------------------------------------------------
----------------------------------------------------------------------------------------------------------------------------------------------------------------
----------------------------------------------------------------------------------------------------------------------------------------------------------------
------------------------------------SS??SSSSSSSSSSSSSSSSSSSSSSSSSSSSSSS?SSSSSSSSSSSSSSSSSSSSSSSSSSSSSSSSSSSS[SSSSSSSSSSSSSSSSSSSSSSSSSSSSSSSSSSSSSSSSSSSSSSSSSSS
----------------------------------SS------------------------------------------------------------------------[SSSSSSSSSSSSS--------------------------------------
-------------------------------SSS--------------------------------------------------------------------------[]SSSSSSSSSSSS--------------------------------------
------------------------------------------------------------------------------------------------------------[SSSSSSSSSSSSS--QQ----------------------------------
------------------------------------------------------------------------------------------------------------[---------------------------------------------------
------------------------------S-----------------------------------------------------------------------------[---------------------------------------------------
------------------------------------XXX------------------XXXXXXXXXXXXXXX------------------------------E-----------------------------------------XXX-------------
-----------------QQQ-------<>------XXXX-----------------XXXXXXXXXXXXXXXX-----E-----------------------<>------SSSSSSSSSSSSS--QQ---QQ----------------------------X
----------<>---------------[]-----XXXXX----XXXXX-------XXXXXXXXXXXXXXXXX----<>--------------------XX-[]--SSSSSSSSSSSSSSSSS---------------XX----------<>------XXX
-----B----[]---------------[]----XXXXXX---------------XXXXXXXXXXXXXXXXXX----[]-------XX----------XXX-[]--SSSSSSSSSSSSSSSSS---------------------------[]----XXXXX
----------[]-E-EE--------E-[]---XXXXXXX-------------XXXXXXXXXXXXXXXXXXXX----[]-----XXXX--------E-XXX-[]--SSSSSSSSSSSSSSSSS---------------------------[]---XXXXXX
XXXXXXXXXXXXXXXXXXXXXXXXXXXXXXXXXXXXXXXX------------XXXXXXXXXXXXXXXXXXXX--XXXXXXXXXXXXXXXXXXXXXXXXX--XX--XXXXXXXXXXXXXXXXXXXXXXXXXXXX----------------XXXXXXXXXXX