----------------------------------------------------------------------------------------------------------------------------------------------------------------
----------------------------------------------------------------------------------------------------------------------------------------------------------------
----------------------------------------------------------------------------------------------------------------------------------------------------------------
----------------------------------------------------------------------------------------------------------------------------------------------------------------
----------------------------------------------------------------------------------SS---------------------------------------?----[]SSSSSSSS----------------------
--------------------------------------------------------------------------------------------------------------------------------[]SSSSSSSS----------------------
------------------------------------<>----------XXXXXXXXX-----------------------------------------------------------------------[]SSSSSSSS----------------------
-------------------------------E---X[]------------------------------------------------------------------------------------------[]SSSSSSSS----------------------
----------------------------------XX[]-----------------------------------XXXXXXXX--------------------------------------------S--[]SSSSSSSS----------------------
---------------------------------XXX[]------------------------------------------------------------------------------------------[]SSSSSSSS----------------------
-----------SQ-------------------XXXX[]--------------------XXX------------------------------------------------------------SS------]SSSSSSSS----------?----------?
------------------------------<>XXXX[]-------------------------------XX------------------------------------------E---------------]SSSSSSSS------<>---------<>---
--------------------<>--------[]XXXX[]----------------------------------------------------------------------------------------SSSSSSSSSSSS------[]---------[]---
--------------------[]-------X[]XXXX[]-----B--------------------------------------------------------------------------B------SSSSSSSSSSSSS------[]-----<>--[]--E
-----------SSSSS----[]------XX[]XXXXXXXXXXXX--------------------------------------------------------------------------b------SSSSSSSSSSSSS--EE--[]-----[]--[]---
XXXXXXX--------XXXXXXXXXXXXXXXXXXXXXXXXXXXXX-------------XXX------------------------XXXX-XXXXXXXXXXXXXXXXXXXXXXXXXXXXXXXXXXX-XXXXXXXXXXXXX--XXXXXXXXXXXXX--XXXXX