----------------------------------------------------------------------------------------------------------------------------------------------------------------
----------------------------------------------------------------------------------------------------------------------------------------------------------------
----------------------------------------------------------------------------------------------------------------------------------------------------------------
-------------------------------------------------------------SS?SSSSSSSSSSSSSSSSSSSSSSSSSSSSSSSSSSSSSSSSSSSSSS--------------------------------------------------
------------S---------------------------------------------------SSSSSSSSSSSSSSS----[]---[]----------------------------------------------------------------------
----------------------------------------------------------------SSSSSSSSSSSSSSS----[]---[]------E---------------------------------------------------------------
----------------------------------------------------------------SSSSSSSSSSSSSSS----[]---[]---QQQQQ----------------------------------XX--oo----------------------
-------SSSSSS--------------------?----XXX------------------------------------------<>---[]---------------SSSSSS---------------XX-------oo-----------------------
-----E----------------------------------------------------------------------------------[]---------------SSSSS-------------------------o------------------------
--------------------------------------o-o-----------------------------------------------[]---------------SSSS---------------------------------------------------
--------------------------------------o-o-XXXXXXXX----------<>-------------<><>---------[]---SSSSSSSSSS--SSS------------oXX------------------------ooo----------
-----<>--------------------------S--------------------------[]----------XX-[][]---------<>---SSSSSSSSSS---------------------------------------------------------
-----[]----------------------<>-----------------------------[]-------EEXXX-[][]--------------SSSSSSSSSS----------<>-----------------------------<>------------X-
-----[]-------------B--------[]---X-------------------------[]------E-XXXX-[][]--------------SSSSSSSSSS----------[]-----------------------------[]------------X-
-----[]----------------------[]E--X------------------XXXXXXXXXXX-XXXEXXXXX-XXXXXXXX--XXXXXE--XXXXXXXXXXXXXXXXX---[]E----------------------------[]------------X-
XXXXXXX----XXXXXXXXXXXXXXXXXXXXXXXX------------------XXXXXXXXXXX-XXXXXXXXX-XXXXXXXX--XXXXXX--XXXXXXXXXXXXXXXXX--XXXXXXX---------XXXXXXXXXXXXXXXXXXXXXXXXXXXXXXXX