----------------------------------------------------------------------------------------------------------------------------------------------------------------
----------------------------------------------------------------------------------------------------------------------------------------------------------------
----------------------------------------------------------------------------------------------------------------------------------------------------------------
----------------------------------------------------------------------------------------------------------------------------------------------------------------
----------------------------------------------------------------------------------------------------------------------------------------------------------------
----------------------------------------------------------------------------------------------------------------------------------------------------------------
---------------------------------------------SSS---------------------------------------------------------------------------------------------------------------o
----SSS------SSS-------------------------------------SSSSSSSSSSSSSS--------------------------------E---------------XX---------------SSSSSSSSS-----------------XX
--------------------------------------------------------------------------------------------------<>---------------XX-------------------------------------------
---------------------------------------------X----------------------------------------------------[]---------------XX-------------------------------------------
---------------------------------------------XEE------------------------------------X-------------XXX-----------X--XX-------------------------------------------
----SSS--------------------X-----------------XSSSSS------------------------X------SSX---------<>---------------XX--XX-------------------SS--ES------------------
------------X-------------XXX---------------------------------------E-----XX------------------[]--------------XXX--XX----------------------<>-------------------
------------XX-----------XXXX-----------<>-------------------------------XXX------------------[]-----<>------XXXX--------------------------[]-------------------
------------XX----------XXXX------------[]-------------------X----------XXXX------------------[]-----[]--E--XXXXX---------E-----E----------[]-------------------
XXXXXXXXXXXXXXXXXX<>XXXXXXXX-----X-XXXXXXXXXXXXXXXXXXXX------XXXXXXXXXXXXXXXXXXXXXXXXXXXXXXXXXXXXXXXXXXXXXXXXXXXXXXXXXXXX--XXXXXXXXXXXXXXXXXXXXXXXXXXXXXXXXXXXXX