--------------------------------------------------------------------------XXX---------XXXXXXXXXXXXXXXXXXXXXXXXXXXXXXXXXXXXXXXX------------XXXXXXX---XXXXXXXXXXXX
----------------------------------------------------------------------------------------------------------------------------------------------------------------
----------------------------------------------------------------------------------------------------------------------------------------------------------------
----------------------------------------------------------------------------------------------------------------------------------------------------------------
-------------------------------------------------------------------------o--------------------------------------------------------------------------------------
--------------------------------o-------------------------------------------------------------------------------------------------------------------------------
-------------------------E-E------E------------------------------------o--------------------------------------------------------------oo------------------------
-----------------------SSSSSSSSSS----------------------------------XXX---XX-----------------------------------------------------XXXX--oo------------------------
----------------------------------------------------------------------------o----------------------------SSQSS----?SSS-------------------------E---------XX-----
----------------------------------------------------------------------------XXXXX-----------------------------------------------------------------------XXX-----
-----------oo------------------------------------------------------------------------------------------------------------------------------------------XXXX-----
-------------------------------S-----<>--------------E----SSS----------------------------------------?-----------------<>----------------?------------XXXXX-----
------------------------E------------[]-------------<>---------------------------------------------------SSSSSSS----E--[]----------------------------XXXXXX-----
-------------------------------------[]----------------------------------------------------------------------------<>--[]---------------------------XXXXXXX-----
--------------------------------E-E--[]--------X----------------------------------------E-----X------E-------------[]--[]--<>----------------------XXXXXXXX-----
XXXXXXXXXXXXXXXXXXXXXXXXXXXXXXXXXXXXXXXXXXXXXXXXXXXXXXXXXXXXXXXXXXXXX--XX---------------------X-E------------------[]--[]--[]----------------------XXXXXXXX-----