----------------------------------------------------------------------------------------------------------------------------------------------------------------
----------------------------------------------------------------------------------------------------------------------------------------------------------------
----------------------------------------------------------------------------------------------------------------------------------------------------------------
--------------------------------------------------------------------S-------------------------------------------------------------------------------------------
------------------------------------------XXXXXXXXXXXX----------------------------------------------------------------------------------------------------------
------------------------------------------XXXXXXXXXXXX----------------------------------------------------------------------------------------------------------
------------------------------------------XXXXXXXXXXXX------------XXXX------------------------------------------------------------------------------------------
-----------XXX--------------------------S-XXXXXXXXXXXX-------E----XXX---------------------------SSSQQS----------------------------------------------------------
----------XXXX----------------------------XXXXXXXXXXXX----------------------------------------------------------------------------------------------------------
---------EXXXX----------------------------XXXXXXXXXXXX----------------------------------------------------------------------------------------------------------
--------XXXXXX-------------------------S--XXXXXXXXXXXX---------------------------------------------------o------------------------------------------------------
-------XXXXXXX---------------------<>-----XXXXXXXXXXXX---------------------------------------------SS-----------------------------------------------------------
------XXXXXXXX---------------------[]-----XXXXXXXXXXXX--------------------------------------------------------------------------------------------B-------------
-----XXXXXXXXX---------------------[]---E-XXXXXXXXXXXX-----------XX----------------X--------------------------------------------------------------b-------------
----XXXXXXXXXX---------------E-----[]-----XXXXXXXXXXXX-----------XXXXXXXXX---------X-E-----------------------------E-------------E---E------------------------EX
XXXXXXXXXXXXXXXXXXXXXXXXXXXXXXXXXXXXXXXXXXXXXXXXXXXXXX-----------XXXXXXXXXXXXXXXXXXXXXXXXXXXXXXXXXXXXXXXXXXXXXXXXXXXXXXXXXXXXXXXXXXXXXXXXXXX-XXXXXXXXXXXXXXXXXXX