----------------------------------------------------------------------------------------------------------------------------------------------------------------
----------------------------------------------------------------------------------------------------------------------------------------------------------------
----------------------------------------------------------------------------------------------------------------------------------------------------------------
--------------------------------------------------------------------------------------?-------------------------------------------------------------------------
------------------------SSSSSSSSSSSSSSSSSSSSSS------------------------------------------------------------------------------------------------------------------
----------------------------------------------------------------------------------------------------------------------------------------------------------------
----------------------------------------------------------------------XX-------------S--------XXX---XX----------------------------------------------------------
------------------------------------------------------------XX----------------------------------------------------------------------------------------SS--------
----------------------------------------------------------------------------------------------------------------------------------------------------------------
----------------------------------------------------------------------------------E-----------------------------------------------------------------------------
-----------oooo-------------S-------------E--------oo-----------XX-XX-----------XXEXXXXX--XX-----------XXXX-----------------------------------------------------
--------------------------E----E---------<>--------------------------------------------------------------------------------<>----------------X-------XXXX-------
-------------------------<>---<>------XX-[]--XXX<>-------------------------------------------------------------------------[]----------------XX---XXXXX---------
-------------------------[]---[]-----XXX-[]--XXX[]-------------------------------------------------------------------------[]--<>------------XXXXXXXX-----------
-------------------------[]---[]-E-E-XXX-[]--XXX[]-----E-------------------------------------------------------------------[]--[]------------XXXXXX-------------
XXXXXXXXXXXXXXXXXXXXXXXXXXXXXXXXXXXXXXX--XX--XX-XXXXXXXXXXX--------------------------------------------------XXXXXXXXXXXXXXXXXXXXXXXXXXXXXXXXXXXX------XX---XXXX