----------------------------------------------------------------------------------------------------------------------------------------------------------------
----------------------------------------------------------------------------------------------------------------------------------------------------------------
----------------------------------------------------------------------------------------------------------------------------------------------------------------
----------------------------------------SS----------------------------------------------------------------------------------------------------------------------
-----------------oo---------------------[]----------------------------------------------------------------------------------------------------------------------
----------------------------------------[]----------------------------------------------------------------------------------------------------------------------
-------XX-----------XXXXXXXXXXX---------<>----------------------------------------------------------------------------XX---------------------------XXX----------
-------------------------------------------------------------------XQQ?QQX-------------------------------------------XXX------E------------------------------E--
-----------------------------------------E-------------------------X-----X------------------------------------------XXXX----------------------------------------
-------------------------------------------------------------------X-----X-----------------------------------------XXXXX--E--------<>---------------------------
-oo-------XX---XXXXX-------------------<>---------Q-------------X--XE-E--X----------------------------------------XXXXXX-<>--------[]------------------SSSSSSSSS
---------------------------------------[]----------------------XX--XQQ-QQX---------------------------------------XXXXXXX-[]-------QQQQQQ?-----------------------
---------------------------------------[]-----<>--------------XXX-----------------------------------------------XXXXXXXX-[]---------------------------------oooo
---------------------------------X-----[]-----[]-------------XXXX--------E---X---------------------------------XXXXXXXXX-[]-E-----------------------------------
-------------XX------------------XX-X-XXXXXXXXXXX-XXXXXXXXXXXXXXX------------X--------------------------------XXXXXXXXXXXXXXXXXXX-------B-------------------oooo
XXXX-----------------------------XXXXXXXXXXXXXXXX-XXXXXXXXXXXXXXXXXXXXXXXXXXXXXXXXXXXXXXXXXXXXXXXXXXXXXXXXXXXXXXXXXXXXXXXXXXXXXXXXXX-X-XXXXXXXXX-------XXXXXXXXX