----------------------------------------------------------------------------------------------------------------------------------------------------------------
----------------------------------------------------------------------------------------------------------------------------------------------------------------
----------------------------------------------------------------------------------------------------------------------------------------------------------------
----------------------------------------------------------------------------------------------------------------------------------------------------------------
----------------------------------------------------------------------------------------------------------------------------------------------------------------
----------------------------------------------------------------------------------------------------------------------------------------------------------------
-----------------------------------------------------------XS-----------------------oooo------------------------------------------------------------------------
-SSS-SSSSSSSS---------------SSSSSSSSSSS-------------------EX------------------------oooo-----XX-------XX--------XX----------------------------------------------
---------------------------------------------------------XXX----------------------------------------------------------------------------------------------------
--------------------------------------------------------XXXXS---------------------------------------------------------------------------------------------------
------------------------------SSSSS--------------------XXXXX----------------------------------------------------------------------------------------------------
S---------<>----------------SS------------------------XXXXXX-----------------------XX--XXXX---------------X---------------------------<>-------SSSS?------------
----------[]------E----------------------<>----------XXXXXXX--------------------------------------------------------------------------[]------------------------
----------[]-----------------------------[]---------XXXXXXXX-------------------------------------<>------------------------B-----B----[]-<>--------S------------
-------X--[]--------------------E---EE---[]-E------XXXXXXXXXXXEXXXXXXXXXXXXXXXX------------------[]---------------------------------E-[]-[]------------E--------
XXX----XXXXX--XXXXXXXXXXXXXXXXXXXXXXXXXXXXXXXXXXXXXXXXXXXXXXXXXXXXXXXXXXXXXXXXX------------------[]--------------------XXXXXXXXXXXXXXXXXXXXXXX--XXXXX---XXXXXXXX