----------------------------------------------------------------------------------------------------------------------------------------------------------------
----------------------------------------------------------------------------------------------------------------------------------------------------------------
----------------------------------------------------------------------------------------------------------------------------------------------------------------
----------------------------------------------------------------------------------------------------------------------------------------------------------------
----------------------------------------------------------------------------------------------------------------------------------------------------------------
---------------------------------------------------------------------------------------------------------------------------------------E------------------------
--------------------------------------------------------------------------------------------------------------------------------------X>----------X-------XXX---
-------------------------S---------SSS-------------------------------XX------------------SS-------------------------------------------[]---------XX----X--------
-----oo--------------------------------------------------------------XX---------------------------------------------------------------[]--------XXXXX---------XX
-------------------------------------------------------------------XXXX----------------------------------ooo------------<>---------E--[]-------XXXX-------------
-------------------------------------SS--------------------E-------XXXX------o----------------oo---------ooo--------QQ?-[]--------<>--[]------XXXXX-------------
--<>------------------S--S---------SS---------------------<>-------XXXX---------X-------XXXX----------------------------[]----<>--[]--[]-----XXXXXX-------------
--[]------------------------------------<>------------------------XXXXX---------XX---XXXXX-------------E----------------[]----[]--[]--[]----XXXXXXX-E-----------
--[]------------------------------------[]------------------------XXXXX---------XXXXXXXX---------------XXXXXX-----------[]----[]--[]--[]---XXXXXXXX<>-----------
--[]------------------------------------[]------------------------XXXXX---------XXXXXX-----------------X-----------XXXXXXXXXXXXX--[]--XXXXXXXXXXXXX[]-----------
XXXXXXXXXXXXXXXXXXXXXXXXXXXXXXXXXXXXXXXXXXXXXXXXXXXXX--XXXXXXXXXXXXXXXXXXXXXXXXXXXXX------XX--------X--X-----------XXXXXXXXXXXXX--[]--XXXXXXXXXXXXX[]-----------