----------------------------------------------------------------------------------------------------------------------------------------------------------------
----------------------------------------------------------------------------------------------------------------------------------------------------------------
----------------------------------------------------------------------------------------------------------------------------------------------------------------
----------------------------------------------------------------------------------------------------------------------------------------------------------------
-----------------------------------------------------------------------------------SSSSSSSSSSSSS----------------------------------------------------------------
----------------------------------------------------------------------------------------------------------------------------------------------------------------
---------------------------------------------------------------------------XXX----------------------------------------------------------------------------------
------------------SSSSSSSSSSSSSS-------------?SSS-------------------------------SSS---------------------------------------------SSSS----------XXX-------------E-
----------------------------------------------------------------------------------------------------------------------------------------------XXX------------SSS
--------------------------------------------------------------------------------S-------------------------------------------------------------XXX---------------
-----SS------------E--SSSSSS----------------------<>---------------------------S-S---------------------------XEXXX--ooooooooo--------------XX-XXX--------X-E--E-
-<>--------------SSSSS--------------------B----E--[]-------------<>---------------S------E---XXX--E----------------XXXXXXXXXXX--S---------XXX-XXX--------XS?SSSS
-[]-----------E---------------------------b---<>--[]-------------[]---------------------<>-----------------------------------------------XXXX-XXX---------------
-[]---------------------------------------B---[]--[]-------------[]---------------------[]----------------------------------------------XXXXX-XXX--------SSSSSSS
-[]----------------------E---EE---------------[]--[]-------------[]---------------------[]--------XXXEEXEEEXX--------------------EE----XXXXXX-XXX----E----------
XXXXXXXXXXXXXXXXXXXXXXXXXXXXXXXXXXXXXXXXXXXXXXXXXXXXXXXXXX---XXXXXXXXXX--------XXXXXXXXXXX-----------------------------------XXXXXXXXXXXXXXX--XXXXXXXXXXXXXXXXXX