----------------------------------------------------------------------------------------------------------------------------------------------------------------
----------------------------------------------------------------------------------------------------------------------------------------------------------------
----------------------------------------------------------------------------------------------------------------------------------------------------------------
----------------------------------------------------------------------------------------------------------------------------------------------------------------
-----SSSSSSSSSSSSSSSSSSSSSSSSSSSSSSSSSSSSSS--[]SSSSSSSSSSS---------------------------------------------------------XXXXXXXXX------------------------------------
-----SSSS------------------------------------[]SSSSSSSSSSS---------------------------------------------------------XXXXXXXXX---------------------oo-------------
-----SSSS------------------------------------[]SSSSSSSSSSS-------X-------------------------------------------------XXXXXXXXX------XXX------------oo-------------
-----SSSS------------------------------------[]SSSSSSSSSSS-------------------------------------------------------S-XXXXXXXXX------------------------------------
---------------------------------------------[]SSSSSSSSSSS---------------------------------------------------------XXXXXXXXX--------------o---------------------
----------------------------------------------]SSSSSSSSSSS---------------------------------------------------------XXXXXXXXX------------------------------------
------o-----------S?--------------------------]SSSSSSSSSSS----XXXXXXX------------E------------------------------S--XXXXXXXXX------------------------?----------S
-----S?SS----------S?------------------------S]SSSSSSSSSSS---------------------------------------Q-ESSQS-----------XXXXXXXXXS------------------------------<>---
-----SSS-----------S--------X-------SS--SSSSSSSSSSSSSSSSSS-------------------X-------------------------------------XXXXXXXXX-------------------------------[]---
-----SS----------X---------XXXX-----SS--SSSSSSSSSSSSSSSSSS-------------------X-----------------------------------E-XXXXXXXXX-------------------------------[]---
-E-----E-EE-EE-E--X--------XXXX-----SS--SSSSSSSSSSSSSSSSSS---------EXXXXXX---X-------------------------------------XXXXXXXXX-------------XXXXXX------------[]---
XXXXXXX-XXXXXXXXXXXXXXXXXXXXXXXXXX--XX--XXXXXXXXXXXXXXXXXX---------------X---XXXXXXXXXXXXXXXXXXXXXXXXXXXXXXXXXXXXXXXXXXXXXXXXX----------------------XXXXXXXXXXXX