----------------------------------------------------------------------------------------------------------------------------------------------------------------
----------------------------------------------------------------------------------------------------------------------------------------------------------------
----------------------------------------------------------------------------------------------------------------------------------------------------------------
----------------------------------------------------------------------------------------------------------------------------------------------------------------
----------------------------------------------?-----------------------------------------------------------------------------------------------------------------
----------------------------------------------------------------------------------------------------------------------------------------------------------------
-------E--------------------------------------------------------------------------------------------------------------------------------------------------------
SSS?SSSSS----EXXX---------------------------XXX---------------------------------------------------------------SSSS------------SSSSSSSS---------------S----------
------------EXXXX------------------E----------------------------------------------------------------------------------------------------------------------------
-----------EXXXXX----------------------XX------------------------------------------ooooooo--------------------------E-------------------------------------------
-----------XXXXXX---------------XXXXXXXXXXXXXXXXX------------------------------------------------------------------<>-------------------------------------------
SSSSSSSS--XXXXXXX----------------------------------------------------------<>-----------------------------------E--[]------------------<>-------S?S--S----------
---------XXXXXXXX--------E-------------------------------------------------[]----------------------------------<>--[]------------------[]-----------------------
--------XXXXXXXXX-----------------------------------------------------X----[]----------------------------------[]--[]------------------[]---------------------B-
-------XXXXXXXXXX------------------------------------------------E----X-E--[]-----<>------XX-------------------[]--[]------------X-----[]---E-------------------
XXXXXXXXXXXXXXXXXXXXXXXXXXXXX--------------------XXXXXXXXXXXXXXXXXXXXXXXXXXXXXX---[]-------XXXXXXXXXXXXXXXX-XXXXXXXXXXXXXXXXXX---XXXXXXXXXXXXXXXXXXXXXXXXXXXXXXX