----------------------------------------------------------------------------------------------------------------------------------------------------------------
----------------------------------------------------------------------------------------------------------------------------------------------------------------
----------------------------------------------------------------------------------------------------------------------------------------------------------------
----------------------------------------------------------------------------------------------------------------------------------------------------------------
----------------------------------------------------------------------------------------------------------------------------------------------------------------
----------------------------------------------------------------------------------------------------------------------------------------------------------------
-----------------------Sooooooooooooooooooooooooooo-------------------------------------------------------------------------------------------------------------
------------------------SSSSSSSSSSSSSSSSSSSSSSSSSSSSS?SS------SSSSS-------------------------------S----------------------------X------XSSS?SS-------------------
------------------------------------------------------------------------------------------------------------------------------XX------X-------------------------
----------------------S------------------------------------------------------------------------------------------------------XXX------X-------------------------
------------oo--------------------------------------------------E-X------------------SSSSSS-------------?-------------------XXXX-----EX-------------------------
-----------------------SSSSSSSSSSSSSSSSSSSSSSSSSSSSSSSSSSSSS--SS?SX-----------------------------S--------------------------XXXXXS-----XSSSSSSS------ooooooo-----
--B------<>-----------------------------------------------------------------------------------E-----------------<>--------XXXXXX--------------------------------
--b------[]-----------------------------------------------------------------------<>--------------<>----E-------[]-------XXXXXXX---------------B----------------
---------[]--------------------------------------E--------------------------------[]--------------[]------------[]------XXXXXXXX---------------b----------------
XXXXXXXXXXXXXXXXXXXXXXXXXXXXXXXXXXXXXXXXXXXXXXXXXXXXXXX-XXXXXXXXXXXXXXXXXXXXXXXXXXXXXXXXXXXXXXXXXXXXXXXXXXXXXXXXXXXXXXXXXXXXXXXXXXXXXXXXXXXXXXXXXXXXXXXXX-XXXXXX