----------------------------------------------------------------------------------------------------------------------------------------------------------------
----------------------------------------------------------------------------------------------------------------------------------------------------------------
----------------------------------------------------------------------------------------------------------------------------------------------------------------
----------------------------------------------------------------------------------------------------------------------------------------------------------------
----------------------------------------------------------------------------------------------------------------------------------------------------------------
----------------------------------------------------------------------------------------------------------------------------------------------------------------
---------------------------------------------------------------------------------------------------------------------------------------------SSSSSSSSSS---------
-----------------------------------------------------------------Q-Q-Q-Q-Q-Q-Q-Q-Q-Q-Q-Q-Q-Q-Q-Q-Q-Q-Q-Q-Q-Q-Q-Q-Q-Q-Q-Q------------E---------------------------
-----------------------------------------------------------------------------------------------------------------------------------<>---------------------------
-----------------------------------------------------------------------------------------------------------------------------------[]-------S-------------------
----------------------------------------------------------oo-----------------------------------------------------------------------[]---------------------------
-----------------------------------QQQ---------------------------Q-Q-Q-Q-Q-Q-Q-Q-Q-Q-Q-Q-Q-Q-Q-Q-Q-Q-Q-Q-Q-Q-Q-Q-Q-Q-Q-Q----------SXXX---<>---------------------
--------------<>----------XXXXXXXXX------------------------------------------------------------------------------------------------------[]---------------------
--------------[]-------------------------------------------------------------------------------------------------------------------------[]---------------------
--------------[]----------------------------------------------E--------------------------------------------------------------------------[]---XXXXXXXXXX--------
XXXXXXXX--XXXXXXXXXXXXXXXXXXXXXXXXXXXXXXXXXXXXXXXXXXXXXXXXXXXXXXXXXXXXXXXXXXXXXXXXXXXXXXXXXXXXXXXXXXXXXXXXXXXXXXXXXXXXXXXXXXXXXXXXXXXXXXXXXXXXXXXXXXXXXX--XXXXXX