----------------------------------------------------------------------------------------------------------------------------------------------------------------
----------------------------------------------------------------------------------------------------------------------------------------------------------------
----------------------------------------------------------------------------------------------------------------------------------------------------------------
----------------------------------------------------------------------------------------------------------------------------------------------------------------
----------------------------------------------------------------------------------------------------------------------------------------------------------------
----------------------------------------------------------------------------------------------------------------------------------------------------------------
------------X-------o--------XXXX-------------------------SSSSS----------------------------------XX-------------------------------------------------------------
-----------XX----X------------------------------------------------------------------------------XXX-------------------------------------------------------------
----------XXXXX--------------------------------------------------------------------------------XXXX-------------------------------------------------------------
---------XXXX-----------------------E---------------------------------------------------------XXXXX-------------------------------------S-----------------------
--------XXXXX--------------------------------------------------------------------------------XXXXXX--------------------------------------------------------QQ?--
-------XXXXXX-------------------------------------------------------XX----------------------XXXXXXX------------------------------X------------------------------
------XXXXXXX-E----------------------------------------------------XXXX--------------------XXXXXXXX---------------B--------------X------S-----------------------
-----XXXXXXXX<>-------------o-----------XXX-------XX--------------XXXXXXX-----------------XXXXXXXXX------------------------------X------S-----------------------
----XXXXXXXXX[]--------X----X---------------------XXXXXXXXXXXXXX-XXXXXXXXXXXXXXXXXXEXXXXXXXXXXXXXXXXXXXXXXXXXXXXXXXXXXXXXXXXXXXXXXXX<>XXXXXXXXXXXXEEXXXXXXXXXXXX
XXXXXXXXXXXXX[]--X--XXXX--------------------------XXXXXXXXXXXXXX-XXXXXXXXXXXXXXXXXXXXXXXXXXXXXXXXXXXXXXXXXXXXXXXXXXXXXXXXXXXXXXXXXXX[]XXXXXXXXXXXXXXXXXXXXXXXXXX