----------------------------------------------------------------------------------------------------------------------------------------------------------------
----------------------------------------------------------------------------------------------------------------------------------------------------------------
----------------------------------------------------------------------------------------------------------------------------------------------------------------
----------------------------------------------------------------------------------------------------------------------------------------------------------------
----------------------------------------------------------------------------------------------------------------------------------------------------------------
----------------------------------------------------------------------------------------------------------------------------------------------------------------
-----------SSS-------------------------------------------------------------------------E------------------------------------------------------------------------
----------------------?---------------------------------------------------------------------------------------------------------------------------SS-----------S
-----------------------------------------------------------------------------------------XX-----------------oooooo----------------------------------------------
----------S-----------------------------X-EE--X-----------------------------------------------------------------------------------------------------------------
------------EE--------------------------XSSSSSX-------------------------------------------------------------------------------------------------SS--------------
------------SSSS------S----------------------------E-------------------------------XXX-------------------<>---------------------------------<>----------------SS
------------------<>----------------------------------------------------------<>-------------------------[]---------------------------------[]------------------
------------------[]---X------------------------------------------------------[]----------------<>-------[]----------------------------X----[]------------------
------------------[]E--X-XXXXXXXXXXXXXXXXXXXXXXXXXXXXXX<>XEE------------------[]----------------[]-------[]----------------------------X----[]------------------
XXXXXXX---XXXXXXXXXXXXXX-XXXXXXXXXXXXXXXXXXXXXXXXXXXXXX[]XXXXXXXXXXXXXXXXXXX--[]----------XXXXXXXXXXXXXXXXXXXXXXXXXXXXXXXXXXXXXXXXXXXXXXXXXXXXXXXXX-XXXXXXXXXXXX