----------------------------------------------------------------------------------------------------------------------------------------------------------------
----------------------------------------------------------------------------------------------------------------------------------------------------------------
----------------------------------------------------------------------------------------------------------------------------------------------------------------
----------------------------------------------------------------------------------------------------------------------------------------------------------------
----------------------------------------------------------------------------------------------------------------------------------------------------------------
----------------------------------------------------------------------------------------------------------------------------------------------------------------
-----------------------------ooo--------------------------------------XXXXXXXXX--------------------------------------------------XXXXX--------oo----------------
-----------------------ooo---XXX-----------XSSS---------SSS---XX-----------------------E---------------------------------------------------------------E--------
-------------------------------------------X--------------------------------------------------------------------------------------------------------------------
-------------------------------------------X-----------------------------------XXXXXX----------------ooo---------------ooo--------------------------E-----------
----------------X-------------------------EX--X------------------------------------------------------ooo---------------ooo--------------------------------------
--------E---SSSSX--------------------------XSSX---------SSS------------------------------XXXX--------E-------------------E-----------------------?---------E----
-------<>------------XX--XX-?-----E---------------------------------------------------------------------------------------------------------------------------XX
---------------------------------------------------------------------------------------------------XXXXXXXXXEXEXXXXXEXXXXXXEXX----------------------------------
--------------------------------------------------------------------------------------ooo------------------------------------------------------------------XXXXX
XXXXXXXXXXX--XXXXXX---------XXXX-XXXXXXXXXXXXXXXXXXXXXXXXXXXXXX-----------------------XXX----------------------------------------------------XXX----------------