----------------------------------------------------------------------------------------------------------------------------------------------------------------
----------------------------------------------------------------------------------------------------------------------------------------------------------------
----------------------------------------------------------------------------------------------------------------------------------------------------------------
------------------------------------------------------------------------?---------------------------------------------------------------------------------------
----------------------------------------------------------------------------------------------------------------------------------------------------------------
----------------------------------------------------------------------------------------------------------------------------------------------------------------
----------------------------------------------------------XXX----------XXXXXXX------------------------------------------------------E---------------------------
----------------------XX-----------------------E---------------------------------------------------------------------------------SSSSSS-------------------------
----------------------XX----------------XXX-----------------------------------------------------------------------------------------------------oo-------------X
--------------------XXXX----------XXXXX-oo-------------------------------------------------------------------------ooo----------------------------------------XX
--------------------XXXX------------------------------------------S---------------------------o-------------------o-oo---------------------------------------XXX
------------------XXXXXX-------------------------XXX----------------------------XX--------------------------------------------------------------------------XXXX
-----<>--------<>-XXXXXX---XXXXXXXX--------------------------------------------------------------------------XX-XXXXXXXXXXXXX------------------------------XXXXX
-----[]--------[]-XXXXXX----------------------------------------------------------------------------------------------------------------------------------XXXXXX
-----[]--------[]-XXXXXX----------------------------------XXXXXXXXXXEX-----------------------------------------------------------------------------------XXXXXXX
XXXXXXXXXXXXXXXXXXXXXXXXXX------------------------------------------------------------XXXXXXXXXXXXXXXXXXXXX--------------------XXXXXXXXX--------XXXXXXXXXXXXXXXX