----------------------------------------------------------------------------------------------------------------------------------------------------------------
----------------------------------------------------------------------------------------------------------------------------------------------------------------
----------------------------------------------------------------------------------------------------------------------------------------------------------------
----------------------------------------------------------------------------------------------------------------------------------------------------------------
----------------------------------------------------------------------------------------------------------------------------------------------------------------
-----------------------------------------------------------------------------------------------------------------------------------------------------o----------
--------------------XXXXXXXXX------------------------------------o----------------------------------------------------------------------------------XXX---------
-----?SS---------------------------E-----------------------XXXXX----------------------------------SS----------------------------E-----SSS?SS?SSS--------o-------
-------------------------------------------------------------------------------------------------------------------------------<>-----------------------XXXXX---
----------E--------------------------------------------------------------------------------------------------------------------[]-------------------------------
---------<>----------------------------------o-----------------------------------------------------------X---------------------XXX------------------------------
---------[]----------------------------X---E-----------------------------XXX---------------------XXXX--------------<>------<>---------SSSSSSSSSS----------------
--X---B--[]-------------------------------<>----XXX-------------------------------------------XXXXX----------------[]------[]-----------------------------------
--X---b--[]--------------------XXX--------[]-----------------------------------------------XXXXXX------------------[]------[]-----<>----------------------------
--X------[]-------------------------------[]-----------------------------------------------XXXX--------------------[]------[]-----[]----------------------------
XXXXXXXXXXXXXXXX--------------------------XXXXX-------XXXXXXXXX--XXXXXXX---------X-XXX-----XX------XX--------XXXXXXXXXXXXXXXXXXXXXXXXXXXXXXXXX-XXXXXXXXX--------