----------------------------------------------------------------------------------------------------------------------------------------------------------------
----------------------------------------------------------------------------------------------------------------------------------------------------------------
----------------------------------------------------------------------------------------------------------------------------------------------------------------
----------------------------------------------------------------------------------------------------------------------------------------------------------------
-------------------------------------------------------------------------------------------------------------------------SSSSSSSSSSSSSSSSSSSSSSSSSSSSSSSSSSSSSSS
-------------------------------------------------------------------------------------------------------------------------SSS-----SS--SSSSSSSS-------------------
---------------------XXXXXXE---------------------------------------------------------------------------------------------SSS-----SS--SSSSSSSS-------------------
----SS------XXX-------------------------XXXXXXXXXX-----------------------------------------------------------------------SSS---SS------SSSSSS-------------------
-------------------------------------------------------------------------------------------------------------------------------SS-------------------o-------o---
-------------------------------------------------------------------------------------------------------------------------------SS-------------------------------
-----------------------------------------------------------------<>--------------------------------------------------------E---SS----oooo----------S-------S----
--------------XXXX-------------------------------------S-----<>--[]----------------------------------XX-------------------<>---SSSS--SSSS----XXXX------XX-------
-------------------------------------------------------------[]--[]------------?-B---------------XXX----------------------[]-----SS---------XXXXXXX--XXXXXX--XX-
--------------------o-------XXX---XX-------------------------[]--[]--------------b--------------XXXX----------------------[]-----SS--------XXXXXXXX--XXXXXX--XXX
--------------------X----------------------------------------[]--[]--------------BEE-----------XXXXX----------------------[]--------------XXXXXXXXXE-XXXXXXE-XXX
XXXX---XXXXXXXX---------------------------XXXXX---XXXXXXXXXXXXX--XXXXXXXXXXXXXXXXXXXXXXXXXXXXXXXXXX--------XXXXXXXXXXXXXXXXXXXXXXXXXXXXXXXXXXXXXXXXXXXXXXXXXXXXX