----------------------------------------------------------------------------------------------------------------------------------------------------------------
----------------------------------------------------------------------------------------------------------------------------------------------------------------
----------------------------------------------------------------------------------------------------------------------------------------------------------------
----------------------------------------------------------------------------------------------------------------------------------------------------------------
------------------------------------------------------------------------------------------------------------------S---------------------------------------------
----------------------------------------------------------------------------------------------------------------------------------------------------------------
---------------------------------------------oo--------------------------------------------------------------------------------oo-------------------------------
------------------E----------------oo----XX----------XXX------------------------------------------SSSSSSSSSSSSSSSSS---------XX----------------------------------
-----------------SSSS--------------------------------XXX------------------------------------XX--E---------------------------------------------------------------
-----------------------------------------------------XXX--------------------------------------------------------------------------------------------------------
-------------X-E--E-----------------XXX--------------XXX-------------------?----------------------------------------------------------------SSSSSSS-------------
-------------XS?SSSSS---X------X--------------XX-----XXX--------------------------XXXXXXXX------<>------------------------------XXXXXXX-------------------------
---------------------EE-X-----XX---------------------XXX----------------------------------------[]--------------------------------------------------<>----------
------X------SSSSSSSSSSSX----XXX---------------------XXX----------------------------------------[]--------------------------------------------------[]--<>------
------X---------------------XXXX---------------------XXX---------------XXXXX--------------------[]--------------------------------------------------[]--[]---E--
XXXXXXXXXXXXXXXXXXXXXXXXXXXXXXXX---------------------XXXXXXXXXXXXXXXXXXXXXXX-----------------XXXXX---------------XXXXXXXXXXXX---------------XXXXXXXXXXXXXXXXXXX-