----------------------------------------------------------------------------------------------------------------------------------------------------------------
----------------------------------------------------------------------------------------------------------------------------------------------------------------
----------------------------------------------------------------------------------------------------------------------------------------------------------------
----------------------------------------------------------------------------------------------------------------------------------------------------------------
----------------------------------------------------------------------------------------------------------------------------------------------------------------
----------------------------------------------------------------------------------------------------------------------------------------------------------------
------------------------------------------------------------------------------------------------------------------------------------SSSSS--------E--------------
--------------SSQQQ------------------------------------------------------------------SSS---------------------------------------------[]------------------------S
---------------------------------------------------------------------------------------------------E---------------------------------[]------------XX-----------
----------------------------------------------------------------------B--------------------------------------------------------------[]-------------------------
-------------------------oooo-----------------------------------------b--------------------------------------------------------------<>-------------------------
--------------SSSSQQQS---------------------------------------E------SSXS-------------SSSS--------------XXX----------------------------------XXXX---------------S
------------------------------------------------------------<>---E--------------------------------------------------------------------E--------------------X----
-B---------------------------------------------------------------------------------------------------------------------------------B-----------------------X----
----------------------------------E-----------------------------------------------------------------------------------------------XX-XXXXX-----------------X----
XXXXXXXXXXXXXXXX--XXXXXXXXXXXXXXXXXXXXXXXXXXXXXXXXXXXXXXXXXXXXXXXXXXXXXXXXXXXXXXXXXXXXXXXXXXXXXXX--------XXXXXXXXXXXXXXXXXXXXXX---XX-XXXXX----------XXXXXXXXXXXX