----------------------------------------------------------------------------------------------------------------------------------------------------------------
----------------------------------------------------------------------------------------------------------------------------------------------------------------
----------------------------------------------------------------------------------------------------------------------------------------------------------------
----------------------------------------------------------------------------------------------------------------------------------------------------------------
-----------------------------------------------------------SSSSSSSSS????SSSSSSSSSSSSSSSSSSSS--------------------------------------------------------------------
---------------------------------------------------------SS--------------------------------------------------------------------XX-------XX----------------------
------------------------------------------------------SSS----------------------------------------------------------------------XX-------XX----------------------
-------QQQS-S------------------------SSSS---------------------------------------------------------------------QQQQQQ-----------XX-------XX----------------X-----
-------------------------------------------------------------------------------------------------------------------------------XX-------XX--------------------E-
-----------------------------------------------------S----------------------------------------oo-------------------------------XX-------XX----------------------
-S---------------------------------------------------------XXXXXXXXXXXX--------------------------------------------------------XX-------XX--------oooo----------
-----QQ?-S-------------B--------------------------<>------XXXXXXXXXXXXX-------------------XXX----------------E?QQQQQ-----------XX-------XX----------------------
-----------------------b--------------------------[]-----XXXXXXXXXXXXXX------------<>----EXXX----------------------------------XX-------XX----------------------
------------<>---------B--------------------------[]----XXXXXXXXXXXXXXX------------[]---XXXXX------------X---------------------XX-------XX----B-----------------
------------[]------------------------------------[]---XXXXXXXXXXXXXXXX------------[]--XXXXXX----------E-X---------------------XX---E---XX----------------------
XXXXXXXXXXXXXXXXXXXXXXXXXXXXXXXXXXX------XXXXXXXXXXXXXXXXXXXXXXXXXXXXXXX---XXXXXXXXXXXXXXXXX---XXXXXXXXXXXXXXXXXXXXXXXXXXXXXXXXXXXXXXXXXXXXXXXXXXXXXXXXX--X-----