----------------------------------------------------------------------------------------------------------------------------------------------------------------
----------------------------------------------------------------------------------------------------------------------------------------------------------------
----------------------------------------------------------------------------------------------------------------------------------------------------------------
----------------------------------------------------------------------------------------------------------------------------------------------------------------
------------------------oo-------------------------------------------------------------------?------------------------------------------------------------------
----------------------------------------------------------------------------------------------------------------------------------------------------------------
-----------------------------------------o-ooo----------------------------------------------------------oo------------------------------------------------------
------------------------XXX-------XXXXXX-----------E---------------------QQQQ-----------------------------------------------------------------------------------
-----------------------------------------------------------------------------------------------SS---------------------------Eo----------------------------------
--------------------------------------------XX-------------------------------------------------------------------oooooo------XX---------------------------------
----------------------------------------------------------------------------------<>---?---SS--------------------oooooo---------------------------------------Q-
---------------------------XXXXXXX-------------------------------------QQ?SSQQQ---[]--------------XX-----XX----------------------------------<>-------<>--QQ-E--
----------------------------------------------------------------------------------[]-------------XXX-----------------------------------------[]----E<>[]-----E--
----<>--<>-------------------------------------XXX--------B-----------------------[]------------XXXX----------XXXXXXXXXXEXXXXXXXEXXX-----<>--[]---<>[][]--------
----[]--[]------------------------------------------------------------------------[]-----------XXXXX----------X--------------------X-----[]--[]-E-[][][]--------
XXXXXXXXXXXXXXXXXXXXXXXX----------XXXXX--XXXX---------XXXXXXXXXXXXXXXXXXXX--XXXXXXXXXXXXXXXXXX-XXXXX----------X--------------------X---XXXX--XXXXXXXXXXXX-XXXXXX