----------------------------------------------------------------------------------------------------------------------------------------------------------------
----------------------------------------------------------------------------------------------------------------------------------------------------------------
----------------------------------------------------------------------------------------------------------------------------------------------------------------
----------------------------------------------------------------------------------------------------------------------------------------------------------------
--------------------------------------------------SSSSSSSSSSSSSSSSSSSSSSSSSSSSSSSSSSSSSSSSSSSS?SSSSSSSSSSS?S?SSSSSSSSSSSSSSSSSSSSSSSSSSSSSSSSSSSSSSSSSSSSSSSSSSS
----------------------------------------------------------------------------------------------------------------------------------------------------------------
------------E---------------------------------------------------------------------------------------------------------------------------------------------------
--------SSSSSS-----------------------------------------------------------------------------------------oooooo---------------------------------------------------
----------------------------------------------------------------------------------------------------------------------------o-----------------------------------
-------------------------------------------------------------------------------------------------------SSSSSS---------------------------------------------------
---------E-------------------------------------------------------------XXXXXXXXXXXXXXXXXXXXXXXE--------SSSSSS--------------S------------------------------------
--------SSSSS--XX-X----------------------------------E------E---------XXXXXXXXXXXXXXXXXXXXXXXXX--------------------XXXXXX------XX--XX--------E------------------
--------------XXX-X---------------------------------<>-----<>--------XXXXXXXXXXXXXXXXXXXXXXXXXX-------------------EXXXXXXXX--XXXXXXXXXX-----<>------<>-----E----
-------------XXXX-X---------------------------------[]-----[]-------XXXXXXXXXXXXXXXXXXXXXXXXXXX------------------XXXXXXXXXX--XXXXXXXXXXXX---[]------[]----<>----
------------XXXXX-X---------------------------------[]-----[]-----XXXXXXXXXXXXXXXXXXXXXXXXXXXXX-----------------XXXXXXXXXXXE-XXXXXXXXXXXX---[]------[]----[]----
XXXXXXXXXXXXXXXXX-XXXXXXXXXXXXXXXXXXXXXXX-XXXXXXXXXXXXXXXXXXXXXXXXXXXXXXXXXXXXXXXXXXXXXXXXXXXXX--X----XXXXXXXXXXXXXXXXXXXXXXXXXXXXXXXXXXXXXXXXXXXXXXXX--XXXXXXXX