----------------------------------------------------------------------------------------------------------------------------------------------------------------
----------------------------------------------------------------------------------------------------------------------------------------------------------------
----------------------------------------------------------------------------------------------------------------------------------------------------------------
----------------------------------------------------------------------------------------------------------------------------------------------------------------
SSSSSSSSSSSSSSSSSSSSSSSSSSSSSSSSSSSSSSSS------------------------------------------------------------------------------------------------------------------------
----------------------------------------------------------------------------------------------------XXXEX-------------------------------------------------------
-------------------------------------------------------X---XX----------------------------------------------------------------------o-o---------------XX---------
--------------------------------------------------------------o------------------------------------------------------------XXXX---------------------------------
---------------------------------------------------------oooooo-------------------------------------------------------------------------------------------------
---------------------------------------------------X-----ooooo---------------------------------------------------------------------XXXXXXXXXXXXXXXX-------------
--------------------------------------------------XX---------------------------X----------------------------------------------------------------------------XXX-
-------------------E----E-----------XXXX---------XXX--------------------------XX-----XXXXX----------------------------------------------------------------------
------------X-----<>---<>-----------------------XXXX-----E-------------------XXX-----------S----------------X-----------------XXXXX-----------------------------
----------XXXXX---[]---[]----XXXX--------------XXXXX----<>------------------XXXX----------------------------XX--------------------------------------------------
--E-----XXXXXXX---[]-E-[]---------------------XXXXXX----[]----XXXXXXXXXXXXXXXXXXXXXX--------XXXXX-----------XXXXXXXXXXXXX---------------------------------------
XXXXXXXXXXXXXXXXXXXXXXXXX-----------------XXXXXXXXXX----[]------------------------------------------------------------------------------------------------------