----------------------------------------------------------------------------------------------------------------------------------------------------------------
----------------------------------------------------------------------------------------------------------------------------------------------------------------
----------------------------------------------------------------------------------------------------------------------------------------------------------------
----------------------------------------------------------------------------------------------------------------------------------------------------------------
---------------------------------------------------------------XXXXXX-------------------------------------------------------------------------------------------
---------------------------------------------------------------XXXXXX-------------------------------------------------------------------------------------------
---------------------------------------------------------------XXXXXX-------------------------------------------------------------------------------------------
---------Q-Q-------------------------------------------------S-XXXXXX----------E----------------XX----------------------------------------------S---------------
---------------------------------------------------------------XXXXXX---------SSSS--------------XX--------------------------------------------------------------
---------------------------------------------------------------XXXXXX---------------------------XX-------<>-----------------------------------------------------
---------------------------------------------SSX------oo----S--XXXXXX-----X-E--E-------------XX-XX-------[]--------------------------?-------------------ooooo--
---------Q-Q-------------------------SS?-------X--------o------XXXXXX-----XS?SSSSS---X------XXX-XX---<>--XXX---------------------<>-------------S---------------
-----------------------<>-----X--------------------------------XXXXXX-------------EE-X-----XXXX-XX---[]---------------------<>---[]-----------------------------
-----------------------[]-----X--------S---------------------E-XXXXXX-----SSSSSSSSSSSX----XXXXX-XX---[]---------------------[]---[]-----------------------------
-----------------------[]-----X--------------------------------XXXXXX--------------------XXXXXX-XX---[]---------------------[]---[]-----------------------------
XXXXXXXXXXXXXXXXXXXXXXXXXXXXXXXXXXXXXXXXX-XXXXXXXXXXXXXXXXXXXXXXXXXXXXXXXXXXXXXXXXXXXXXXXXXXXX--XXXXXXXXXXXXXXXXXXXXXXXXXXXXXXXXXXXXXXXXXXXXXXXXXXXXXXXXXXXXXXXX