----------------------------------------------------------------------------------------------------------------------------------------------------------------
----------------------------------------------------------------------------------------------------------------------------------------------------------------
----------------------------------------------------------------------------------------------------------------------------------------------------------------
----------------------------------------------------------------------------------------------------------------------------------------------------------------
----------------------------------------------------------------------------------------------------------------------------------------------------------------
----------------------------------------------------------------------------------------------------------------------------------------------------------------
----------------------------------------------------------------------------------------------------------------------------------------------------------------
-----------------------------------------------------------QSS------------------------------------------------------------------------------SSS-SSSSSSSSS-------
------------------------------------------------------------------------------------------------------E---------------------------------------------------------
--------------------------------------------------------------------------------E--------------------<>---------------------------------------------------------
-----------------------------------------------------------SSS-----------XXXXXXXXXXXX----------------[]---------------------------------------------------------
-SS---------------XXX---------------------------------<>---------XXX--X------------------------------[]--------------------------X------------------<>----------
---------------------------------------------<>-------[]---------------------------------------------[]-------------------------XX------------------[]----------
------X----------------X---------------------[]-------[]---------------------------------------------[]------------------------XXX------------------[]----------
------X----------------X---------------------[]-------[]---------------------------------------------XXXXXXXXXXXXXXXXXXXXXXXXXXXXX------------------[]----------
XXXXXXXXXXXXXXXXX------XXXXXXXXXXXXXXXXXXXXX-XXXXXXXXXXXX--------------------------------------------XXXXXXXXXXXXXXXXXXXXXXXXXXXXXXX----XXXXXX------XXXXXXXXXXXX