----------------------------------------------------------------------------------------------------------------------------------------------------------------
----------------------------------------------------------------------------------------------------------------------------------------------------------------
----------------------------------------------------------------------------------------------------------------------------------------------------------------
----------------------------------------------------------------------------------------------------------------------------------------------------------------
----------------------------------------------------------------------------------------------------------------------------------------------------------------
----------------------------------------------------------------------------------------------------------------------------------------------------------------
--------------------------------------------------------E--XXX----------------------------------------------------------XX----XXXXX--------XXX---------XXX------
----S----?---------------------EXX-----------------------------------------E------XX---------------------------S---------------------E--------------------------
------------------------------XXXX-----------------------------------E-------------------------------------------------------------------------XX---------------
-----------------------------XXXXX----------------------X-------------XXX---------------------------------------------------------------------------------------
------------oo--------------XXXXXX--XX----XXX----------------------XXXX-----------------------------------------------------------------------------------------
----S----------------------XXXXXXX----------------X--------------------------XXX-------------B------------QQ--SS------------------------------------------------
-------E------------------XXXXXXXX-----------------------------------------------------------b----<>------------------------------------------------------------
-------------------------XXXXXXXXX-----------------------------------------------------------B----[]-------------------------o----------------------------------
------------------------XXXXXXXXXX-----XXX--------------------------------ooo---------------------[]-------------------------X----------------------------------
XXXXXXXXXXXXXXXXXXXXXXXXXXXXXXXXXX----------------------------------------XXX--------XXXXXXXXXXXXXXXXXXXXXXXXXXXXXXXX---------------------------XXXX---------XXX