----------------------------------------------------------------------------------------------------------------------------------------------------------------
----------------------------------------------------------------------------------------------------------------------------------------------------------------
----------------------------------------------------------------------------------------------------------------------------------------------------------------
----------------------------------------------------------------------------------------------------------------------------------------------------------------
-------------------------------------------------------------------SSSSSSSSS???SSSSSSSSSS--[]SSSSSSSSSSSSSSSSSSSSSSSSSSSSSSSSSSS--------------------------------
-------------------------------------------------------------------------------------------[]SSSSSSSSSSSSSSSSSSSSSSSSSSSSSSSSSSS--------------------------------
------------------------------E------------------------------------------------------------[]SSSSSSSSSSSSSSSSSSSSSSSSSSSSSSSSSSS--------------------------------
--------------------------SSSSSS-----------------------------------------------------------[]SSSSSSSSSSSSSSSSSSSSSSSSSSSSSSSSSSS--------------------------------
-------------------------------------------------------------------------------------------[]SSSSSSSSSSSSSSSSSSSSSSSSSSSSSSSSSSS--------------------------------
-------------------------------------------------------------------------------------------[]SSSSSSSSSSSSSSSSSSSSSSSSSSSSSSSSSSS---------------------------o----
-----------<>--------------E---------------------------------------------XXXXX--------------]SSSSSSSSSSSSSSSSSSSSSSSSSSSSSSSSSSS----<>----oo--------------------
---------?-[]------------SSSSSS----------<>-----------------------------XXXXXX--------------]SSSSSSSSSSSSSSSSSSSSSSSSSSSSSSSSSSS----[]-----------------ESSS-----
----XX<>---[]-------<>----------XXXX-----[]----------------------------XXXXXXX--------SSSSSSSSSSSSSSSSSSSSSSSSSSSSSSSSSSSSSSSSSS----[]--------------------------
---XXX[]---[]-------[]---------XXXXX-----[]---------------------------XXXXXXXX---XX---SSSSSSSSSSSSSSSSSSSSSSSSSSSSSSSSSSSSSSSSSS----[]--------------------------
--XXXX[]---[]-------[]--------XXXXXX-----[]--------------------------XXXXXXXXX--------SSSSSSSSSSSSSSSSSSSSSSSSSSSSSSSSSSSSSSSSSS----[]--------------------------
XXXXX-XXXXXXXXXXXXXXXXXXXXXXXXXXXXXXXXXXXXX-XX-XXXXXXXXXXXXXXXXXXXXXXXXXXXXXXXX-------XXXXXXXXXXXXXXXXXXXXXXXXXXXXXXXXXXXXXXXXXX----XX-X-----XXXXXX-XXXXXXXXXXXX