----------------------------------------------------------------------------------------------------------------------------------------------------------------
----------------------------------------------------------------------------------------------------------------------------------------------------------------
----------------------------------------------------------------------------------------------------------------------------------------------------------------
----------------------------------------------------------------------------------------------------------------------------------------------------------------
----------------------------------------------------------------------------------------------------------------------------------------------------------------
----------------------------------------------------------------------------------------------------------------------------------------------------------------
---------------------------------------------------------------------------XXXX-------------------------------------------------oo------------------------------
--------------------------S-----------E--------------------------------------------------------------------XXX------------------oo---------------------------?SS
-------------------------------------------------------------------------------------------------------------------------------------XXX------------------------
----------------------------------------X-------------------------------------------------ooooo-----oooo--------------------------------------------------------
---------------------------------------XX------E------------------------------------------ooooo-----oooo-----------oooooooo-------------------------------------
------------------<>-----SS----------<>XX-----<>--------<>--------------------------------E---------E--------------ooooooo---E---XX----------------------QQ-----
------------------[]-----------------[]XX---------------[]---------------------XXXXX--------------------------------------------------------------------------B-
------------------[]-<>---------B---X[]XX---------------[]--<>--------------------------XXXXXXXXXXXXXXXXX-------XXXXXXXXXEXXXXX-------------------------------b-
------------------[]-[]------------XX[]XX---------------[]--[]--------------------------X---------X-------------XX------------X---------------------------------
XXXXXXXXXXXXXXXXXXXXXXXXXXXXXXXXXXXXXXXXXXXXXXXXXXXXXXXXXXXXXXXXXXXX-XX-----------------X---------X-------------XX------------X-------XXXXXXXXXXXXXXXXXXXXXXXXXX