----------------------------------------------------------------------------------------------------------------------------------------------------------------
----------------------------------------------------------------------------------------------------------------------------------------------------------------
----------------------------------------------------------------------------------------------------------------------------------------------------------------
----------------------------------------------------------------------------------------------------------------------------------------------------------------
---------------------------------------------------------------------------------------------------------------------ooo----------------------------------------
---------------------------------------------------------------------------------------------------------------------XXXX---------------------------------------
----------------------------------------------------E--------------------E-------------------XS--SSSSS----------------------------------------------------------
-----------------------------------------------------------------EXX---SSQS-----------------EX----[]------E------------------------------XXXX------Q-Q----------
-----------------------oo------------oo---------------XX--------EXXX-----------------------XXX----[]----------------------------E-------------------------------
---------------------------------------------------------------EXXXX----------------------XXXXS---[]------------------------------------------------------------
-------------------------------------------------------o----X--XXXXX---------------------XXXXX----<>----------------------XXXXXXXXXXXX--------------------------
-<>----------<>-----<>---------------------------XX----o------XXXXXXS--SSQS-------------XXXXXX--------------XXX--XXX-------------------XX----------Q-Q----------
-[]----------[]--E<>[]-----------------------E---------------XXXXXXX-------------------XXXXXXX-----E-----------------XXXXXX-------------------------------------
-[]----------[]-<>[][]--------------------------------------XXXXXXXX------------------XXXXXXXX--B--------------------------------------------------------B------
-[]----------[]-[][][]-------------------------------------XXXXXXXXX-----------------XXXXXXXXXXXX-XXXXX--ooo---------------------------------------------b--X-XX
XXXXXXXXXXXXXXXXXXXXXXXXXXXXXXXXX----XXXXXXXX-XX----------XXXXXXXXXXXXXXXXXXXXXXXXXXXXXXXXXXXXXXX-XXXXX--XXX-----------------------------XXXXXX-XXXXXXXXXXXXX-XX