----------------------------------------------------------------------------------------------------------------------------------------------------------------
----------------------------------------------------------------------------------------------------------------------------------------------------------------
----------------------------------------------------------------------------------------------------------------------------------------------------------------
----------------------------------------------------------------------------------------------------------------------------------------------------------------
----------------------------------------------------------------------------------------------------------------------------------------------------------------
----------------------------------------------------------------------------------------------------------------------------------------------------------------
--------------------------------------E----------------------------------------------E--------------E---E-------------------------------------------------------
--------XXX------------------------------------------------------X------------------SQS-----------QQQQQQQX------------------------------------------------------
-------XXXX-----------------------------------------------------XX---------------------------------------X------------------------------------------------------
------EXXXX----------------------------------------------------XXX---------------------------------------X------------------------------------------------------
-----XXXXXX---------------------------------------------------XXXX-------o---------------------------E---X---------------------------------S--QQQQQ-------------
----XXXXXXXS----<>-------------------------------------------XXXXX------------------SQS----------QQQQQQQQX-------------E---------------------------------B----<>
---XXXXXXXX-----[]------------------------------------------XXXXXX----------------------------------------------E-----<>-----------------SS------E-------b----[]
--XXXXXXXXX-----[]-<>------X-------------------------------XXXXXXX---------------------------------------E-----<>------------------------SS--------------B----[]
-XXXXXXXXXX-----[]-[]------XXXXXXX-X----------------------XXXXXXXX----------------E----------------------------------------------------XXXXXXXXXXXXXXXXXXXXXXXXX
XXXXXXXXXXXXXXXXXXXXX------XXXXXXXXX---XXXXXXXXXXXXXXXX-XXXXXXXXXXXXXXXXXXXXXXXXXXXXXXXXXXXXXXXXXXXXXXXXXXXXXXXXXXXXXXXXXXXXXXXXXXXXXXXXXXXXXXXXXXXXXXXXXXXXXXXX