XXXXXXXXXXXXXXXXXXXXXXXX-----------X--XXXXXXXX<>XXXX----XXXXXXXXXXXXXXXXXX--------------XXXXXXXXXXXXXXXXXXXXXXX----------------------------------------------
------------xxxxxxxxxxxx-----------X--xxxxxxxxxxxxxx----xxxxxxxxxxxXXXXXXX--------------[]-----------xxxx-XXXXX----------------------------------------------
-----------x-----------xxx---------X-x-----------B-xxxxx----------xxXXXXXX--------------[]----------x---xxXXXXX----------------------------------------------
----------x---------------x--------xx-------------------X----------xxXXXXXX-------------<>---------x---E-xxXXXX----------------------------------------------
---------x--SS-------------x-xxxxxx---------------------------?Q?S--xxXXXXX-------------xx--------x-------xxXXX----------------------------------------------
--------x-------------------xx-----------E-----------o------------E--xxXXXX----------xxx-xx------x---------xxXX----------------------------------------------
-------x--------------------XX----------------------------------------xxXXXXXXX-----xx----xx----x-----------xxX----------------------------------------------
------x----------------------------------------------------------------xxXXXXXX----xx------xx--x-------------xx----------------------------------------------
-----x------------------------------------------------------------------xxxxxxxxxxxx--------xxx---------------xxxx-------------------------------------------
----x-----------------------------------------------------------------------------x-------------------------------x------------------------------------------
---x-------------------------XX--------------------------------------------------XXXX------------------------------x-----------------------------------------
--x------------------------------------------------------------------------------X-----------------------------------------------------Q---------xxxx--------
-x------------------------------------------------------------------------------------------------------------------x---------------------------xx---x-------
x--------------------------------------------------------------------------------------------------------------------x--------xxx--------B-----xx-----x----xx
----------------------------------------------------------------------------------------------------------------------xxxxxxxxx--xxxxxxxxxxxxxxx-------xxxxxX
-------------------------------------------------------------------------------------------------------------------XXXXXXXXXXXX--XXXXXXXXXXXXXXX-------XXXXXX