------------------------------------------------------------------------------------------------------------------------------------------------------------
------------------------------------------------------------------------------------------------------------------------------------------------------------
------------------------------------------------------------------------------------------------------------------------------------------------------------
------------------------------------------------------------------------------------------------------------------------------------------------------------
----------------------------------------------------------------------------------------------------------------------------------------xxx--xxx------------
---------------------------------------------------------------------------------------------------------------------------------------xx--xxx--x-----------
--------------------------------------------------------------------------------------------------------------------------------------xxX--XXX---x----------
----------------------------------------------------SS-----------------------------------------------------------------------------xxxx-----------xE--------
----------------------------------------------------------------------------------------------------------------------------------xxXXX------------x-------x
---------ooo------------------------------------------------------xx-------------------------------------------------------------xx----------------xxxxxxxxx
SSSSSSSSSSX--------------------xxx----------------SS-------------xx-x------------------------------------------xxxxx----------xxxx------------------XXXXXXXX
-----------------xx-------xxxxxx--x--------?QQ------------------xx---x------o---------------------------------xx--X-x-------xxxXXX--------------------------
----------------xx-x-----xxQ--<>---x---------------------------xx-----x--------------------------------------xx------x-----xxXXXX---------------------------
---------xxxx--xx---x---xx----[]--X-x-----------xxx-xxxxxxx---xxX------x-xxx----------------------------xxx-xx--------xxxxxxXXX-----------------------------
xxxxxxxxxxx--xxx---S-xxxx-----[]--X-ExxxxxxxxxxxxE-xx------xxxx---------xx--xxxxxxxxxxxxxxxxxxxxxxxxxxxxx--xx--------XXXXXXXXXX------------XX-----oo--------
XXXXXXXXXX---XXX-----XXXXXXX--XXXXXXXXXXXXXXXXXXXXXXX--X-XXXXXXXX------XXX--XXXXXXXXXXXXXXXXXXXXXXXXXXXXX--XX-------------XXXX--------------------XX--------