-------------------------------------------------------------------------------------------------------------------------------------------------------------
-------------------------------------------------------------------------------------------------------------------------------------------------------------
------------------------xxxx---------------------------------------------------------------------------------------------------------------------------------
-----------------------xx---x--------------------------------------------------------------------------------------------------------------------------------
----------------------xx-----x-------------------------------------------------------------------------------------------------------------------------------
---------------------xx-------x------------------------------------------------------------------------------------------------------------------------------
--------------------xx---------x---------------------------------Q-------------------------------------------------------------------------------------------
----------------xx--x-----------x---------------------------------S----------------------------XX------------------------------------------------------------
---------------xx-xxx------------x------------------xx-----------------------------------------XX--------------------xx--------------------------------------
------xxxxxx--xx---xE-------------x-xxx------------xx-x------Q--xxx----------------------------XX-------------------xx-x-------------------------------------
-----xx-x---xxx----<>--------------xx--x------xxxxxx---x-------xxS-x---------------------xxxx--XX------------------xx---x-----------------------------xxxx---
----xx-----XXXX----[]----------XXXXXX---xxxx-xx<>-x-----x-----xx----x---------Q---------xx<>-x-XX------QQQQQQQ---xxx-----x---------------------------xx<>-x--
---xx--------------[]-----------------------xx-[]-X------x---xx------x-----------------xx-[]--xXE---------------xx<>------x-------------------------xx-[]--x-
--xx---------------[]----------------------<>--[]-X-------xxxx--------x--------xxx-xxxxx--[]---x---------------xx-[]-------x-----------------------xx--[]---x
xxx----------------[]----------------------[]--[]-X-------XXXX---------xxxxxxxxx--xx--x---[]---X-xxxxxxxxxxxxxxx--[]--------xxxxxxxxxxxxxxxxxxxxxxxx---[]--X-
XXX----------------XXXXX-------------------[]XXXXXX-------X---------XXXXXXXXXXXX--XX--XXXXXXXXXXXXXXXXXXXXXXXXXXXXXXXXXXXXXXXXXXXXXEXXXXXXXXXXXXXXXXXXXXXXXXX