------------------------------------------------------------------------------------------------------------------------------------------------------------
------------------------------------------------------------------------------------------------------------------------------------------------------------
------------------------------------------------------------------------------------------------------------------------------------------------------------
----------------------------------------------------------------------------SSSSSSSSSSSSSSS-----------------------------------------------------------------
-------------------------------------------------------------------------------------------SSSSSSSSSSSSSSSS-------------------------------------------------
---------------------------------------------------------------------------------------------SSS------------------------------------------S-----------------
---------------------------------------------------------------------------------------------SSS-----------------------------------------ES-----------------
------------------------------------------------------xx--------------------------------------S-----S------S---------------------------SSS------------------
---------------------------------------------------x-xx-x-------------------xx----------------S-----S-----S---------S---------------------------------------
------------------xx--------------------------------xx---x----------------xxx-xxxxxxxxxxxx----S-----S-----S-------------------------------------xxx---------
------xxxxxxx----xx-x-------------------xxxx------xxxX----x--------------xx<>-???????????-x---S?----S---------------------------------xxxxx----xx--x--------
-----xxXXXXX-x---x---x-----------------xx<>-x----xxXXX-----x------------xx-[]-SSSSSSSSSSSS-x--SSS---S-----SSS?-----------------------xx<>S-xxxxxX---x------x
----xx--------x-x-----xxxx---xxx------xx-[]--x--xx-XXX------x----------xx--[]-SSSSSSSSSSSS--x----------------------xxx--------------xx-[]--<>-xXX----x----xx
---xx----------xx-----<>--xxxx--xxxxxxx--[]---xxx--XXX-------xxxx-----xx---[]------------S---x--------------------xxX-x------------xx--[]--[]-XXX-----x-xxx-
xxxx-----------<>-----[]-XXXXX--XXXXXXXXXXXXX--x---XXX-------XXX-xxxxxxXXXXXXXXXXXXXXXXXXX----xxxxxxxxxxxxxxxxxxxxxXX--xxxxxxxxxxxxx---[]XXXXXXXX------xx-E-
XXXXXXX--------[]---XXXXXXXXXX--XXXXXXXXXXXXX--XXXXXXXXXXXXXXXXXXXXXXXXXXXXXXXXXXXXXXXXXXX---XXXXXXXXXXXXXXXXXXXXXXXXXXXXXXXXXXXXXXXXXXXXXXXXXXXX------XX-X-