-------------------------------------------------------------------------------------------------------------------------------------------------------------
-------------------------------------------------------------------------------------------------------------------------------------------------------------
-------------------------------------------------------------------------------------------------------------------------------------------------------------
-------------------------------------------------------------------------------------------------------------------------------------------------------------
-------------------------------------------------------------------------------------------------------------------------------------------------------xxx---
--------------------------o--------------------------------------xxx------x------------------------------------xxx------------------------------------xx--x--
--------------------------XXoo-------------------------------xxxxx--x----xx-----------------------------------xx--x---------------------oooo----------xX---x-
--S-SSS--------------------XXXXXXXXXX----xxxxx-----------X--xxXXXX---x--xx?-----------------------------xxxxxxx----x-----------XXXXX----oooo---------xx-----x
----------------------------------------xx----x------XXXX--xx---------xxx------------------------------xx--x-XX-----x------xxxxxxxxxxxx-------------xx-------
----------------------xxxxxxxxxxxxxxx--xx-----ox-----xxxx-xx-----------x-----------------------xxxx---xx-------------xxxxxxx--------x--xxxx-xxxxxxxxx--------
----------------E----xx-XXXXX--------xxx--------x---xx---xx------------X----------------------xxXS-x-xx--------------XXXXXXX-------XX---x--xx------<>--------
-S------------------xx--------------XXXX---------x-xx----XXX----------X---------xxx----------xxXX---xx---------------------------------XE--XX------[]--------
-----------E-------xx-----------------------------xx-----------------XX---E----xx--x--------xxXXX----x---------------------------------------------[]--------
------------------xxX----------------------------XXX----------------XXX---E---xxX---x------xxXXXX----x---------------------------------------------[]--------
xxxxxxxxxxxxxxxxxxxXX------------------------------X----------------XXX---xxxxxXX----xxxxxxxXXXXX----SE--E----------------------------------------XXXX-------
XXXXXXXXXXXXXXXXXXXXX------------------------------X----------------XXXXXXXXXXXXXXXXXXXXXXXXXXXXXXXXXXXXXXXXXX-----------X------------------------XXXX----XXX