-------------------------------------------------------------------------------------------------------------------------------------------------------------
-------------------------------------------------------------------------------------------------------------------------------------------------------------
-------------------------------------------------------------------------------------------------------------------------------------------------------------
-------------------------------------------------------------------------------------------------------------------------------------------------------------
-------------------------------------------------------------------------------------------------------------------------------------------------------------
-----------------xxx-----------------------------------------------------------------------------------------------------------------------------------------
---------------xxx--x----xxxxxxx-----------------------------------------------------------------------------------------------------------------------------
--------------xxXX---x--xx-SSQQ-x---------------------------------o------------------------------------------------------------------------------------------
-------------xxXXX----xxx--------x---------------------------------------------------------------------------------------------------------------------------
------------xxXXXX-----x----------x-----------xxx-------------xxxxxx-----------------------------------------------------------------------------xxx---------
-----------xxXXXXX-----X------S----x---------xx<-x-----------xxSSSS-x-------------------------------------------------------------xxxx------xxxxxx--x--------
----------xxXXXXXX-----XXX?---------x-------xx-[]-x--------xxx-------xx-------------------S---------------------QQQ--------------xx<>-xxxxxxx---<>---x-------
---------xxXXXXXXX-----XXX-----------x-----xx--[]--x--xxx-xx<>---------x------------E---E---------------------B-----------------xx-[]-XXXx-<>---[]----x----?Q
--------xxXXXXXXXX-----XXX------------x---xxX--[]---xxxE-xx-[]-------X--x-------------------------------------b----------------xx--[]-X----[]---[]-----x-----
xxxxxxxxxXXXXXXXXX----EXXX-------------xxxxXX--XXXXXEX<>XXXXXXXXXXXXXX---xxxxxxxxxxxxxxxxxxxxxxxxxxxxxxxxxxxxxxxxxxxxxxxxxxxxxxx---[]-X----[]-E-[]----X-xxxxx
XXXXXXXXXXXXXXXXXXXXXXXXXXXXXXXXXXXXXXXXXXXXX--XXXXXXX[]XXXXXXXXXXXXXXXXXXXXXXXXXXXXXXXXXXXXXXXXXXXXXXXXXXXXXXXXXXXXXXXXXXXXXXXXXXXXXXX----XXXXXXXXXXXXXXXXXX