XX--XX--XXXXXXXXXXXXXXXXXXXXXXXXXXXXXXXXXXX--XXXXXXX-XX----X-XX-X----X]XXXXXXXXXXXXXXXXXXXX-----------------------------------------------------------------
----XXX---------xxxxx--X---xxxxxxxxxxxxxxxX--XXXXXXX-XX----X----x-X--X>XXXXXXXxxxxxxxxXXXXX-----------------------------------------------------------------
----XXX--------x----xx-X--x---b----------xx--xxxxxx--[]-----xxxxxxx--xx-xxxxxxSXS----xxXXXX-----------------------------------------------------------------
--S--XX-------x------xxX-x----B-----------xxx-----xx-[]----x------xxx-xx------EBS-----xx-XX----xxx----------------------------------------------------------
------E------x--------xxx--------------------------xx<>---x--------------------XS------xxXXX--xx--x---------------------------------------------------------
------------x---------------------------------------xxx--x--------o--E?S?SS----XS-------xxXXSxx-------------------------------------------------------------
-----------x------------------------------------------xxx---o------------------X---------xxXxx-----x--------------------------------------------------SQSS--
----------x--oooo----------------ooo------------------------------------------------------xxx-------x----------------------------xxxxx--XXXX-------SSS-----S
---------x-------------------------------------------------------------------------------------------x--------------------------xx----x---------------------
--------x-----------------------o-------------------S----------------------SSQQ-----------------------xxxx---------------------xx------x----------------S---
--x----x----------------------------------------------------------------------------------------------XXX-x------------S------xx?-----E-x-------------xx-SS-
-xxxxxx----------------------------------------------------------------------------------------------------x-----------------xx------<>--x---xxx-----x<>x---
------------------------------------------------------------------------------------------------------------x---------------xx-------[]---x-xxX-x---xx[]-x--
x------------------------------------------------------------------------------------------------------------xxxxxxxxxxxxxxxx--------[]----xx-X--x-xx-[]--x-
--------------------------------------------------------------------------------------------------XX---------XXXXXXXXXXXXXXXXXXXX----[]----x--X---xx--XXXX-x
-------------------------------------------------------------------------------------------------------------XXXXXXXXXXXXXXXXXXXXXXXXXXXX--XXXXXXXXXXXXXXXXX