------------------------------------------------------------------------------------------------------------------------------------------------------------
------------------------------------------------------------------------------------------------------------------------------------------------------------
------------------------------------------------------------------------------------------------------------------------------------------------------------
------------------------------------------------------------------------------------------------------------------------------------------------------------
------------------------------------------------------------------------------------------------------------------------------------------------------------
------------------------------------------------------------------------------------------------------------------------------------------------------------
--E---------------------------------------------------------------------------------------------------------------------------------------------------------
-SSSS----------EXX---------------------SS--------------------------------------------XXXXX---------------SSQQX----------------------------------------------
-------------------------------------------------------------------------------------------------------------X-E--------------------------------------------
----------------------------xxx-----------o------------------------------------------------------------------X-X----------xxxx-E----------------------------
-------------------XX----xxxx--x------------E------------------------xxxx------------------------------------X-X?QQQQQ---xx---x-----oooooooooooooooooooooooo
----S-------------------xxXXX---x----SSSSSSSS-----xxxx----Q?QQQQ----xx<>-xxxxxxxxxxxxxxxx-------------------QX-----------x-----x----ooooooo-oooooooooooooooo
-----------------------xx--------x---------------xx<>-x------------xx-[]-XXXXXXXXXXXXXx--x---------E--------------------xx------xxxxxxxxxxxxxxxxxxxxxxxxxxxx
--------xxxxxxxxxx----xx----------x----------E--xx-[]--x----------xx--[]-XXX--------------x------------------Exxxxxxxxxxx-------XEXXXXXEXXXXXXXXXXXXXXXXXXXX
xxxxxxxxx------x--xxxxx------------xxxxxxxxxxxxxx--[]---xxxxxxxxxxx---[]-XXX---------------xxxxxxxxxxxxxxxxxxxXXXEEXXXXXX-----------------------------------
XXXXXXXXX----X-X--XXXXX-----------XXXXXXXXXXXXXXXXXXXXXXXXXXXXXXXXXXXXXXXXX----------------XXXXXXXXXXXXXXXXXXXXXXXXXXXXXX-----------------------------------