-------------------------------------------------------------------------------------------------------------------------------------------------------------
--------------------------------------------------------------------------xx---------------------------------------------------------------------------------
-------------------------------------------------------------------------x--x--------------------------------------------------------------------------------
------------------------------------------------------------------------xx---x-------------------------------------------------------------------------------
-----------------------------------------------------------------------xx-----x-----------------------------xx-----------------------------------------------
------------------------------------oxxx--------------------------xxx-xx-------xx--------------------------xx-x--o-----------------------xxx----xxx----------
-----------------------------------XXXE-x--------xxx-----o-------xx--xx--------X-x-------E----------------xx---x--oooo------------------xx--xxxxx-ox---------
--------------------E--------------------x------xx--x---oo------xx---XX-----------x----------------------xx-----x----o-----------------xxX----XXX---x--------
------------------------E-----------------x----xx----x--E------xx------------------x---------------------x-------x--------------------xxXX-----------x-------
---------------------xxxo------------------x--xx------x-----xxxx-----o--------------x-------------------xx--------x------------------xxXXX------------x-xxxx-
--------------------xx----------------------xxx--------xx--xxXXX-----o---------------x-----------------xxE---------x-?--------------xxXXXX-------------xx---x
-----------xx-----xxx-----------------------XXX-----XXXXXxxx--------------------------xxxx------------xx<>----------x--------------xxXXXXX-------------XX---X
-xxxx-----xx-x---xx<>------------------------------------XXX-------------------------XXXX-x----------xx-[X------------------------xxEXXXXX->-----------X----X
xx<>-x---xxX--x-xx-[]-------?------------------------------X----------------------------XX-xxx--xxx-xx--[]-----------x----<>-----xxXXXXXXX<]-----------------
x-[]--xxxx-X---xx--[]--------------------------------------X------------XXX-------------XXXXX-xxxE-xxE--[]-------E----x---[]---xxxXXXXXXXX[]-----------------
XXXXXXXXXXXXXXXXXXXXXX----------------------------------x--X----------------------------XXXXXXXXXXXXXXXXXX-XXXXXXXX-XX----XXXXXXXXXXXXXXXXXXXXX---XXX--------