-------------------------------------------------------------------------------------------------------------------------------------------------------------
-------------------------------------------------------------------------------------------------------------------------------------------------------------
-------------------------------------------------------------------------------------------------------------------------------------------------------------
-------------------------------------------------------------------------------------------------------------------------------------------------------------
-----------------------------------------------------------------------------------------------------------------------------------------------o-------------
-----------------------------------------------------------------------------------------------------------------------------------------------XX------------
---------------------------xxx-------------------------------------------------------------------SSSSSSSSSSSSSSSSSSSSSSSS------SS---xx-----------------------
----------------SSS-------xx--x----------------------------------------------------------------------------------------------------xx-x--------E---xx--------
-------------------------xx-E--x----------------------------------------------------------------------------------------xxxxxx----xx---x----------xx-x-------
-------------------xxxxxxx------x---------------xxx---------------------------------------xxxxxxxxxxxxxxxxxxxxxxxxxxxxxxx-----xxxxx-----xxxxxx--xxx---x------
---------------xxxx-x--XXX-------x----------xxxxx--x-------------------------xxxx------xxxx------SSSSSSSSSSSSSSSSSSSSSSSS----XXXXXX------xX---xxxx-----x-----
--------------xx<>--X-------------x-xxx----xxXXXX---x-----------------------xx---x----xxXXX----------------------------------------------XX--XXXX-------x----
-------------xx-[]--X--------------xx--x--xx---------x---------------------xx--X--x--xx-------------------------------------------------XXX--------------xx--
xxxxxxxxxxxxxx--[]--X--------------<>---xxx-----------x----xxxx-----------xx---X---xxx-------------------------------------------------XXXX-------------<>-x-
x---x----x--x---[]--X--------------[]---XXX------------xxxxx---xxxxxxxxxxxx----X---XXX----------XXXXXXXXXXXXXXXXXXXXXXXXX--------------XXXX-------------[]--x
X---X----X--XXXXXX--X--------------[]-----------------XXXXXX--XXXXXXXXXXXXXXXXXX----------------XXXXXXXXXXXXXXXXXXXXXXXXX--------------XXXX----------XXXXXXXX