-------------------------------------------------------------------------------------------------------------------------------------------------------------
-------------------------------------------------------------------------------------------------------------------------------------------------------------
-------------------------------------------------------------------xxxxxxx---------------------------------------------------------------------------------xx
------------------------------------------------------------SSXXXXX-------x-------------------------------------------------------------------------------xx-
------------------------------------------------------------[][]-----------x-----------------------------------------------------------------------------xx--
------------------------------------------------------------[][]------------x-----------------------------------------------E---------------------------xx---
------------------------------------------------------------<>[>-------------x-----------------------XX------------------------------------------------xx----
-----------S----------------------------------E---------------<---------------x-----E------------------S----------------------------------------------xx-----
----------------------------------------------xx-------------E-E---------------x---------------------------------------------------------------------xx------
----------xxxxxx--------xxxxxx---------------xx-x---------xxx-------------------x---------------------------------------------------------------xxxxxx-------
---------xx--oo-xxxxxxxxx--x--x-------------xx---x-------xx<>--xx----------------x-------------SSSS---xxxx--------------------o-----o-------xxxxx-XXXX-------
--------xx------XXXXXXEXX--X---x-----------xx-----x-----xx-[]xx--x----------------x---xxxx-----------xxXX-x-----SSSSS---------XX-----------xxXXXX------------
-------xx------------------X----x---------xx-------x---xx--[]----------------------x-xx<S-x---------xx-----x------------------------------xx-X---------------
------xx-------------------X-----xxxxxxxxxx---------xxxx---[]-----------------------xx-[]--xxxxxxxxxx-------x----------xxx---------------xx----------------Xo
xxxxxxx--E-E---------------X----XXXXXXXXXXX---------XXXXXXXXX--------------XX------XXXXXXXXXXXXXXXXXXX-------xxxxxxxxxxx--xxxxxxxxxxxxxxxx------------------X
XXXXXXXXXXXXXXXX-----------X-----XXXXXXXXXX---------XXXXXXXXX-----x----------------XXXXXXXXXXXXXXXXXX----XXXXXXXXXXXXXXX--XXXXXXXXXXXXXXXXXXX----------------