XXXXXXXXX---XXX--X--XXX-----XXXXXXXXXXXX---------------------------------------------------------------------------XXXXXXXX--XXXXXXXXXXXXXXXX-XXXXXXXXXXXXXXX
--------E---xxx---x--xx-----XXXXXXXXXXXX---------------------------------------------------------------------------xxxxxxxx--xxxxxxxxxxxxxxxx-xxxxxxxxxxxxXXX
-----------x--xxxx-xx-xx----XXXXX---XXXX--------------------------------------------------------------------------x-------xxx---------------xx------b----xxXX
----------x------------xxx-xxXXXX---XXXX------------------------------------------------------------------------xx----------------------------------B-----xxX
---------x----------------xxxxXXX---XXXX--------------------------------------------------------------------------------------------Q---ooooo--------------xx
--------x-----------------XXExxXX---XXXX------------------------------------------------------------------------------------------------o--------------------
-------x------------------oX--xxX---xXXX---------------------------------------------------------------------------------------------------------------------
------x----------oo--------]---xx--xxxXX-----------------------------------------------------o-----------------SS--------------------------------------------
-----x-----------oo---SS---X----xxx--xxX----------------------------------------------------SS---------------------------XXXXXX----SQ------------------------
----x-----------o----------]----------xx-----------------------xxxx------------xxxx--xxxxx------------xx-----------------------------------------------------
---x-----------------------S-----------xx--------------------xxx--xx---------xxx---xxxXXX-x---------xxx-x------E---------------------------------------------
xxx-------------------------------------xx------------------xxXX----x-------xx<>---XXXE----x-------xx<>--x-----?Q--------------------------------------------
-----------------------------------------xx----------------xxXXX-----x-----xx-[]------------xx----xx-[]---x--------------------------------------------------
------------------------------------------xx-----xxx------xxXXXX------x---xx--[]------------X-x--xx--[]----x-------------------------------------------------
-------------------------------------------xxxxxxx--xxxxxxxXXXXX-------xxxx---[]------------X--xxx---[]-o---xxx----------------------------------------------
---------------------------------------------<>XXX--XXXXXXXXXXXXXXXXXXXXXXXXXXXX------------X--XXXXXXXXXXXXXXXXXX--------------------------------------------