----------------------------------------------------------------------------------------------------------------------------------------------------------------
----------------------------------------------------------------------------------------------------------------------------------------------------------------
----------------------------------------------------------------------------------------------------------------------------------------------------------------
-------------------------------------------------------------------------SX-------------------------------------------------------------------------------------
-------------------------------------------------------------------------[]----------ooo------------------------------------------------------------------------
-------------------------------------------------------------------------[]----------XXXX-----------------------------------------------------------------------
---------------------XXXX------------------------------------XS----------<>-SS----X------------XXXXXX---------------SSS---X-------------oo----------------------
----EXX--------------------------------------------------XX-EX-----------------------------------------------------------XX----XX------XXXX---------------------
---EXXX-------------------------------------------------XXXXXX------------E---------------------------------------------XXXXX---------------o-------------------
---XXXX------------------------------------------------XXXXXXXS--------------------------------------------------------XXXX----------------XXX------------------
---XXXX-XXX-------------XXX---------------------------XXXXXXXX----------<>----------------XXXX------------------------XXXXX-------------------------------------
---XXXX----------------------------------------------XXXXXXXXX----------[]-------------------------------------------XXXXXX-------------------------------------
---XXXX---------------------------------------------XXXXXXXXXX----------[]-----------XXXXXX--------------------E----XXXXXXX-E--------------------------------<>X
---XXXX--------<>----------------------------------XXXXXXXXXXX--X-------[]-----------------------------------------XXXXXXXX<>-------XXX---XXXXX--------------[]X
---XXXX--------[]------------X---------------EXXXXXXXXXXXXXXXXXXXXXXXXXXXXXXXXX------------------------------------XXXXXXXX[]------------------------E-------[]X
XXXXXXXXXX-----[]------------XXXXXXXXXXXXXXXXXXXXXXXXXXXXXXXXXXXXXXXXXXXXXXXXXX-------------------------------X----XXXXXXXX[]-------------------XXXXXXXXXXXXXX]X