----------------------------------------------------------------------------------------------------------------------------------------------------------------
----------------------------------------------------------------------------------------------------------------------------------------------------------------
----------------------------------------------------------------------------------------------------------------------------------------------------------------
--------------------------------------------------------------------------------------------------------------oooooo--------------------------------------------
-------------------------------------------SSSSSSSSSSSSSSSSSSSSSSSSSSSSSSSSSS?SSSSSSSSSSSSSSSSSSSS------------o-oo-o--------------------------------------------
----------------------------------------------------------------------------------------------------------------------------------------------------------------
--------------------------------------------------------------------------------------------------------------XXXXXX--------------------------------------------
-----------S-----------------------------------------E---E---E-----------ooooo----------------------------------------------------------------------------------
----------------------------------------------------<>--<>--<>--------------------------------------------------------------------------------------------------
----------------------------------------------------[]--[]--[]-----------SSSSS------------------------------------------E---------------------------------------
----------------------------------------------------[]--[]--[]-----------SSSSS-----------------------------------------<>---------------------------------------
-----------------------------------------------E--SS[]SS[]SS[]SS------------------E-----E------------------------------[]----------Q?-------------<>--------QQQ?
-----------<>-------------E-------------------<>----[]--[]--[]-------------------<>----<>------------------------------[]-----------------B-------[]------------
-----------[]---------E--<>----------E--------[]----[]--[]--[]-------------------[]----[]--------------X---------------[]-----------------b-------[]------------
-----------[]-------------------------------E-[]-E--[]--[]--[]-----------------E-[]----[]--------------X---------------[]-----------B-------------[]-E----------
XXXXXXXXXXXXXXXXXXXXXXXXXXXXXXXXXXXXXXXXXXXXXXXXXXXXXXXXXXXXXXXXXXXXX---XXXXXXXXXXXXXXXXX--------XXXXXXXXX-------------[]-XXXXXXXXXXXXXXXXXXXXXXXXXXXXXXXXXXXXXX