----------------------------------------------------------------------------------------------------------------------------------------------------------------
----------------------------------------------------------------------------------------------------------------------------------------------------------------
----------------------------------------------------------------------------------------------------------------------------------------------------------------
----------------------------------------------------------------------------------------------------------------------------------------------------------------
-----------------------------------------------------------------------------------------------------E----------------------------------------------------------
----------------------------------------------------------------------------------------------------------------------------------------------------------------
---------------------------------------o-ooo------------oooooo--------------------------------------------------------------------------------------------------
-----------------------------------XXX------------------oooooo--------XXX-----------------------------XX------XX------------------------------------------------
----------------------XX---o--X------------------------------------------------------------------------------XXX----------XX---o--------------------------------
------------------------------------------XX--------------------------o-o-----------------------------------XXXX------------------------------------oo----------
----------------o------o----------------------------------------------o-o-XXXXXXX--------------------------EXXXX-----------o------------------XXXXXXEXXXXX------
-----------------------o-------------------------E---E--------XXX-------------------------S----------------XXXXX-----------o---------------------------X--------
--------------------------------------------------------------X--------------------------------------------XXXXX---------------------------XXX----------------E-
---------------------------------------------XXXXXXXXXX-------X--------------------------------------------XXXXX------------------------------------------------
-----------E--------------XXXX------------------------X-------X---------------------EE---------------X-----XXXXX-----XXX------XXXXXXXXXXXXXXXX------------------
XXXXXXXXXXXXXXX------------------------XXXX-----------X-------X-----------------XX--XXXXXXXXXXXXXXXXXX-----XXXXX-------------------------------------------XXXXX