----------------------------------------------------------------------------------------------------------------------------------------------------------------
----------------------------------------------------------------------------------------------------------------------------------------------------------------
----------------------------------------------------------------------------------------------------------------------------------------------------------------
----------------------------------------------------------------------------------------------------------------------------------------------------------------
----------------------------------------------------------------------------------------------------------------------------------------------------------------
----------------------------------------------------------------------------------------------------------------------------------------------------------------
-------------------------------------------------------------E----------XXXXX-----------------------------------------------------------------------------------
-----------------X-----------------------------------------SSSSSS---------------------------------------------------------------------------------------XX------
-----------------X-----------------------------------------------------------------XXXX------------------------ooo----------------------------------------------
-----------------X----------------------------------------------------------------------------------------------------------------------------------------------
-----------------X----------------------o-----------------------------------------------------o-----------------------------------------S-----------XX----------
-----------------X-------------------------------------<>-----SSS--------------E---------------------E--S---<>--------------------------------------X------XXX--
-----E--------E--X-------------------------------------[]---E-------X---------<>--------------------<>------[]--------------------------------------------------
-------------<>--X-------------------------------------[]-----------X---------[]----------------------------[]--------------------------------------------------
-------------[]--X-----------------------------------E-[]-----------X--------X[]X---------------------------[]--------------------------------E-----------------
XXX-X---XXXX-XX--XXXXXXXX-XXXXXXXXXXXXXXXXXXXXXXXXXXXXXXXXXXXXX-X-X-X---------------------XXXXXXXXXXXXXXXXXXXXXXXXXXXXXXXXXXXXXXXXXXXXXXXXXXXXX-----------------