----------------------------------------------------------------------------------------------------------------------------------------------------------------
----------------------------------------------------------------------------------------------------------------------------------------------------------------
----------------------------------------------------------------------------------------------------------------------------------------------------------------
-----------------------------------------------------------------------------------------------------------------------------------SSSSSSSS---------------------
------------------------------------------------------------------------------------------------------------------------------------------[------?---------SSSSS
--------------------------------XXX-------------------------------------------------------------------------------------------------------[---------------------
--------------------------------XX----------------------------------------XXXX--------------------E---------------------------------------[---------------------
---SSSSSSSSSSSSSS---------------XX---------------------------ooo----------------------------------S---------Eooo--------------------------[---------------------
--------------------------------XX------------------------E--ooo--------------------------------------------o--o--------------------------<------------S--------
--------------------------------XX----------------------------------------------------------------?----------------E--------------------------------------------
-------SSSSSSSSS----------------XX---------------------XXXXXXX-------------------------------------------------XXXXXX--------------------------SS---------------
-----SS-------------------------XX-------<>---------------------------------------------E-----------------------------------XXXXXX-------S----------------------
---<>---------------------------XX-------[]---------------------------------------------X---------X----XXXXX-----------------------oooo--S-----------------SS-<>
---[]---------------------------XX-------[]------------------------------o------<-------X---------X----X---------------------------oooo--S--<>---------<>--SS-[]
---[]----E---E------------------XX-------[]--------------------XXXXXXXXX-X------[-------X---------X----X---------------------------XXXX--S--[]---------[]--SS-[]
XXXXXXXXXXXXXXXXXXXXXXXXXXXXXXXXXXXXXXXXXXXXXXXXXXX-----------------------------XXXXXXXXXXXXXXXXXXXX---X---------------------------XXXX--S-XXXXXXXXXXXX[]--XX-XX