----------------------------------------------------------------------------------------------------------------------------------------------------------------
----------------------------------------------------------------------------------------------------------------------------------------------------------------
----------------------------------------------------------------------------------------------------------------------------------------------------------------
----------------------------------------------------------------------------------------------------------------------------------------------------ooo---------
----------------------------------------------------------------------------------------------------------------------------------------------------o-o---------
----------------------------------------------------------------------------------------------------------------------------------------------------------------
-------------------X-------------------------------------------------------------XXXXXXX------------------------------------------------------------XXX---------
------------------XX----XXX-----XX--------------------------XX--------------------------------------------------------------------------------------------------
-----------------XXXXX--------------------------------------------------------------------------------------------E-----------------------------E---------------
----------------XXXX-----------------------------E--oooo------------------------------------------E--------------------------------------------<>---------------
---------------XXXXX-------------------------XXXXXXXEXXXXX-----------------------------------XXXXXXXX-------XX---X-----------------------------[]---------------
---------------XXXXX--------XX-----XXXXXXX----------------------------------------------------------------------XX-----------------------------XX---------------
-------------XXXXXXX-E---------------------------------------------<>-------------------------------------------XX--XXXXXX--------------------------------------
------------XXXXXXXX<>---------------------------------------------[]-------------------------------------------XX-------X------------------<>------------X-----
---------------XXXXX[]---------------------------------------------[]--XEXEXXXX---------------------------------XX-------X-------------X----[]------------X-----
XXXXXXXXXXXXXXXXXXXX[]---------------------------------------------[]----------------------------------XX-------XX-------X------XXXXXXXX-XXXXXXXX---------X-XXXX