----------------------------------------------------------------------------------------------------------------------------------------------------------------
----------------------------------------------------------------------------------------------------------------------------------------------------------------
----------------------------------------------------------------------------------------------------------------------------------------------------------------
----------------------------------------------------------------------------------------------------------------------------------------------------------------
--------SSSS----------------------------SSSSSSSSSSSSSSSSSSSSSSSSSSSSSSSSSSSSSSSS--------------------------------------------------------------------------------
--------------------------------------------------------------------------SSSSSS--------------------------------------------------------------------------------
-------------------------Q-?-Q--------------------------------------------SSSSSS---------------------------------------E----------------------------------------
--------------------------------------------------------------------------SSSSSS-----------------------------E--------<>----------------------------------------
------------------------------------XXX-----------------------------------SSSSSS--------------------------------XXX---[]----------------------------------------
--------------------------------------------------------------------------SSSSSS--------------------------------------[]----------------------------------------
-------------------------E-------------------E---------XXX--XXXX----------SSSSSS--------------------------------------[]----------------------------------------
------------------XXXXXXXEXXXXXXXX----------<>-------------------------------SSS--------------------------------------[]--------<>------------------------------
--------SSSSSSS-S---------------------------[]-----E-------------------------SSS--------------------------------------[]---E----[]------------------------------
--------SSSSSSS-S---------------------------[]----------------------<>-------SSS--------------------------------------[]--------[]------------------------------
--------SSSSSSS-S---------------------------[]------X---------------[]----------------------EE------------------------[XX-------[]------------------------------
--------XXXXSSS-S------------------------XXXXX--XXXXX---------------XXXXXXXXXXXXXXXXXXXXXXXXXXXXXXXXXX----------------XXXXXXXXXXXXXXXXXXXXXXXXXXXXX-XXXXXXXXXXXX