----------------------------------------------------------------------------------------------------------------------------------------------------------------
----------------------------------------------------------------------------------------------------------------------------------------------------------------
----------------------------------------------------------------------------------------------------------------------------------------------------------------
----------------------------------------------------------------------------------------------------------------------------------------------------------------
-----------------------------SSSSSSSSSSSSSSSSSSS----------------------------------------------------------------------------------------------------------------
-----------------------------SSSS---------------------------------------------------------------------------------------------------E---------------------------
-----------------------------SSSS-----------------------XX----------------------------XX---XX------------XXXXXX-------------------------------------------------
-----------------------------SSSS----------------------------------------------------------[]-------------------------XXooo-------------------------------------
-------------------------------------------------------------------------------------------[]------XXX----------------------------------------------------------
-------------------------------------------------------------------------------------------[]------oo-----------------------------------------------------------
-------------------------------E-----------------------------------------------------------[]-------------------------------------------------------------------
------------------------------<>------------E----------------------------------------------<>----------------------XXX------------------------------------------
----------<>------B-----------[]---<>------<>--E----------------<>------XXXXXXXX------------------------------------------XXXXXXXX------------------------------
----------[]------b-----------[]---[]------[]-<>---<>-----------[]--------------------------E------------------------------------X-------------E----------------
-----E----[]------BEE---------[]---[]----E-[]-[]---[]---XX------[]------------------------XXXXXX---------------------------------X-XXXXXXXXXXX<>XXXXXXXX--------
XXXXXXXXXXXXXXXXXXXXXXXXXXXXXXXXXXXXX--XXXXXXXXXXX-[]-----------[]XXXXXX------------------XXXXXX---------------------------------X-XXXXXXXXXXX[]XXXXXXXXXXXXXXXX