----------------------------------------------------------------------------------------------------------------------------------------------------------------
----------------------------------------------------------------------------------------------------------------------------------------------------------------
----------------------------------------------------------------------------------------------------------------------------------------------------------------
--------------------------------------------------------------------------------------------------------------------------------------------------------------S-
----------------------------------------------------------------------------------------------------------------------------------------------------------------
----------------------------------------------------------------------------------------------------------------------------------------------------------------
-------------------------------------------------------------------------------------------------------------------------------------oo---------------------XXXX
-----------SSSSSSS-------S?SS?SS-------------------------------------------------------------------SSSS-SS--------------XX--------------------------------?-XXX-
-----------------------------------------------------------------------------------------------------------------------XXX--------------------------------------
----------------------------------------------------------------------------------------S-----------------------------XXXX--------------------------------------
----------------------------------------------------------------------------------------------------------------------XXXX--------------------------------------
-----------QQQ----------SSSSSSSS-----------XXXXXX------------------------------------------------X?-------------------XXXX-----------------------Q--------S-----
----------------------------------<>------------X--<>-----------------------------------S-------XX-----------XXX------XXXX----------------------------<>--------
----------------------------------[]------------X--[]-----------------------------------S-------XX-------------X------XXXX----------------------------[]---XX---
----------------------------------[]E-----------X--[]-----XX--------E---------EXXXXX<>XXXXXXXXXXXX-------------X------XXXX----X-----------------------[]E--XXXXX
XXXXX--XXXXXXXXXX-XXXXXXXXXXXXXXXXXXXXXXXXXX----X--XX---------------XXXXXXXXXXXXXXXX[]XXXXXXXXXXXXXXXX-----XXXXXXXXXXXXXXX------------XXXXXXXXXXXXXXXXXXXXXXXXXX