----------------------------------------------------------------------------------------------------------------------------------------------------------------
----------------------------------------------------------------------------------------------------------------------------------------------------------------
----------------------------------------------------------------------------------------------------------------------------------------------------------------
----------------------------------------------------------------------------------------------------------------------------------------------------------------
-------------------------------------------------------------------------------------------XXXXXXXXXXXX---------------------------------------------------------
-------------------------------------------------------------------------------------------XXXXXXXXXXXX---------------------------------------------------------
-----------------------------------------------------SSSSSSSSSSSSSSSSSSSSSSX------?--------XXXXXXXXXXXX--------------------------------------------E------------
--------SSSS---------------------------------------------------------------X------E--------XXXXXXXXXXXX-------------SSSS--------------------------SQSSS---------
---------------------------------------------------------------------------X---------E-----XXXXXXXXXXXX--E------------------------------------------------------
----------------------------------------------------------------------E----X--E-----<>-----XXXXXXXXXXXX-<>------------------------------------------------------
------------------X-----------XXX----QQQQQQQQQQQQQQ---XX-------------<>---?X-<>-----[]-----XXXXXXXXXXXX-[]------------------------------------------------------
--<>---XXXXXXXX------X--------------------------------X-----------E--[]----X-[]-----[]-----XXXXXXXXXXXX-XX--------------------ESSSSQ--------E-----SQSSS---------
--[]---X---------------------------------------------EX----------<>--[]----X-[]-----[]--<>-XXXXXXXXXXXX--------------E---------------------<>-----------------<>
--[]---X----------------------------X---------------BXX----------[]--[]----X-[]-----[]--[]-XXXXXXXXXXXX----B--------<>----------------------------------------[]
--[]---X---------------------------XXXXXXXXXXXXXXXXXXXX----------XXXXXXXXXXXXXXXXXXXXX--[]-XXXXXXXXXXXX-------------[]--------------------------E----------E--[]
XXXX-XXXXX----------------------XXXXXXXXXXXXXXXXXXXXXX-----------XXXXXXXXXXXXXXXXXXXXX--XXXXXXXXXXXXXXXXXXXXXXXXXXXXXXXXXXXXXXXXXXXXXXXXXXXXXXXXXXXXX-X-XXXXXXXX