----------------------------------------------------------------------------------------------------------------------------------------------------------------
----------------------------------------------------------------------------------------------------------------------------------------------------------------
----------------------------------------------------------------------------------------------------------------------------------------------------------------
----------------------------------------------------------------------------------------------------------------------------SSSSSSSSSSSSSSSSSSSSSSSSSSSSSSSSSSSS
----------------------------------------------------------------------------------------------------------------------------------------------------------SSSSSS
----------------------------------------------------------------------------------------------------------------------------------------------------------SSSSSS
----------?--XXXXX--------------------------------------------------------E-------------------------------------------------------------------------------SSSSSS
-------------------------------------------XX----------------SSSSSSSSSSSSSSSSSSSSSSSSSSSS-------------------------------------SSS-------------------------------
------------------------------------------------------------------------------------------------------------------------------SSS--SSSSSSSSSS-------------------
------------------------------------------------------------E-----------------------------------------------------------------SSS--SSSSSSSSSS-------------------
---------EX--------XXXXX--------------X---------------------------SSSSS---E--------------------------------------------------?SSS--SSSSSSSSSS?SS?SS???????SSSSSS
-----------------------------------QQQX--------------<>---S?S---SS--------QQ?---------<>----------------------X---------------------------------SSSSSSSSSS------
-----------------------------------------------------[]-------<>----------------------[]-----<>--------------XXX-----------------<>-------------SSSSSSSSSS------
------------o-----------<><>-------------------------[]-------[]----------------------[]-----[]-------------XXXX----XXXX---------[]-----------------------------
------------X-----------[][]-----EE---------------E--[]-------[]----E-----------------[]-----[]--E------EXXXXXX--------X----XXXXXXXXXXXXXXXXXXXXXX-XXXXXXXXXXXXX
XXXXXXX-----------XX---XXXXXXXXXXXXXXXXXXXXXXXXXX--XXXXXXXXXXXXXXXXXXXXXXXXXXXXXXXX---XX--XXXXXXXXXXXXXXXXXXXXX--------X----XXXXXXXXXXXXXXXXXXXXXX-XXXXXXXXXXXXX