----------------------------------------------------------------------------------------------------------------------------------------------------------------
----------------------------------------------------------------------------------------------------------------------------------------------------------------
----------------------------------------------------------------------------------------------------------------------------------------------------------------
----------------------------------------------------------------------------------------------------------------------------------------------------------------
----------------------------------o-------------------------------------------------------SSSSSSSSSSSSSSSS------------------------------------------------------
----------------------------------X-------------------------------------------------------------------------------------------------------------------------E---
----------------------------------XX-----------ooooooo-------SSSS---------------------?----------------------------------------------------XXX------------------
----------------------------------X--o-------SSSSSSSSSSSSS------------------------------------------------SSSSSS------------------------------------------------
-------------------------------------XXoo-----------------------------XX---o----------E----------------------------------------------------------E--XXXXXXX-----
----------------------------------------------------------------------------------------------------------------------------------------------------------------
-------------------------------------------------------E--------X------o----------------------------------------------------------------------------------------
-<>--------------------------------------------?SSSSSSSSSSSSSSSSX------o--------------------------------------E----------------------------------------------XXX
-[]-------------Q?QQ----------------------------------------------------------------------SS-<>-----------------------------------------------------------------
-[]---------------------------------------------------------------------------------------SS-[]-----------------------------------------------------------------
-[]-------------------------------------------------E---------------------XXXXX-----------SS-[]-----------------------------------------------------------------
XXX-XXXXXXXXXXXXXXXXXXXXXXXXXXXXXXXXX--------XXXXXXXXXXXXXXXXXXXX-------------X-----------XX-XX-----X----XXXXXXXXXXXXXXXXXXX--XXXXXX-X--------------------------