----------------------------------------------------------------------------------------------------------------------------------------------------------------
----------------------------------------------------------------------------------------------------------------------------------------------------------------
----------------------------------------------------------------------------------------------------------------------------------------------------------------
----------------------------------------------------------------------------------------------------------------------------------------------------------------
----------------------------------------------------------------------------------------------------------------------------------------------------------------
----------------------------------------------------------------------------------------------------------------------------------------------------------------
-----------------------XXE--------------XXXX------------------------------------E-----------X---XX-----X-----------------------E--------------------------------
------------------------------------XX------------------------------------SSSSSSSS--------------------------X-----------------SSSS---------?--------------------
----------------------------------------------------------------------------------------------ooooooo------XX----------------X----------------------SSS---------
----------------------------------------------------------------------------------------------ooooooo-----XXX----------------X----------------------------------
---------------------------------X--------------oooo---------------------------S--------------------E----XXXX---------?------X----------------------------------
--------------------------------XX-------------XXXXXX---------<>-------------SS-SS-----------------<>---XXXXX-----<>--------SX-------------Q-------X------------
----------XXXXXX----------------XX----------------------------[]------QQ---<>-----------------E----[]---XXXXX-----[]-------------------------------X------------
-<>-----------------------XX----XX----------------------------[]-----------[]----------------<>----[]---XXXXX-----[]----------------------------<>-XX-----------
-[]------------XXXX-------------XX----------------------E-----[]-----------[]----------------[]----[]---XXXXX-----[]----------------------------[]-XX-----------
XXXXXXXXX------X--X-------------XX------------------XXXXX--XXXXXXXXXXXXXXXXXXXXXXXXXXX-------[]----[]---XXXXXXXXXXXXXXXX<>XXXXXXXXXXXXXXXXXXXXXXXXXXXXXXXXXXXXXX