----------------------------------------------------------------------------------------------------------------------------------------------------------------
----------------------------------------------------------------------------------------------------------------------------------------------------------------
----------------------------------------------------------------------------------------------------------------------------------------------------------------
----------------------------------------------------------------------------------------------------------------------------------------------------------------
----------------------------------------------------------------------------------------------------------------------------------------------------------------
----------------------------------------------------------------------------------------------------------------------------------------------------------------
-----------------------------SSS--------S-----------------------------------------------------------------------------------------------------------------------
-----------------------Q-----------------S-------------------------------------------------------------------------XX-----XXX-----XXX------QQQX-----------------
-------------ooooo------------------------------------------------------------------------------S-----------------XXX---E--------XXXX---------X-----------------
-----------------------------X------B-----------------------------------------------------------------ooo--------XXXX-----------XXXXX---------X-----------------
-----------------------------XEE----b-----------------------------------------------------------------ooo-------XXXXX----------EXXXXX---------X-----------------
----------<>---------S?SQS---XSSSSSSXSSSQQQ-------------------------------------Q------------------------------XXXXXX----------XXXXXX-----E?QQX----<>-----------
----------[]------------------------------------------------------------<>------------------------------------XXXXXXX----------XXXXXX--------------[]--------XXX
----------[]------------------------------------------------------------[]----------------------X---XXXXXXXXXXXXXXXXX----------XXXXXX---------E----[]-----------
----------[]------------------------------------------------------------[]------------------X---X---X--------XXXXXXXX----------XXXXXX--------------[]-----------
XXXXXXXXXXXXXXXXXXXXXXXXXXXXXXXXXXXXXXXXXXXXXXXXXXXXXXXXXXXXXXXXX-XXXXXXXXXXXXXXXXXX<>XXXXXXX---X---X--------XXXXXXXX----------XXXXXXXXXXXXXXXXXXXXXXXXXXXX-----