----------------------------------------------------------------------------------------------------------------------------------------------------------------
----------------------------------------------------------------------------------------------------------------------------------------------------------------
----------------------------------------------------------------------------------------------------------------------------------------------------------------
----------------------------------------------------------------------------------------------------------------------------------------------------------------
--------------------------------------------------------------------------------oo------------------------------------------------------------------------------
-------------------------------------------------------------------------------XXXX-----------------------------------------------------------------------------
---------------------------------------------------------------------o------------------------------------------------------------------------------------------
-----------XXX--------------------------E---------------XX-----------XX-----------------------------------------------------------------------------------------
-------------------------------------------XSSS-------------------------o----------------------ooo--------------------------------------------------------------
------------------------------------------XXX--------------------------XXX------------------------------------------------------------------------oooo----------
-----------------------<>----------------XXXS-----------------------------------------------------------------------------------------------------oooo----------
---------XX------------[]--------------<>XXXX----------------------------oooooo------------------------------E--------------------------XXEXX-------------------
--B--------------------[]--------------[]XXXX-SSS-----------------------------------------------------------<>-------------------------XXX--X--------------X----
--b--------------------[]-------------X[]XXXX--------E--------o-------XXXXXXXXXX-----------------------------------------------X------XXX---X----XXXXXX---XXX---
--BEE-------------XXXXXXXXXXXXXXXXXXXXX[]XXXX------X<>--------X----------------------------------------------------------------X-----XXXX---X-------------XXXXXX
XXXXXXXXX--XXXXXXXXXXXXXXXXXXXXXXXXXXXXXXXXXXXX---XX[]------------------------------XXXXXXXXXXXXXXXXXXXXXXXXXXXXXXXXXXXXXXXXXXXXXXXXXXXXX---X-------------XXXXXX