----------------------------------------------------------------------------------------------------------------------------------------------------------------
----------------------------------------------------------------------------------------------------------------------------------------------------------------
----------------------------------------------------------------------------------------------------------------------------------------------------------------
----------------------------------------------------------------------------------------------------------------------------------------------------------------
----------------------------------------------------------------------------------------------------------------------------------------------------------------
------------------------------------------------o-o-------------------------------------------------------------------------------------------------------------
----------------------------------------------X-o-o-----------------------ooo-----------------------------------------------------------------------------------
----------------------------?SSS------E-----------------------------------ooo---------------SQSSSSS-------------------------------------------------------------
-------------------------------------<>-------------------------------------------------------------------------------------------------------------------------
----------------------------------E--[]----------------ooooooo----------------------------------------------------------X---------------------------------------
--------------------------E------<>--[]----------XX----ooooooo----------------------------------E----------------------XX-------------o-------------------------
-------------------------<>---E--[]--XXX--E-------------------------E--E-----XXXXXXX--------S?SSSSSS----------B-------XXX--------------------------------ooooooo
-----B---B---------------[]--<>--[]------------------------------------------X-----------E--------------------b------XXXX----E--X-------------------------------
-----b---b------B--------[]--[]--[]------------------XXXXXXXXXXXXXXXXXXXX----X--------------------------------B-----XXXXX------XX-------------------------------
-------------------------[]--[]--[]------------------X------------------X----X-----------------------------------E-XXXXXX-----XXX----------XXXXXXXXXXXXXXXXXXXXX
XXXXXXXXXXXXXXXXXXXXXXXXXXXXXXXXXXXXXXXXXXXXX--------X------------------X----X-------XXXXXXXXXXXXXXXXXX--XXXXXXXXXXXXXXXXXXXXXXXXXXXX---------------------------