----------------------------------------------------------------------------------------------------------------------------------------------------------------
----------------------------------------------------------------------------------------------------------------------------------------------------------------
----------------------------------------------------------------------------------------------------------------------------------------------------------------
----------------------------------------------------------------------------------------------------------------------?-----------------------------------------
---------------------------------------------o-----------------------------------------?------------------------------------------------------------------------
-----------------------------------------------------------------------o-o-------------------------------------------------------------------E------------------
----------------------------------------------------oo-ooo-------------o-o-------------------------------------------S----------------XX------------------XXXX--
--------------------------------------------------------oo---------------------------XXX------------------------------------------------------------------------
--E-------------------------------------------------------------XXX--------------------------------------------------------E-------------XXX-------XXX----------
-<>---------------------------------------------------------------------------------------------------------------------------E---------------------------------
-[]---------------------------------------------------------------------XX--------XXXXXXXXX------XXXX-----XXXXXXXXXXXXXX----------------------------------------
-XX-------------------E------------------------------XXX--XXXX--------------------------------------------------------------------------------XXX---------------
----------------------X---<>---------B--------------------X-----------------------------------XXX------------------------------XXXXXX---------------------------
----B-----------------X---[]---------b-----XX-XXXXX-------X-----------------------------------------------------------------------------------------------------
------XEEXEXXXX-------X---[]E---------------------X-------X-------------------------------XXXXXXX------XXX------------------------------------------------------
XXXXXXX------------XXXXXXXXXXXXXXXXXXXXXXX--------X-------X-----------------------------------------------------------------------------------------------------