----------------------------------------------------------------------------------------------------------------------------------------------------------------
----------------------------------------------------------------------------------------------------------------------------------------------------------------
----------------------------------------------------------------------------------------------------------------------------------------------------------------
----------------------------------------------------------------------------------------------------------------------------------------------------------------
----------------------------------------------------------------------------------------------------------------------------------------------------------------
----------------------------------------------------------------------------------------------------------------------------------------------------------------
----------------------------------------------------------------------------------------------------------------------------------------------------------------
--------------------------XXX----------------------------------------------------------------------------------------------------------------SSSSS----SQ--------
----------------------------------------------------------------------------------------------------------------------------------------------------------------
----------------------------------------------------------------------------------------------------------------------------------------------------------------
---------------------------------------------------------------------------------------------?------E-----------------------------------------------------------
--------S-------------------------------------XXXXXX-------------------------------oo--------------<>--------------------------------------------------S--------
-----------------------------------------------------------------------------------------<>---------------------------------------------------------------------
---------------B----------------------------------------------XX-------------------------[]---------------------------------------------<>----------------------
--------------------------------------------------------------XXX------------------------[]---------------------------------------------[]----------------------
XXXXXXXXXXXXXXXXXXXXXXXXXXXXXXXXXXXXXXXXXXXXXXX----X----------XXXXXXXXXXXXXXXXXX-XXXXXXXXXXXXXX<>XXXXXXXXXXXXXXXXXXXXXXXXXXXXXXXXXXXXX--[]XXXXXXXXXXXXXXXXXXXX--