----------------------------------------------------------------------------------------------------------------------------------------------------------------
----------------------------------------------------------------------------------------------------------------------------------------------------------------
----------------------------------------------------------------------------------------------------------------------------------------------------------------
-------------------------------------------------------------------------------------------------------------------------------------------------------SS-------
-------------------------------------------------------------------------------------------------------------------------------------------------------[]-------
-------------------------------------------------------------------------------------------------------------------------------------------------------[]-------
-------------------------------------------------------------XXXX--------------------------------------------------------------------------------------<>-------
---------------------------------------XXXX---------------------------------------------------------------------------XXXX---------------XXXXXX-----------------
-------------------------E-------------------------------------------------------------------------ooooo-------------EXXXX--------------XXXXXXX---------E-------
-----------------------------------XXX--------------------------------------------E---------------------------------EXXXXX-------------XXXXXXXX-----------------
----------------------------------------------------------------------------------X---------------------------------XXXXXX------------XXXXXXXXX-------<>--------
-------------QQQQQ?QQ------------------------------------------------------------XX-----Q-------<>-----------------XXXXXXX-----------XXXXXXXXXX-------[]--------
------------------------------------------------XXXXXXXXXX---------------->-----XXX-------------[]----------------XXXXXXXX----------XXXXXXXXXXX-------[]--------
--------E----------------------------------------------------------------<]----XXXX-------------[]---------------XXXXXXXXX---------XXXXXXXXXXXX-------[]--------
--XXXXX<>--EE----------X-------------------------------------------------[XXXXXXXXX-------------[]--------XXXXXXXXXXXXXXXXXXXXXXXXXXXXXXXXXXXXXXXXXXXXXXXXXXXXXX
XXXXXXX[]--XXXXXXXXXXXXX---XXXXXXX---------------------------------------XXXXXXXXXXXXXXXXXX-XXXXXXXXXXXXXXXXXXXXXXXXXXXXXXXXXXXXXXXXXXXXXXXXXXXXXXXXXXXXXXXXXXXX