----------------------------------------------------------------------------------------------------------------------------------------------------------------
----------------------------------------------------------------------------------------------------------------------------------------------------------------
----------------------------------------------------------------------------------------------------------------------------------------------------------------
----------------------------------------------------------------------------------------------------------------------------------------------------------------
----------------------------------------------------------------------------------------------------------------------------------------------------------------
-------------------E--------------------------------------------------------------------------------------------------------------------------------------------
-------------------------oo-o--------------------------------------------------------------------------------ooo------------------------------------------E-E---
-----------------------------------XXXX---------------------------------------------------------------------------------------------SSSSS---------------SSSSSSSS
----------------------------------------------------------------------------------------------------------------------------------------------------------------
----------------------------------------------------------------------------------------------------------------------------------------------------------------
----------------------------------------------------------------------------------------------------------------------------------------------------------------
-----------XX-------------XXXX--------------S------QQ--------------------<>-------------------------XXX--------------------------QQQQQ--------------<>----------
-------------------------------------------------------------------------[]-----------------------------<>------------------------------------------[]---E------
-------------------------------------------------------------------------[]-----------------------------[]------------------------------------------[]----------
---------------XXXXXX--------------------------------------E-------------[]-------------------E---------[]------------------------------------------[]----------
XXXXXX---------XXXXXX------------------XXXXXXXXXXXXXXXXXXXXXXXXXXXXXX-XXXXXXXXXXXXXXXXXXXXXXXXXXXXXX----[]-----XXXXXXXXXXXXXXXXXXXXXXXXXXXXXXXX-XXXXXXXXXXXXXXXX