----------------------------------------------------------------------------------------------------------------------------------------------------------------
----------------------------------------------------------------------------------------------------------------------------------------------------------------
----------------------------------------------------------------------------------------------------------------------------------------------------------------
-----------------------------------------------------------------------------------------------------------------------SSSSSSSSSSSSSSSSSSSSSSSSSSSSSSSSSS-------
----------------------------------------------------------------------------------------------------------------------------------------------------------------
-------------------------------------------------------------------------------------------------------------XXXXXXX--------------------------------------------
--------------------------------?QQQ----------------------------------------------------------------------------------------------------------------------------
--------------SS-------------QQQ----------------------------------------------------------E---------------------------------------------------------------------
------------------------------------------------------------------o---------------------------------------------------------------------------------------------
-------------------------------ESSSS-------------------------------E------------------------------------------------------------XXX--XXX--XXX--XXX--------------
-----------------------------SSS--------------------------------SSSSS--------------------------XXX------<>--------------------------------------------XXX-------
----<>--------SS--<>--------------------------------E-----------------------------------------------<>--[]-------------SSS-<>-----------------------------------
----[]------------[]---<>------X------------------------------------E----------------------XX-------[]--[]----------o--SSS-[]-----------------------------------
----[]------------[]---[]------X--------------------------------------------------------------------[]--XX----------X--SSS-[]-----------------------------------
--E-[]------------[]---[]---E--XXXXXXXXXXXXXXXXXXXXXXXX-XXXXXXXXXXXXXXXXXXXXXXXXXXXXXX--------------XX--XX-------------XXX-XX-----------------------------XXXXXX
XXXXXXXXXXXXXXXXXXXXXXXXXXXXXXX---------------------------------------------------------------------------------------------------------------------------------