----------------------------------------------------------------------------------------------------------------------------------------------------------------
----------------------------------------------------------------------------------------------------------------------------------------------------------------
----------------------------------------------------------------------------------------------------------------------------------------------------------------
----------------------------------------------------------------------------------------------------------------------------------------------------------------
----------------------------------------------------------------------------------------------------------------------------------------------------------------
----------------------------------------------------------------------------------------------------------------------------------------------------------------
---------------------------------------------------------XXXXX-----------------------------------------------------------------------------------------E--------
------------------SSSSSSS-SS------------------------------------------------------oo--------------------------------------------------------------SSQSSSS-------
--------------------------------------------------------------------------------------------------------------S-------------------------------------------------
----------------------------------------------------------------------------------------------------------------------------------------------------------------
--ooo--------------E------SS----------------E----o--------------------<>----------------------------------X-EE--------------------------------------------------
------------------SSSSS--------------------<>-----------------------?-[]----XXXXXX--XX----------SSSQ------XS?SS---X---------------QQQQ------------SSSSSSS------S
-----------------------------------------------------------------<>---[]---------------------------------------EE-X---------------------------------------------
-----------<>-------------------B------<>---------------o--------[]---[]----------------------------------SSSSSSSSX----------X-------------<>-------------------
-----------[]--------------------------[]---------------X--------[]---[]-----------------------------------------------------X-------X-----[]-------------------
XXXXXXXXXXXXXXXXXXXXX-XX----XXXXXXXXXXXXXXXXXXXXXXXXX------------XXXXXXXXXXXX-----------XXXXXXXXXXXXXXXXXXXXXXXXXXXXXXX-XXXXXXXXXXXXXX-----XXXXXXXXXXXXXXXXXXXXX