----------------------------------------------------------------------------------------------------------------------------------------------------------------
----------------------------------------------------------------------------------------------------------------------------------------------------------------
----------------------------------------------------------------------------------------------------------------------------------------------------------------
----------------------------------------------------------------------------------------------------------------------------------------------------------------
----------------------------------------------------------------------------------------------------------------------------------------------------------------
---------------------------------------------------------------------------------------------------------------------------XX-----------------------------------
--------------------------------------------------------------------------------------------------------------------------XX----------------------------E----E--
-----------------------------SSS----------XXXX-------------------------------------------------------XX------------------XXX---E---------------------SSSSSSSSSSS
------------------------------------------X-----------------------------------------------------------------------------XXXX------------------------------------
------------------------------------------X------------------------X---X-----------------------------------------------XXXXX-----X------------------------------
-----------------------------SSS-------X--X-------QQQQQQQ----------XSSSX-----<>---------------------------------------XXXXXX----XX---o--------------------------
--------------------------------------XX--X----------------------------------[]----------XX----------------X---------XXXXXXX--<>XX---------------<>-------------
--------------XXXXXX------------------XX--X----------------------------------[]--------<-X-----------------XX-------XXXXXXXX--[]XX---------------[]----X----X---
--------------------------------------XX-------------------------------------[]--------[---------<>--------XXX-----XXXXXXXXX-X[]XX---------------[]----X----X---
------XXXXXXX-------------------------XX----------XXXXXXXXXXXXXXXXXXXXXXXXEXXX]--------[---------[]--------XXXXXXXXXXXXXXXXX-X[]XX---------------[]----X----X---
XXXX----------------------------XXXXXXXXXXX-------XXXXXXXXXXXXXXXXXXXXXXXXXXXXXXXXXXXXXX---------[]--------XXXXXXXXXXXXXXXXXXXXXXXXX--XXXXXX-XXXXXXXXXXXXXXXXXXX