----------------------------------------------------------------------------------------------------------------------------------------------------------------
----------------------------------------------------------------------------------------------------------------------------------------------------------------
----------------------------------------------------------------------------------------------------------------------------------------------------------------
-----------------------------------------------------------------------------------------------------------------------------------------------------------ooo--
--------------------------------------------------------------------------------------------------------------------ooo-----------?------------------------o-o--
--------------------------------------------------------------------------------------------------------------------XXXX----------------------------------------
-----------------------------------------------------------------------------------------------------------------------------------------------------------XXX--
------EXXXX--------------------------------------------SS------SS--------------------------------XX--------E--------------------XXX-----------------------------
-----EXXXXX-------------------------------------------------------------------------------------XXX-------------------------------------------------------------
-----XXXXXX------------------------------------------------------------------------------------XXXX-----X-------------------------------------------------------
-----XXXXXX------o---------------------------------------------------------------------------XXXXXX----------------------XXXXXXXXXXXXXXX------------------------
-----XXXXXX----------------X-------------------?QQQ?-----------SS--------E-----------<>-----XXXXXXX----------XXXXXX---------------------------------------------
-----XXXXXX---------------XX-------------E-----------------------------------E--E----[]----XXXXXXXX-----------------XXXXXX----------------<>--------------------
-----XXXXXX--------------XXX-------------------B-------------------------------------[]---XXXXXXXXX---------------------------------------[]--------------------
-----XXXXXX--------------XXX-------------------b-E-B---------------------------------[]--XXXXXXXXXX-------ooo-----------------------------[]--------------------
XXXXXXXXXXXXXXXX-X-------XXXXXXXXXXXXXXXXXXXXXXXXXXXXXXXXXXXXXXXXXXXXXXXXXXXXXXXXXXXXXXXXXXXXXXXXXXX------XXX---------------------------XXXXXXXXXX<>XXXX--------