----------------------------------------------------------------------------------------------------------------------------------------------------------------
----------------------------------------------------------------------------------------------------------------------------------------------------------------
----------------------------------------------------------------------------------------------------------------------------------------------------------------
----------------------------------------------------------------------------------------------------------------------------------------------------------------
----------------------------------------------------------------------------------------------------------------------------------------------------------------
----------------------------------------------------------------------------------------------------------------------------------------------------------------
------------SSSS---------------------------------------X------------XX---------------------------------------oooo--------------------------------------XXXXXXX--
---S--------------------------------------E------------X-----------------------------SSS----------X----------oooo---------oo--XX--------------------------------
-------------------------------------------------------X--------------------------------------------E----------------------------------o------------------------
------------------------------------------------------EX------------------------------------------o----E--------------------------------------------------------
---------------X------------------------X-------------XX--------X----------------o-------oo-------o------------------------XX----------------------------------S
--SS----SSSSSSSX-------------X---------XX------------XXX--------X---------------------E-------<>------------XX--XX--XXXXXX--------------------------------------
----------------------------XX--------XXX-----------XXXX--------X-------XXXXX-----------------[]--------XX------------------------------------------------------
---------------------X-----XXX-------XXXX----------XXXXX-------EX-----------------------------[]----------------------------------------------------------------
---------------------XXXXXXXXXXXXXX-XXXXX---------XXXXXXXXXXXXXXX-----------------------------[]--------------------------------------XXXXXXXXXXXXXXXX----------
X-XXXXXXXXXXXXXX-----XXXXXXXXXXXXXXXXXXXXXXXXXXXXXXXXXXXXXXXXXXXX--------------X--XXXXXXXXXXXXXXX--------------------------------------------------------------X