----------------------------------------------------------------------------------------------------------------------------------------------------------------
----------------------------------------------------------------------------------------------------------------------------------------------------------------
----------------------------------------------------------------------------------------------------------------------------------------------------------------
----------------------------------------------------------------------------------------------------------------------------------------------------------------
----------------------------------------------------------------------------------------------------------------------------------------------------------------
----------------------------------------------------------------------------------------------------------------------------------------------------------------
----------------------------QQQ?QQQ?QQQ?QQQQ---------------------------------------------------------------------------------------------------------------XXXX-
-----------------------------------------[]--------------------------------------------------------------------XXXoo---XXX--XXX---------oo----------X-----------
-----------------------------------------[]--------------------------------XXXXXXX------------------------------------------------------------------------------
-----------------------------------------[]---------------------------------------------oooooooo----------------------------------------------------------------
-----------Q------------------SSSSSSSSSS-<>---------------------------------------------oooooooo----------------------------------------------------------------
--------------QQQQQ?-----------------------------------------------------------------------------------------XXX----XXXX-XXXX-XXXXXXXXXX--XXXXEXX---------------
-----------------------------E---E-------------------------------------------------------------------------E------------------------------------X---------------
----------X-------------------------------E--------------B---------------------------XXXXXXXXXXXXXXX--X-----------------------------------------X---------------
---------XXXXXXXXXXXXXXXXXXXXXXXXXXXXXXXX<>-XXXXXXXXXXXXXX---------------------------X----------------X-----------------------------------------X----------XXXX-
XXXXXXXXXXXXXXXXXXXXXXXXXXXXXXXXXXXXXXXXX[]-XXXXXXXXXXXXXX--XXXXXXXXXXXXX------------X----------------X---X-------------------------------------X---X-----------