----------------------------------------------------------------------------------------------------------------------------------------------------------------
----------------------------------------------------------------------------------------------------------------------------------------------------------------
----------------------------------------------------------------------------------------------------------------------------------------------------------------
----------------------------------------------------------------------------------------------------------------------------------------------------------------
----------E-----------------------------------------------------------------------------------------------------------------------------------------------------
----------------------------------------------------------------------------------------------------------------------------------------------------------------
-------------------------------------------------------------------------------------------------------------------------------------------------------oo-------
-----------XX-------------------------------E----------------------------------------------------------E---E--------E-------E--E-----------E-------E-----------X
---------------------------------------------------oo-----------------------------------------------E-----------------------------------------------------------
----------------------------------------------------ooo-------X----------E--------------------------------------------------------------------------------------
--Q----------------------------------------------------------XX---------<>-------------------E----SSSSSSSSSSSSSSSSSSSSSSSSSSSSSSSSSSSSSSSSSSSSSSSSS-------------
-----------------------------E--<>--------------------------XXX----E----[]------------?QQQQQQQQ---------------------------------------------------------XXXX----
-----B-----------------------E--[]-------E-----------------XXXX---------[]----------------------------ooooooooooooooooooooooooooooooooooooooooooo---------------
E----b--------------------------[]------------------------XXXXX---------[]------------B-----------------------------------------------------------------------X-
----------X---------------------[]-------------XXX-----XXXXXXXX---------XXXXXXXXXXX---b-E-------------ooooooooooooooooooooooooooooooooooooooooooo---------------
XXXXXXXXXXX--------XXXXXXXXXXXXXXXXXXXX-X---------------XXXXXXXXXX------XXXXXXXXXXXXXXXXXX-<><>---XXXXXXXXXXXXXXXXXXXXXXXXXXXXXXXXXXXXXXXXXXXXXXXXX-------------