----------------------------------------------------------------------------------------------------------------------------------------------------------------
----------------------------------------------------------------------------------------------------------------------------------------------------------------
----------------------------------------------------------------------------------------------------------------------------------------------------------------
----------------------------------------------------------------------------------------------------------------------------------------------------------------
----------------------------------------------------------------------------------------------------------------------------------------------------------------
-----------------------------------------------------------------------------------------------------------------------------------------------E----------------
--------------------------------------------------------------------E-------------------------------------------------------------------------------------------
------------------------------XXX------------------------S--------SSSSS-----------------------------------------------------------------------------------------
-------------------------------------------------------------------------------------------------------------oooo---------------------------------E-------------
-----------------------------------E--------------------------------------------------------------------------------------------------------X----------ooo------
------------------oo--------------------------o-----B--------------------------------------------------------------------------------------XX---------o-oo------
---<>-----------------------------XXX---------------b--QQQQQ?QQ--------------------------------------------------------------<>-----------XXX-------------------
---[]-----------------------------XX---<>--------------------------E---------------------------------------X-----------------[]----------XXXX-------XXXXXXXXXXXX
---[]----------------------------------[]------------------------------------------------------------------X-----------------[]---------XXXXX------------------X
---[]------------------X---------------[]-----------------------------------E------------E-----------------X-----------------[]--------XXXXXXXXXX--------------X
XXXXX-XXXXXXXXXXXXXXXXXX---------------XXXXXXXXXXXXXXXXXXXXXXXXXXXXXXXXXXXXXXXXXXXXXXXXXXXXXXXXXXXXXXXXXXXXXXXXXXXXXXXXXXXXXXXXXXXXXXXXXXXXXXXXXX--------------X