----------------------------------------------------------------------------------------------------------------------------------------------------------------
----------------------------------------------------------------------------------------------------------------------------------------------------------------
----------------------------------------------------------------------------------------------------------------------------------------------------------------
----------------------------------------------------------------------------------------------------------------------------------------------------------------
----------------------------------------------------------------------------------------------------------------------------SSSSSSSSSSSSSSS---------------------
----------------------------------------------------------------------------------------------------------------------------SSSSSSSSSSSSS-----------------------
--------------------------------------------------------------------------------------?-------------------------------------SSSSSSSSSSSSS-----------------------
------------------------------------------------EXX-------------------------------------------------------------------------SSSSSSSSSSSSS-----------------------
-----------------------------------------------EXXX-----------------------------------E-------------------------------------S-----------------------------------
-----------------X--X-----E--------------------XXXX---------------B---------------------------------------------------------S----------------oo-----------------
-----------------XSSX----<>------------------SSXXXX---------------b----------------------------------------------------------?ooooooo---------------------------
-------------------------[]--------------------XXXX--------E----SSXSSQ-----------------------Q--------<>-------XXSS?---------??SSSSSS----XXX--------------------
-------------------------[]-----------<>-------XXXX-------<>-----------<>-----------------------------[]-------XX-----------------------XXXX--------E-----------
-------------------------[]-----------[]-------XXXX--------------------[]-----------------------------[]-------XX--S-------------------XXXXX------------------XX
-------XXXXXXXXXXXXXXXXXXXXXXXXEE-----[]E------XXXX---E----------------[]-E---------------------------[]-------XX----------------EE---XXXXXX--------------------
XXXXXXXXXXXXXXXXXXXXXXXXXXXXXXXXXXXXXXXXXXXXXXXXXXXXXXXXXXXXXXXXXXXXXX-XXXXXXXXXX--------XXXXXXXXXXXXXXXXXXXXXXXXXXXX-------XXXXXXXXXXXXXXX---XXXX-X----XXX-----