----------------------------------------------------------------------------------------------------------------------------------------------------------------
----------------------------------------------------------------------------------------------------------------------------------------------------------------
----------------------------------------------------------------------------------------------------------------------------------------------------------------
----------------------------------------------------------------------------------------------------------------------------------------------------------------
----------------------------------------------------------------------------------------------------------------------------------------------------------------
----------------------------------------------------------------------------------------------------------------------------------------------------------------
---------------------------------------------------oo-------XXX-------------------------------------------------------------------------------------------------
-------------------------------------ooo----XXooo---------------------------------------------------------------------------------------------XXXX-----XXoo-----
-----------------------------E----------------------------------------------------------------------------------------------------------------------------------
----------------------------------------------------------------------------------------------------------------------------------------------------------------
---------------------------------E---------------------------------------------------------------------------------------------E---o----------------------------
----------------------------------XXX---XXXX----------------------------------------------------------------------------------<>-----------------XXXXXX----XXXXX
-------------------------------XXX--------------XX----------XXX-------------------------------------------------------------------------------------------------
----------------------------------------------------XXXX----------------------------------------------B---<>----------------------------------------------------
--------E----------XXX----XX--------------------------------------------------------------------------b---[]----------------------------------------------------
XXXXXXXXXXXXXXXXXXXXXX-----X-------------------------------------XXXXXXXXXXX-------XXXXXXXXXXXXXXXXXXXXXXXXXXXXXXXXXXXXXXXXXXXXXXXXXXXXXXXXXXXXXXX--------------