----------------------------------------------------------------------------------------------------------------------------------------------------------------
----------------------------------------------------------------------------------------------------------------------------------------------------------------
----------------------------------------------------------------------------------------------------------------------------------------------------------------
----------------------------------------------------------------------------------------------------------------------------------------------------------------
----------------------------------------------------------------------------------------------------------------------------------------------------------------
----------------------------------------------------------------------------------------------------------------------------------------------------------------
---------------------------------------------------E-----E------------------------------------------------------------------------------------------------------
-------------------------E-------------------XQQ?QQQQQ?QQQQQ?QQQX-----------------------------------------------------------------------------------------------
------------------------<>-------------------X------------------X------oooo-------------------------------------------------------------------------------------
------------------------[]-------------------X------------------X---------------------------------------------------------------X---------------X--------------X
------?------E---ooo----XXX------------------XE-E---E-E---E-E---X----------------------------------------<>--?-----------------XX--------------XX-------------XX
--<>--------<>-------------------------------XQQ-QQQQQ-QQQQQ-QQQX--------------------------------------?-[]-------------------XXX-------------XXX------------XXX
--[]---------------------------------------------------------------------------<>-------------------<>---[]---------------E--XXXX---------<--XXXX-----------XXXX
--[]-----------------------<>-----------------------------------E--------------[]-------B-----------[]---[]-----------------XXXXX---------[-XXXXX----------XXXXX
--[]-----------------------[]--------E-----------------------------------------[]E---------EE-------[]---[]----------------XXXXXX---------[XXXXXX---------XXXXXX
XXXXXXXX<>XXXXXXXXXXXXXXXXXXX-XXXXXXXXXXXXXXXXXXXXXXXXXXXXXXXXXXXXXXXXXXXXXXXXXXXXXXXXXXXXXXXXXXXXXXXXXXXXXXXXX<>XXXXXXXX-XXXXXXXXXXXXXXXXXXXXXXXXXXXXXXXXXXXXXX