----------------------------------------------------------------------------------------------------------------------------------------------------------------
----------------------------------------------------------------------------------------------------------------------------------------------------------------
----------------------------------------------------------------------------------------------------------------------------------------------------------------
----------------------------------------------------------------------------------------------------------------------------------------------------------------
----------------------------------------------------------------------------------------------------------------------------------------------------------------
----------------------------------------------------------------------------------------------------------------------------------------------------------------
----------------------E----E---------E--oooooooo----------------------------------------------------------------------------------------------------------------
-------------------SSSSSSSSSSSSSSSSSSSSSSSSSSSSSS-------------SS--------------SSSSSS---SSSSSSSS---------------------------------------SSS-----------------------
----------------------------------------------------------------------------------------------------------------------------------------------------------------
----------------------------------------------------------------------------------------------------------------------------------------------------------------
----SS-o------------------------------------------------Q-------------------------------E-------------------------------------ooooo----E------------------------
---------------------------------SS-----?SSSSSSSS---<>-------------------------S------SSS--------------------------------------------SSSS-------------<>--------
---------------------X----X----<>-------------------[]------E-------------X------E--------------------------------------------------------------------[]--------
-<>------------<>----X----X----[]-------------------[]-----<>-------------X---------------------------------------------------------------------------[]--------
-[]------------[]----X----X----[]-------------E-----[]-----[]------------EX---------------------------------------------------------------------------[]--------
XXXXXX---XXXXXXXXXXXXXXXXXXXXXXXXXXXXXXXXXXXXXXXXXXXXXXXXXXXXXXXXXXXXXXXXXXXXXXXXXXXXXXXXXX----XXXXXXXXXXXXXXXXXXXXXX-X-XXXXXXXXXXXXXXXXXXXXXXXXXXXXXXXX-XXXXXXX