----------------------------------------------------------------------------------------------------------------------------------------------------------------
----------------------------------------------------------------------------------------------------------------------------------------------------------------
----------------------------------------------------------------------------------------------------------------------------------------------------------------
----------------------------------------------------------------------------------------------------------------------------------------------------------------
---------------------------------------------------------------------------------------------------------------------------------------------------oo-----------
----------------------------------------------------------------------------------------------------------------------------------------------------------------
--------------------------------------XXXXXX-------------------------------------------oo---------------------o-ooo---------oo-----------Eoo----------XXX-------
----------------------------------------------------------------------------------ooo--XXo-------oo--------XX---------------oo-----------XXXX-------------------
----------------------------------------------------------------------------------------------------------------------------------------------------------------
-----------------------------------------------------------------------------------------------------------------XX---------------------------------------------
---------------------------------------------XXXX---------------E--------------------------------------------------------------------------------XXXXX----XX----
-----------------------E-------------------------------------------------------------XX---XXX-------?--------------------E----XXXXX----XXXXXXX------------------
---------------------------------------------------------------------------------XX-------------------------------------------X-------------------------------XX
--------------------------------------------------------------------------------------------------------X-----------XXXXXXX---X----------------o----------------
-----------------------XXXXX------------------------------------XXXXXXXXEXEXXXXX-----------------------XX-----------------X---X---------------XXX---------------
XXXXXXXXXXXXXXXXXXX------------XXXXXX-------XXX--XXXXXXXX<>XX---X-------------------------------XXX----XX-----XXXX--------X---X--------------------------XX-----