----------------------------------------------------------------------------------------------------------------------------------------------------------------
----------------------------------------------------------------------------------------------------------------------------------------------------------------
----------------------------------------------------------------------------------------------------------------------------------------------------------------
----------------------------------------------------------------------------------------------------------------------------------------------------------------
----------------------------------------------------------------------------------------------------------------------------------------------------------------
----------------------------------------------------------------------------------------------------------------------------------------------------------------
---------------------------------------------------------------------------------------------------------------E---------E-E-E----------------XXXXXXXXXX--------
-SSSSS------------------------------------------------------------------------------------------------------------------<><><>------------E---------------------
------------------------------------------------------------------------------------------------------------------------[][][]----------------------------------
---------------------------------------X--------------------------------------------------------------------E-----------QQQQQQ----------------------------------
--E-----------------------------------XX-------------------------------------------------------------------<>---------------------------------------------------
SSSSSSS------------------------------XXX---SSSS--------------------------------------------------------<>--[]-------?-------------------------------------------
-------------E----------------------XXXX---------------------E-----------------------------------------[]--[]--------------------<>-----------------------------
-----------------------------------XXXXX---------------------X-----------------------------------------[]--[]--------------------[]-----------------------------
----------------------------------XXXXXX---------------------X-------------------------X---------------[]--[]---XX------XXXXXXXXXXXXXXXXXXX---------------XXXXXX
XXXXXXXXXXXXXXXXXXXXXXXXXXXXXXXXXXXXXXXXXXXXXXXXXX-XXXXXXXXX-X--XXXXX<>XXXXXXXXXXXXXXXXXXXXXXXXXXXXXXXXXX--[]---XXX-----XXXXXXXXXXXXXXXXXXX---------------------