----------------------------------------------------------------------------------------------------------------------------------------------------------------
----------------------------------------------------------------------------------------------------------------------------------------------------------------
----------------------------------------------------------------------------------------------------------------------------------------------------------------
----------------------------------------------------------------------------------------------------------------------------------------------------------------
----------------------------------------------------------------------------------------------------------------------------------------------------------------
----------------------------------------------------------------------------------------------------------------------------------------------------------------
------------------------------------------------------------------------------------------ooooooo-----------------------------------------------------------o-oo
---------------------------------------------------X----------------------XXX-----------SSSSSSSSSSSS?SSS--------------------------oo--------------------------o-
--------------------------------------------------XX------------------------------------------------------------------------------------------E-----------------
---------oo--------------------------------------XXX-----------------------------------------------------------------------------------------------------------X
------XXXEXXXX---------------o------------------XXXX-------------------------------------------------------------------------------------E----------------------
----------------------QQQQ------------<>-----X-XXXXX------------------------XXXXX---------?SSSSSSSSSSSSS------------------------XX--XX--------------------------
--------------------------------------[]---EXXXXXXXX---------------------------------------------------------<>---------------------------------XXXXXXX---------
----------------------E---------------[]---XXXXXXXXX---------------------------------------------------------[]-------------------------------------------------
--------------------------------------[]--XXXXXXXXXXXXXXXXXXEEXEXXXXXX-------------------------E-------------[]--------------------------XXXX-------------------
----------------XXXXXXXXXXXXXXX-----XXXXXXXXXXXXXXXXXXXXXXXXXXXXXXXXXXXXXXXXX-----------XXXXXXXXXXXXXX-X-XXXXXXXXXXXX-XXXX---------------X--X---------------XXXX