----------------------------------------------------------------------------------------------------------------------------------------------------------------
----------------------------------------------------------------------------------------------------------------------------------------------------------------
----------------------------------------------------------------------------------------------------------------------------------------------------------------
----------------------------------------------------------------------------------------------------------------------------------------------------------------
----------------------------------------------------------------------------------------SSSSSSSSSSSSSSSSSSSSSSSSSSSSSSSS----------------------------------------
----------------------------------------------------------------------------------------S--SSS------SSSS-----------SSSSS----------------------------------------
-------------------------------------------------------ooo------------------------------S--SSS--E---SSSS-----------SSSSS-------------------------XXXX--------XX-
------------------------------SSSSS-----------------E--XXX--------------------------------------SS-----------------SSSSS----------------XXX---------------------
------------------------------------------------------------------------------------------------SS-----------------SSSSS----------------------------------------
------------------------------------------------------------------------------------------------SS-----------------SSSSS------------XX-----------------oo-------
---------------oo-----E-oo-----E-----------------------------------------------------------oo??-SS---E-------------SSSSS------------XX-----XX-------XXXEXXX-----
-----------------------------SSSSSS-------------------------------<>--------------------S--SSS--SS--SSSS-------<>-----SS-----------XXX-----XXX------------------
-------------------------------------------------E----?-----------[]-------?QQ---E---E--S----------EE-----SS---[]-----SS----------XXXX--------------------------
-------------------------------------------------X----------------[]--------------------S-----------------SS---[]-----SS--------X-XXXX--------------------------
------E------------------------------------------X----------------[]--------------------------------------SS---[]---------------X-XXXX--------------------------
XXXXX--XXXXXXXXXXXXXXXX----XXXXXX-XXXXXXXXXXXXX--X----XXXX-XXXXXXXXXXXXXXXXXXXXXXXXXXXXXXXXXXXXXXXXXXXXX--XXXXXXXXXXXXXXXXXXXXX-XXXXXX--------X-----------------