----------------------------------------------------------------------------------------------------------------------------------------------------------------
----------------------------------------------------------------------------------------------------------------------------------------------------------------
----------------------------------------------------------------------------------------------------------------------------------------------------------------
----------------------------------------------------------------------------------------------------------------------------------------------------------------
----------------------------------------------------------------------------------------------------------------------------------------------------------------
----------------------------------------------------------------------------------------------------------------------------------------------------------------
-------------------------------------------------------------------------------------------------------------------------------------------------SSSSSSSS-------
-----------------------------------------------------------------------------------------------------------------XXXX-------------------------------------------
----------------------------------------------------------------------------------------------------------------------------------------------------------------
-------------------------------------------------------------------------------E--------------------------------------------------------------------------------
--------------------------B--------------ooooo--------------------------------<>----------------------------------------X------QQ?QQQQ?-------------SSSSS-------
-----------B--------------b-------------XXXXXXX-----<>------------------------[]-----QQQQ----------------------------------E-----------------B----<>-------E----
-----------b----------------------------------------[]----------<>------------[]---------------<>XXXXXXXXXX---------------<>-----------------b----[]------------
-----------B----------------------------------------[]----------[]------------[]-----E---------[]XXXXX----X---------------[]-----------------B----[]------------
-------------------------------------------------E--[]----------[]------------[]---------------[]XXXXX----X---------------[]-XXXXEEXXXXXXXXXXXXXXXXXXXXXXXXXXXXX
XXXXXXXXXXXXXXXXXXXXXXXXXXXXXXXXXXXXXXX-------XXXXXXXX-XXXXXXXXXXXXXXXXXXXXXXXXX-XXXXXXXXX<>XXXX]XXXXX----X-----------XXX-XXXXXXXXXXXXXXXXXXXXXXXXXXXXXXXXXXXXXX