----------------------------------------------------------------------------------------------------------------------------------------------------------------
----------------------------------------------------------------------------------------------------------------------------------------------------------------
----------------------------------------------------------------------------------------------------------------------------------------------------------------
----------------------------------------------------------------------------------------------------------------------------------------------------------------
-----------------------------------------------------------------------------------------E----------------------------------------------------------------------
----------------------------------------------------------------------------------------------------------------------------------------------------------------
-------------------------------------------------------E--E----------------------------------------------------------------------oo-----------------------------
---------E------------------------------S----------SSSSSSSSSSS----------------------------XX-----------------------E--------------------------------------------
--------<>------------------------------------------------------------------------------------------------------------------<>----------------------------------
--------[]------------------------------------------------------------------------------------------------------------------[]----------------------------------
--------[]---------------o---------X----------------------E-----------------------------------------------------------------[]---------X------------------------
----<>--XXS----------------------SSX--QQQQ----------------QQ?QQ-------------------------------XXX--------XXX---------------QQQ?--------XSE--X---Q---------------
----[]-------------------------------------------E----X----------<>-------------------------------------XXXX---------SSS-S----------------E-X-------------------
----[]----------------------B-------------------<>----X----------[]-------B----------------------------XXXXX--XXXX---SSS-S-------------SSSSSX-------------------
----[]------------------------------------------[]----X----------[]----------------------X------------XXXXXX--X------SSS-S-----E-E------------------------------
XXXXXXXXXXXXXXXXXXXXXXXXXXXXXXXXXXXXXXXXXXX<>XXXXXXXXXXXXXXXXXXXXXXXXXXXXXXXXXXXXXXXXXXXXX-------XXXXXXXXXX---X-----XSSS-S-----XXXXXXXXXXXXXXXXXXXXXXXXXXXXXXXXX