----------------------------------------------------------------------------------------------------------------------------------------------------------------
----------------------------------------------------------------------------------------------------------------------------------------------------------------
----------------------------------------------------------------------------------------------------------------------------------------------------------------
----------------------------------------------------------------------------------------------------------------------------------------------------------------
---------------------------------X-----------------------------------oo---------------------------------------------------------------------------------------SS
-------------------------------XXXX---------------------------?-----XXXX----E---------------------------------------------------------E-------------------------
------------------------------XX------------------------------------------------------------------------------------XXXXXX--E------SSSSSSSSSSSSSSS--------------
-----------------------------XXX---SSSSSSS-------------------------------------------------E------oooo---------------------------------------------------E------
----------------------------XXXX--------------------------E-----E--------XX--------------E----------------------------------------------------------------------
-<>-------------------X----XXXXX-------------------------XXXXXXXXX----------------------------------------------------------------------E-----------------------
-[]----E-------------XX----XXXXX----------EE-----------------------------------------Xo--------------------------------------------SSSSSS?SSSSSSSS--------------
QQQQQQQQQ?----------XXX--XXXXXXX-------<>---XX-XX----XXXX--------ooo---------XXXXX----XX--------------------------o---------------------------------------------
----------------E--XXXX--XXXXXXX--<----[]---XX-XX--------------------------------------------XXXXXX--XXXXX-----------------------------------------<>-----------
------------------XXXXX--XXXXXXX--[----[]---XX-XX-------XXXXXXXXXXXXX------------------------------------------------------------------------------[]-----------
---------B-------XXXXXX--XXXXXXX--[----[]---X--XX----------------------------------------------------------------------------XXEXXXXXXXXXXXXXXXXXXXXXXXXXX------
XX-X-<><XXXXXXXXXXXXXXXXXXXXXXXXXXX----XX---X--XX----------------------------------XXX----------------------XXXXXXX----------XXXXXXXXXXXXXXXXXXXXXXXXXXXXXXXXXXX