----------------------------------------------------------------------------------------------------------------------------------------------------------------
----------------------------------------------------------------------------------------------------------------------------------------------------------------
----------------------------------------------------------------------------------------------------------------------------------------------------------------
----------------------------------------------------------------------------------------------------------------------------------------------------------------
----------------------------------------------------------------------------------------------------------------------------------------------------------------
----------------------------------------------------------------------------------------------------------------------------------------------------------------
------------------------SSSSSSSSSS-----------------E----------------------------------------------------------------XXX-----------------------------------------
--XSSSSSSS-----------E--------------------XXXX------------------------------------------------------------------------------------------------------------------
--X--------------------------------------------------XXX--------------------------------------------------------------------------------------------------------
--X------------------------------------------------------------------------------------------------------------------------------------------------------------<
-EX--E--------------------------------XX-------------------------------------SS--------------------------------------------------------------------------------[
--XSS>S-----------------------------------------XX----------------------------------------------------------------------------------<>-------------------------[
-----------------------------------------------------------------------E---------------------XXX<>----------------------------------[]----?------------?QQ-----[
-----------------------------------X-------------------XXXXX--------------------------------XXXX[]--?--------------------<>---------[]-------------------------[
-------EE---------XXXXXXXXXXXXXXXXXX-----------------------X--------------------------------XXXX[]-------E---------------[]---------[]----------------------X--X
XXXXXXXXXXXXXXXX--XXXXXXXXXXXXXXXXXX----X------------------X----------XXXXXXXXXXXXXXXX-XXXXXXXX-XXXX-XXXXXXX-------------[]XXXXXXXXXXXXXXXXXXXXXXXXXXXXXXXXXX--X