----------------------------------------------------------------------------------------------------------------------------------------------------------------
----------------------------------------------------------------------------------------------------------------------------------------------------------------
----------------------------------------------------------------------------------------------------------------------------------------------------------------
----------------------------------------------------------------------------------------------------------------------------------------------------------------
----------------------------------------------------------------------------------------------------------------------------------------------------------------
----------------------------------------------------------------------------------------XX----------------------------------------------------------------------
----------------------------------------------------------------------------------------XX----------------------------------------------------------------------
----------------------------------------------------------------oo----------------------XX--------------------------SSS----?SS-------SSSSS--S?SSSS--------------
----------------XXX-----------------------ooo------------------XX-----------------------XX----------------------------------------------------------------------
-------------------------------<>-------------------------------------------------------XX----------------------------------------------------------------------
-------------------------------[]------------------------oo-----------------------------XX----------------------------------------------E-----------------------
-------------------------------XXX-------------<>-----------------XX--------------------XX-------------Q------<------------------------SSS--SSSSSS---------X----
---------XXXXXXXX------------------------------[]---------------------------------------XX--------------------[---E-----E---B------E-----------------------X----
--------XXXXX----------------------------------[]---------------------------------------XX---<>---------------[--<>---------b-----<>-----------------------X----
-------XXXXXX----------------------------------[]---------------------XXXXXXXXE--X------XX---[]---X-----------[--[]---------------[]-----------------------X----
XXXXXXXXXXXXX----------XXXXXXXXXXXXXXXXXXXXXXXXXXXXXXXXXXXXXXXX------------------XXXXXXXXX---[]------XXXXXXXXXXXXXXXXXXXXXXXXXXXXXXXXXXXXXXXXXXXXXXXXXXXXXXXXXXX