----------------------------------------------------------------------------------------------------------------------------------------------------------------
----------------------------------------------------------------------------------------------------------------------------------------------------------------
----------------------------------------------------------------------------------------------------------------------------------------------------------------
----------------------------------------------------------------------------------------------------------------------------------------------------------------
----------------------------------------------------------------------------------------------------------------------------------------------------------------
------------------------------------------------------------------------------------------------------------------------------------------o-o-------------------
------------o-ooo-------------------------------------------------------------------------------------------------SSSSS-------------------o-o----XXXXXX---------
---------XX---------------------------------------------------------oo-------------------------------?-------------[]---------XXXXXXXXXXX------------------E----
-------------------------------------------------------------------------------------------------------------------[]--------XXXXXXXXXXXX-----------------------
---------------XX-----------------------------E--oo----oo----------------------------------------------------------[]-------XXXXXXXXXXXXX-----------------------
-----------------------------------------XXXXXXXXEXXXXXEXXXX---------XXXX-----------<>-----------------------------<>-------XXXXXXXXXXXXX--XX-------------------
---------------------------------------------------------------XX------------------X[]------?QQQQQQ--Q-----QQQQ?-----------XXXXXXXXXXXXXX-----------------------
--------------------------------------------------------------------------------<>XX[]------------------------------E-----XXXXXXXXXXXXXXX-----------------------
------------------XX-------B------<>--------------------------------------------[]XX[]------B--------------------B-------XXXXXXXXXXXXXXXX------<----------------
------------------------------EE--[]-XXXX---------------------------------------[]XXXX------b-E---------EEXXXXXXXX-XXXXXXXXXXXXXXXXXXXXXX------[---------------X
XXXXXXXXXX--XXXX-------XXXXXXXXXXXXX-------------------------------------XXXXXXXX]XXXXXXXXXXXXXXXXXXXXXXXXXXXXXXXX-XXXXXXXXXXXXXXXXXXXXXX------X-----------X----