----------------------------------------------------------------------------------------------------------------------------------------------------------------
----------------------------------------------------------------------------------------------------------------------------------------------------------------
----------------------------------------------------------------------------------------------------------------------------------------------------------------
----------------------------------------------------------------------------------------------------------------------------------------------------------------
----------------------------------------------------------------------------------------------------------------------------------------------------------------
-------------------------------------------------------E--------------------------------------------------------------------------------------------------------
---------------------------------------------------------------------------E-------------------------------E----------------------------------------------------
--------------------------------------------------------------------------SQS------------XSSSSS------SSSSSSSSSSSSSSSSSSSSSSSSSSS---------------E----------------
-----------------------------------------------------------------------------------------X----------------------------------------------------<>----------------
-----------------------------------------------------------------------------------------X-----------------------------------------E----------[]----------------
-----------E---oooo--------------------?QQQQQ--------------<>---------------------------EX--E-X-----------------------------------<>-XXXX-----[]----------------
----------<>-----------------------------------------------[]-------------SQS------------XSS?SX----QQQQ------------<>---------<>--[]---------SXXS------------<>-
-----B-------------------------------------E---------------[]---------------------------------------------X--------[]---------[]--[]-------------------------[]-
-----b---------------------------------------------E-------[]----------------------B----------------------X--------[]---------[]--[]---------------<>-B------[]-
-----BEE------------------X-XXEEXEXXXXXXXXXXXXXXXX<>XXXXX-XX]-----------E---------------------------------X--------[]---------[]--[]---------------[]XX------[]-
-XXXXXXXXXXXXXXXX-XXXXXXXXX-XXXXXXXXXXXXXXXXXXXXXX[]XXXXX-XXXXXXXXXXXXXXXXXXXXXXXXXXXXXXXXXXXXXXXXXXXXXXXXXXXX-----XX---------XX--[]-------XXXXXXXXXXXX---XXXXX-