----------------------------------------------------------------------------------------------------------------------------------------------------------------
----------------------------------------------------------------------------------------------------------------------------------------------------------------
----------------------------------------------------------------------------------------------------------------------------------------------------------------
---------------------------------------------------------------------------------------------------------------------------------------------------------XXXX---
----------------------------------------------------oo----------------------------------------------------------------------------------------------------[]----
----------------------------------------------------------------------------------------------------------------------------------------------------------[]----
---------------------------------------------------XXXX---------------------------------------------------------------------------------------------------<>----
---oo-------------------------SS-SS--------------------------------------XX-------------------------------------------------------------------------------------
--XX--------------------------------------XX-----------------------------------------------------------------------E-----XX--------------------------------E----
--------------------E-------------------------------------------------------------------------------------------------------------------------------------------
-----------------XXXXXX---------S--S-------o--------------------------------------------------------------------------------------------------------------------
-----XXXXEXX----E--------------------------o-------E------------------S-----------------------------------------------------------------------------------------
-----------X---<>---------------------------------<>-----------------------------------------------------------------XXXX-----------------------------------<---
-----------X---[]---------------------------------[]--------------------------------------------------------------------------------------------------------[---
-----------X---[]--------X-----------------------X[]XXX----------------------XXXXXXXXXXX----------XXXXXXXXXXXXXXXX----------------X-------E--------XXXXX----[---
XX---------X---[]--------XXXXXXXXXXXX-X-------------------XXXXXXXXXXXXX------------------------------------------X----------------XXXXXXXXXXXXXX---X--------[XXX