----------------------------------------------------------------------------------------------------------------------------------------------------------------
----------------------------------------------------------------------------------------------------------------------------------------------------------------
----------------------------------------------------------------------------------------------------------------------------------------------------------------
----------------------------------------------------------------------------------------------------------------------------------------------------------------
----------------------------------------?--------------------------------------------------------------------------------------------------------------SSSSSSSSS
----------------------------------------------------------------------------------------------------------------------------------------------------------------
----------------------------------------------------------------------------------------------------------------------------------------------------------------
--------------------------------------XXX-------o-o-ooo--------------XX----------SSSSS----------------------------------------S---------------------------------
---------------------E--------------------------o-o-ooo--------------XX-----------------------------------------------------------------------------------------
---------------------------------------------------------------------XX-----------------------------------------------------------------------------------------
-----<>-------------------------XXXXXXXXXXXXXXXXXXXXX----------------XX-----------E-----------------------------------------------------------E-----------------
-----[]--------------<>----------------------------------------------XXS---XX----SSSSS----------------XXX---------------------S--------------<>-----------------
-----[]--------E-----[]----------------------------------------------XX----XX-----------------------------------------<>-------------------------------SS-<>----
-----[]--------------[]----------------------------------------------XX----XXX----------------------------------------[]-----------<>------------------SS-[]----
--X-XX]--------------[]--X-XXXX-----------------------XXXXXXXXXXXXX--XX----XXX-------------------------------E------E-[]-----------[]-E----------------SS-[]----
XXX-XXXXX-XXXXXXXXXXXXXXXX-X-----------------------------------------XXXXXXXXXXXXXXX-X-XXXXXXXXXXX--------XXXXXXXXX---XXXX-XXXXXXXXXXXXXXXXXXXXXXXXX---XX-XX---X