----------------------------------------------------------------------------------------------------------------------------------------------------------------
----------------------------------------------------------------------------------------------------------------------------------------------------------------
----------------------------------------------------------------------------------------------------------------------------------------------------------------
-------------SSSSSSSSSSSSSSSSSSSSSSSSSSSSSSSSSSSSS--------------------------------------------------------------------------------------------------------------
------------------------------------------------[]---------------------------------------------------------------------------------------------SSSSSSSSSSSSSSSSS
------------------------------------------------[]--------------------------------------------------------------------------------------------------------------
------------------------------------------------[]--------------------------------------------------------------------------------------------------------------
------------------------------------------------[]-------------------------------------------------------------------------------------------------E---E--------
------------------------------------------------[]------------------------------------------------------------------------------------------------<>--<>--------
------------------------------------------------[]------------------------------------------------------------------------------------------------[]--[]--------
------------------------------------<>---<>-----[]----------oooooo--------------------------------------------------------------------------------[]--[]--------
------------------------------------[]---[]-----<>----------oooooooooooooooooooooooooooooooooooooooooooooooooooooooooooooooooooooooooooo--------SS[]SS[]SS------
-------------oooooooooooooooooooo---[]---[]-------------------------------------------------------------------------------------------------------[]--[]--------
-------------oooooooooooooooooooo---[]---[]--------------XXXXXXXEX-------------------------------------------------------------------------E------[]--[]--------
-------------XXXXXXXXXXXXXXXXXXXX---[]---[]--XXXXXXXXXXXXXX-------XXXXXXXXXXXXXXXXXXXXXXXXXXXXXXXXXXXXXXXXXXXXXXXXXXXXXXXXXXXXXXXXXXXXXX-X<>---E--[]--[]--------
XXXXXXXXXX---XXXXXXXXXXXXXXXXXXXX---[]---[]--XXXXXXXXXXXXXX----------------------------------------------------------------------------X-X[]--XXXXXXXXXXXXXXXXXX