----------------------------------------------------------------------------------------------------------------------------------------------------------------
----------------------------------------------------------------------------------------------------------------------------------------------------------------
----------------------------------------------------------------------------------------------------------------------------------------------------------------
----------------------------------------------------------------------------------------------------------------------------------------------------------------
----------------------------------------------------------------------------------------------------------------------------------------------------------------
----------------------------------------------------------------------------------------------------------------------------------------------------------------
---------------------------------------------------------?---------QQQ?QQQ?QQQQSSSSSSSSSSSSSSSSSSSSSSSSSSSSSSSSSSSSSSSSSSSSSSSS---------------------------------
-----------------XX--------------------------------------------------------------------------------------------------------------------XXX----------------------
----------------XXX--------------------------------------------------------------------------------------------------------------------------------------X------
---------------XXXX------------------------------------------E--------------------------------------E----------------E------E-------X--o-o-------------XX-------
-E-----E------XXXXX---------oooo----------------------XEXX--<>-------SSSSSS------------------------<>---------------<>-----<>------XX--o-o-XXXXXXXXX------------
-------------XXXXXX-----------------------------------------[]------------------------------E------[]---------------[]-----[]-----XXX---------------------------
-----------EXXXXXXX-----------------------------------------[]-----------------------------<>------[]---------------[]-----[]----XXXX---------------------------
-----------XXXXXXXX-----------------------------------------[]------E------EE--------------[]------[]---------------[]-----[]---XXXXX---------------------------
----------XXXXXXXXX-------------------------XXXXXXXXXX------XXXXXXXXXXXXXXXXXX-------------XXXXXXXXXXXXXXXXXXXXXXXXXXXXXXXXXXXXXXXXXX-----------------------E---
XXXXXXXXXXXXXXXXXXXXXXXXXXXXXXXXXXXXXXXXXX------------------XXXXXXXXXXXXXXXXXX-------------XXXXXXXXXXXXXXXXXXXXXXXXXXXXXXXXXXXXXXXXXX------------------XXXXXXXXX