----------------------------------------------------------------------------------------------------------------------------------------------------------------
----------------------------------------------------------------------------------------------------------------------------------------------------------------
----------------------------------------------------------------------------------------------------------------------------------------------------------------
----------------------------------------------------------------------------------------------------------------------------------------------------------------
----------------------------------------------------------------------------------------------------------------oo----------------------------------------------
---------------------------------------------------------o-------o----------------------------------------------------------------------------------------------
--------------------------------------------------------XXX-----XXX----------------XX---------------------------------------------------------------------------
----------------------------E---------------------------------------o-------------------------------------------XXX--------------------------------------XX-----
---------------------------------------------o---o---o-------o------XXXXXXXXXXoo--------------------------------------XX--------------------------------EXX-----
------------------------XX---------------XXXXXX-XXX-XXX-----XXX----------------------------------------------------------------------------------------EXXX-----
-------------------------------------------------------------------------------------------------oooo------------------o---ooooo--------?Q------------XXXXX-----
------------------E-----------XXXXX--------------------------------------------------------------------------------X---o--XXXXXXX--------------------XXXXXX-----
-----------------------------------------------------------------------------------------------------------------------------------------------------XXXXXX-----
-------------------------------------XX------------------------------------------------------------------------------------------------------E-------XXXXXX-----
---------------------------ooo-------------------------------------------------------------------------E-----------------------------XXXXXXX<>XXXXXXXXXXXXX--E--
XXXXXXXXXXXXXXXXXXXXXXX----XXX-----------XXXXXXXXXXXXXXXXXXXXXXXXXXX-------------------XXXXXXXXXXXXXXXXXXXXXXXXX----------------XXXXXXXXXXXX[]XXXXXXXXXXXXXXXXXX