----------------------------------------------------------------------------------------------------------------------------------------------------------------
----------------------------------------------------------------------------------------------------------------------------------------------------------------
----------------------------------------------------------------------------------------------------------------------------------------------------------------
----------------------------------------------------------------------------------------------------------------------------------------------------------------
----------------------------------------------------------------------------------------------------------------------------------------------------------------
----------------------------------------------------------------------------------------------------------------------------------------------------------------
----------------------------------------------------------------------------------------------------------------------------------------------------------------
----------------------------------------------------------------------------------------------------------------------------------------------------------------
-------------------------------------XX-------------------------------------------------------------------------------------------------------------------------
----------------------------------------------------------------------------------------------------------------------------------------------------------------
---------------------------------------------------------------X-------------------------------------------------------------------SSSSS-------------<>--?------
-----------------------------------------------------------XSSSX---?QQQQQQQQ-----------SSSQS--------------<------------------------------------------[]---------
------------------------<>----------------B----------------X----------------------------------------------[>-----------------------------------------[]---------
------------------------[]----------------b---<>-----------X-------B--------------------------------------[]-----<>----------------------------------[]---------
-----------------X------[]E-------------------[]----------EX-------b-E------------------------------------[]E----[]----E-----------------------------[]---------
XXXX-------------XXXXXXXXXXXXXXXXXXX--XXXXXXXXXXXXXXXXXXXXXXXXXXXXXXXXXXXXXXX<>XXXXXXXXXXXXXXXXXXXXXXXXXXXXXXXXXXXXXXXXXXX---XXX---XXXXXXXXXXXXXXXXXXXXXXXX<>XXX