----------------------------------------------------------------------------------------------------------------------------------------------------------------
----------------------------------------------------------------------------------------------------------------------------------------------------------------
----------------------------------------------------------------------------------------------------------------------------------------------------------------
------------------------------------------------------ooo-------------------------------------------------------------------------------------------------------
----E-------------------------------------------------o-o-------------------------------------------------------------------------------------------------------
----------------------------------------------------------------------------------------------------------------------------------------------------------------
------------------------------------------------------XXX-------------------------------------------------------------------------------------------------------
-----XX------------------------------------------------------------------------XQQ------------------------------------------------------------------SSSS--------
-------------------------------------------------------------------------------X--------------------------------------------------------------------------------
----------------------------------------E---------------------ooo------E-------X--------------------------------------------------------------------------------
-------------------------------------------------------------o-oo--------------X--------------------------------------------------------------------------------
-------------------------------------------------------------------------------XQQ-----QQ----------------------------<>--------------------B-------XXX?QQ-------
----------XXXXXXXXXXXXXXXXXXXXXXXXXXXXXXXXX----------------XXXXXXXXXXXXXXX-------------------------------------------[]--------------------b------XX------------
------------------------------------------X------------------------------X--------------------------------B----------[]------XX------------B-----XXX------------
----X-------------------------------------X------------------------------X-----------EE------------------------------XX--XXXXXXXXXXXXXXXXXXXXXXXXXXX------------
XXXXX-------------------------------------X--XXXXXX----------------------X--XXXXXXXXXXXXXXXXXXXXXXXXXXXXXXXXXX-X-----XX--XXXXXXXXXXXXXXXXXXXXXXXXXXXXXXXXXXXXXXX