----------------------------------------------------------------------------------------------------------------------------------------------------------------
----------------------------------------------------------------------------------------------------------------------------------------------------------------
----------------------------------------------------------------------------------------------------------------------------------------------------------------
-------------------------------------------------oo-------------------------------------------------------------------------------------------------------------
--------------------------ooo--------------?-----o--------------------------------------------------------------------------------------------------------------
---------------------o----XXXX----------------------------------------------------------------------------------------------------------------------------------
---------------------oo--------------------------XX--------ooooo--------oooooo-----------------------------?-------------------o--------------------------------
-----------------------------------------XXX---------------XXXXX--------oooooo-----------XXX-----------------------------------o--------------------------------
---------------------------------------------------------------------------------------------E-------------E---------------------XX-----------------------------
-------------------------------------------------------------------------------------------------------------------------oo-------------------------------------
-------------------------------XXXXXXXXXXXXXXX------------------------------------------------XXXXXXXXXX----------------ooo-------------------------------------
------------XX---------XX----------------------------------------------XX-----XXXXXXXXXXXX-XXXX--------------------------------------XXX------------------------
--------------------------XXXXXX--------------------XXXXX-?------XXXX---------X---------------------------------------XXXXXXXXXX------------------<>------------
----B-------------XX--------------------------------X-------------------------X-------------------------------------------------------------------[]------------
----------------------------------------------------X-------------------------X---------------------------------XXXXX-----------------------------[]------------
XXXXXXXXX-------------------------------------------X-----XXXXXX--------------X---------------------------------------------------XXX-----XXXXXXXXXXXXXXXXX-XXXX