----------------------------------------------------------------------------------------------------------------------------------------------------------------
----------------------------------------------------------------------------------------------------------------------------------------------------------------
----------------------------------------------------------------------------------------------------------------------------------------------------------------
-------------------------------------------------------------------------------------------------------------------------------------SSSSSSSSSSSSSSSSSSSSSSSSSSS
---------------------------------------------------------------------------------------------------------------------------------------------------SSSSSSSSS----
---------------------------------------------------------------------------------------------------------------------------------------------------SSSSSSSSS----
-------E----------------E------------------------------------------------ooo---oo----------oo-------ooooooo----------ooo---------------------------SSSSSSSSS----
------SQS--------X---SSSSSSS----------------------------------------E-----oo------------------------ooooooo---XX-----ooo----------------------------------------
-----------------X------------------------------XXXXXXXXX--------------------------------------------------------E----------------------------------------------
--------------XX-X--------------------------E------------XXXXXXXXX-----------------------------------------------------------------------------------------E--<>
--------------XX-X------E------------XX-----------------------------------------------E-----------------------------------------------?SS?SSSSSSSS?SSSSSSSSS--[]
------SQS-----XX-X------QQ?QQ--------XXX---XXX------------------------XXXX--XX-------XXXXXX------E--------XX--------XX--XXXXX------------SSSSSSSSSS-----------[]
-------------XXX-X-------------------------XX-------------------------------X-------------------------------------------X----------------SSSSSSSSSS-----------[]
-------------XXX-X----------------------------------------------------------X---XXXX--------XXXXXXX---------------------X-------------------------------------[]
E---E--------XXX-XX------------------------------------------------ooo------X---------------------X---------------------X--------XX--XXXXXX-XX-XX-XXXXXXXXXXXXXX
XXXXXXXXXXXXXXXX-XXXXXXXXXXXXXXXXX---------------------------------XXX------X---------------------X---------------------X------------XXXXXX-XX-XX-XXXXXXXXXXXXXX