----------------------------------------------------------------------------------------------------------------------------------------------------------------
----------------------------------------------------------------------------------------------------------------------------------------------------------------
----------------------------------------------------------------------------------------------------------------------------------------------------------------
----------------------------------------------------------------------------------------------------------------------------------------------------------------
----------------------------------------------------------------------------------------------------------------------------------------------------------------
----------------------------------------------------------------------------------------------------------------------------------------------------------------
-------------------------------------X---XX-----XX--------------------------------------------------------------------------------------------------------------
----------------------X-----------------------------------------------------------------------------------------------------------------------------------------
---------------------XX----------------ooooooo---------------------------------------oo-------------------------------------------------------------------------
---<>-------------X-EXX----------------ooooooo------------------------------------------------------------------------------------------------------------------
---[]----E-------XXXXXX----------X-----------E---------------------<>-------------------------------------------------------------------------------------------
--QQQQQQQQQ-----XXXXXXX----------X----------<>---------------------[]-----------XX----------------------B-------SS------------------B---S-----------------------
---------------XXXXXXXX----------X-----E----[]---------------------[]----<>----XXX----------------------b--------------<>-----------b---------<>----------------
--------------XXXXXXXXX---------EX----<>----[]---------------------[]----[]---XXXX----------------------B--------------[]-----------B---------[]----------------
--------------XXXXXXXXXXXXXXXXXXXX----[]----[]----------E----------[]----[]--XXXXX-------------------------------------[]---------------------[]------------X---
XXXX-X-<><>---XXXXXXXXXXXXXXXXXXXX----[]----[]-------XXXXX-XXXXXXXXXXX---[]XXXXXXX---XXXXXX-XXXXXXXXXXXXXXXXXXXXXXXXXXXXXXXXXXXXXXXXXXXXXXXXXXXXXXXXXXXXXXXXXXXX