----------------------------------------------------------------------------------------------------------------------------------------------------------------
----------------------------------------------------------------------------------------------------------------------------------------------------------------
----------------------------------------------------------------------------------------------------------------------------------------------------------------
----------------------------------------------------------------------------------------------------------------------------------------------------------------
----------------------------------------------------------------------------------------------------------------------------------------------------------------
----------------------------------------------------------------------------------------------------------------------------------------------------------------
----------------------------------------------------------------------------------------------------------------------------------------------------------------
-----------------------------------------------------------------------------------------------XXXX-----------?SS---------SSS-----------------------------SSSSSS
----------------------------------------------------------------------------------------------------------------------------------------------------------------
-----------------------------------oooooooooo-------------------------------------------------------------------------------------------------------------------
--------------ooo---------------------------------------------------------------------------o--------E----------------------------------------------------------
-----------ooo-------oo----XXXXX-------------------XX-------Q-----------QQQ--------------Q----------<>-------------------------------------------------XXX------
---------------------oo---XXX---------------------XXX-------------------------------XXXXX------------------E---B-------E-------------------------------XXX------
-------------------------XXX---------------------XXXX----------------------------------------------------------b---------------------------------------XXXX-----
-------------------XXXXXXXXX------<>---------XXXXXXXX-----------------EE--------------------------------------------------------X------E--EE-----------XXXX-----
XXXXXXXXXXXXXXXXXXXXXXXXXXXX------[]----------XXXXXXX----XXXXXXXXXXXXXXXXXXXXXXXXXXXXXXXXXXXXXXXXXXXXXXXXXXXXXXXXXXXXXXXXXXXXXXXX--XXXXXXXXXXXXXXXXXXXXXXXXX----