----------------------------------------------------------------------------------------------------------------------------------------------------------------
----------------------------------------------------------------------------------------------------------------------------------------------------------------
----------------------------------------------------------------------------------------------------------------------------------------------------------------
------------------------------------------------------------------------ooo-------------------------------------------------------------------------------------
------------------------------------------------------------------------o-o----------------------------------------------------------------------?--------------
----------------------------------------------------------------------------------------------------------------------------------------------------------------
--------------------------------------SSSX------------------------------XXX----------------oo------------SSSSSSSSSSSS------------XX-----------------------------
-------------------------------------S---X-------------------------------------------------oo-----XX------------------------XX---------------E---XX-------------
------------------------------------SS---X---------------------------------------------------------------------------------EXX----------------------------------
-----------------------------------SSS---X--E-----------------------------------------------------------------------------EXXX------------------------X-EE----X-
----------------------------------SSSS--?X-<>---------------------------------------------------o------S-----------------XXXXX------------------------XSSSSSSSX-
-----------------------------------------X-[]-------------------------------------------E----XX-------------------E-----XXXXXX---------XXX----------------------
-----------------------------------------X-[]--------------------------------XXXXX-----------X-------------------<>----XXXXXXX----------------------------------
------------------------E---------B------X-[]---------X-----X--------------------X-XXXXXXX---X-------------------[]---XXXXXXXX-----o----------------------------
E-------------XXXXXXXXX<>XXXXXXXXXXXXXXXXXXXXXXXXXXXXXX-----X-E------------------X-X-----X---X-------------------XXXXXXXXXXXXX-----X-----------------XXXXXXXXXXX
XXXXXXXXXXXXXXXXXXXXXXX[]XXXXXXXXXXXXXXXXXXXXXXXXXXXXXX-----XXXXXXXXX------------X-X-----X---X-------------------XXXXXXXXXXXXX-----------------------XXXXXXXXXXX