----------------------------------------------------------------------------------------------------------------------------------------------------------------
----------------------------------------------------------------------------------------------------------------------------------------------------------------
----------------------------------------------------------------------------------------------------------------------------------------------------------------
----------------------------------------------------------------------------------------------------------------------------------------------------------------
----------------------------------------------------------------------------------------------------------------------------------------------------------------
----------------------------------------------------------------------------------------------------------------------------------------------------------------
-------------------------------------------------------ooooooo----------E---------------------------------------------------------------------------------------
---------------------------------------------X-------SSSSSSSSSSSSSS---SSSSSS----------------------------------------------------------------------------E-------
---------------------------------------------X-------------------------------------------------------------------------------------------------------E----------
---------------------------------------------X-----------------------------------------------------------------ooooooo------------------------------------------
---------------XX----------------------------X------------------E-X-----E----------o----------------------SSS--------------------------------XX-----------------
---<>-----------------------------------XX---X---------?SSSSSSSS?SX-----QQ?QQ----------QQQ----------------------------------------------------------------------
---[]----------------------------------------X----------------------------------------------<>---------------------------------<>-------------------------------
---[]--------------------------B---B---------X----------------------------------------------[]------<>-------------------------[]-------<>----------------------
---[]----------------------------------------X--------------E-------------------------------[]------[]--------<>---------------[]-------[]--------XX------------
XXXXX-XXXX-----------XXXXXXXXXXXXXXXXXXX-----XXXXX---XXXXXXXXXXXXXXXXXXXXXXXXXXXXX--XXXXXXXXXXXXXXXXXXXXXXXXX-[]-----XXXXXXXXXXXXXXXXXXXXX---------X-----XXXXXXX