----------------------------------------------------------------------------------------------------------------------------------------------------------------
----------------------------------------------------------------------------------------------------------------------------------------------------------------
----------------------------------------------------------------------------------------------------------------------------------------------------------------
----------------------------------------------------------------------------------------------------------------------------------------------------------------
----------------------------------------------------------------------------------------------------------------------------------------------------------------
----------------------------------------------------------------------------------------------------------------------------------------------------------------
-------------------------------------oooo----------------E--------------------------------------------------------------------------------------XXX-------------
------------------------------------XXXXXX-------------SSSSSSSS----X---------------------------------X-----------XXXX--------------------------------------XX---
-------------------------------------------------------------------X---------------------------------X----------------------------E------o----------------------
-------------------------------------------------------------------X---------------------------------X----------------------------------------------------------
-----------ooo-----------------------------------------------------X--?---------------------------X--X----------------------------------------------------------
E----------------------------------------------------------S-------X-----------------------------XX--X-------SS-------------------------------------------------
E------E------------------------------------------------E----E-----X----------------------------XXX--X--------------------XXXXX---------------------------------
-------------------------------------------------------------------X---------------------------XXXX--------------------------------------------o---o------------
-------------------E-----------------------------------------------X------------E-------------XXXXX-------------------------------------XXXXXX-X---X------------
XXXXXXXXXXXXXXXXXXXXXXXXXX---XXXXXXXXXXXXXXXXXXXXXXXXXXXXXXXXXXXXXXXXXXX<>XXXXXXXXXXXXXXXXXXXXXXXXXXXXXXXXXXXXXX------------------------------------------------