----------------------------------------------------------------------------------------------------------------------------------------------------------------
----------------------------------------------------------------------------------------------------------------------------------------------------------------
----------------------------------------------------------------------------------------------------------------------------------------------------------------
----------------------------------------------------------------------------------------------------------------------------------------------------------------
---------XXXXXXXXXXXXX--------------SSSSSSSSSSSSSSSSSSSSSSSSSSSSSSSSSSSSSSSSSSSSSSSSS?SSSSSSSSSSSSSSSSSSSSSSSSSSSSSSSSSSSSSSSSSSSSSSSSSSSSSSSSSSSSSSSSSSSSSSSSSS
---------XXXXXXXXXXXXX-----------------------------------------------------------------------SSSS------SSSS-----------------------------------------------------
---------XXXXXXXXXXXXX-----------------------------------------------------------------------SSSS--E---SSSS-----------------------------------------------------
---------XXXXXXXXXXXXX-------SSS-------------------------------------------------ooooo--------S----SS-----------------------------------------------------------
---------XXXXXXXXXXXXX-------------------------------o----------------------------------------S----SS-----------------------------------------------------------
---------XXXXXXXXXXXXX-----------------------------------------------------------SSSSS--------S----SS-----------------------------------------------------------
---------XXXXXXXXXXXXX-------------------------------------------------------E---SSSSS--------So??-SS---E-------------------------------------------------------
---------XXXXXXXXXXXXX------XXXXX-----------E---------<E--------------------<>----------------SSS--SS--SSSS-----XXX---------------------------------------------
---------XXXXXXXXXXXXX------X-------SS-----<>-<>------[>--------------------[]------------------------EE----------------SS-<>------E------------<>--------------
---------XXXXXXXXXXXXX------X-------SS-----[]-[]------[]--------------------[]------------------------------------------SS-[]-----<>---------<>-[]---------<>---
---------XXXXXXXXXXXXX------X-------SS---E-[]-[]------[]------X-------------[]------------------------------------------SS-[]-----[]-------E-[]-[]-------E-[]---
XXXXXXXXXXXXXXXXXXXXXXXXXXXXXXX-----XX-XXXXXX-XX----XXXX---XXXX---XXXXXXXXXXXX--XXXXXXXXXXXXXXXXXXXXXXXXXXX---------X---XX-XX---XXXXXXXXXXXXXXX-XX---XXXXXXXX---