----------------------------------------------------------------------------------------------------------------------------------------------------------------
----------------------------------------------------------------------------------------------------------------------------------------------------------------
----------------------------------------------------------------------------------------------------------------------------------------------------------------
----------------------------------------------------------------------------------------------------------------------------------------------------------------
--------------------------------------------------------------------------------------------------------------------------?-------------------------------------
----------------------------------------------------------------------------------------------------------------------------------------------------------------
----------------------------------------------------------------------XXX------------------------------------------------------E--------------------------------
-------------------------------------XXX------------------------------------------------X----SSSS-----------------------------SSS---------SSS-------------------
----------------------------------------------------------------------------------------X-----------------------------------------------------------------------
----------------------------------------------------------------------------------------X-----------------------------------------------------------------------
---oooo------------------------------------------------------------XXX---------E---o----X------E------------------------SS----------------SSS-------------------
---------------------------------------XXXXXXXX-------------------------------<>--------X---SSSSS----------------------------SSSS-------------------------------
---------------B-----B------------------------------------------------------------------X-----------------------------------------------------------------------
---------------b-----b------------------------------------------------------------------X-----------------------------------------------------------------------
------------------------X---------------------------XXXXXXXXXXXXXXX---------------------X-----------------------------------------------------------------------
XXXXXXXXXXXXXXXXXXXXXXXXX-------XXXXXXXX---------------------------------XXXXXXXXXXXX--XXXX-XXXXXXXXXXXXXXXXXXXXXXXXXXXXXXXXXXXXXXXXXXXXX----XXXXXXXXXXX---XXXXX