----------------------------------------------------------------------------------------------------------------------------------------------------------------
----------------------------------------------------------------------------------------------------------------------------------------------------------------
----------------------------------------------------------------------------------------------------------------------------------------------------------------
----------------------------------------------------------------------------------------------------------------------------------------------------------------
--------------------------------------------------------------------------SSSSSSSSSSSSSSSSSSSSSSSSSSSSSSSSSSSSSSSSS?SSSSSSSSSSS---------------------------------
----------------------------------------------------------------------------------------------------------------------------------------------------------------
---------------------------------------------ooo----------------------------------------------------------------------------------------------------------------
--------------SSS----------------------------XXX--o-------------------------------ooooo-------------------------------------------------SSS-------------?SSS----
--------------------------------------------------XXXX----------------------------------------------------------------------------------------------------------
----------------------------------------------------------------------------------SSSSS-S----------------------------------------oo---------o-----------------E-
--------------------------------XX------------------------------------------------SSSSSoS----S----------------XXXXXX-------------------------E--------E------<>-
-------------XXXXX-XXXX---------------------------------------------------------------SSS--E----E------------XXXXXXX---------XXX---------SSSSSS------<>---E--[]-
-------------X----------XXXXX------XXXXXXXXX?--------------------E--------SS-<>-----------<>---<>----E------XXXXXXXX--------EXXX---------------------[]--<>--[]-
-------------X--------------X---------------------------------------------SS-[]-----------[]---[]----------XXXXXXXXX-------XXXXX--------------E------[]--[]--[]-
-------------X--------------X---------------------------------------------SS-[]-----------[]---[]-----X--XXXXXXXXXXX------XXXXXX---------------------[]--[]--[]-
XX-XXXXXXXXXXXXX------------X---------------XXXX-X---------XXXXXXXXXXXXX--XX-XX--XXXXXXXXXXXXXXXX--XXXX--XXXXXXXXXXX--XXXXXXXXX---XXXXXXXXXXXXXXXXXXXXXXXXXXXXXX