----------------------------------------------------------------------------------------------------------------------------------------------------------------
----------------------------------------------------------------------------------------------------------------------------------------------------------------
----------------------------------------------------------------------------------------------------------------------------------------------------------------
----------------------------------------------------------------------------------------------------------------------------------------------------------------
-------------------------------------------------?--------------------------------------------------------------------------------------------------------------
----------------------------------------------------------------------------------------------------------------------------------------------------------------
-----E----------------------------------------------------------------------------------------------------------------------------------------------------------
--S--S------------SSSSSSSSSS--S---------------------------------------E-----------------------------------SSQ-------SSSS----------------------------XX----SSSS?S
---------------------------------------------------------------------------------------------------------------------------------------------------XXX----------
-----?-----------------------------------------------------------------------------------------------------------------------------E--------------EXXX----------
-------------------E---E------------X----------SS------------------XSS------------------------------------------------------------<>-------------XXXXX-----E----
-SS---------<>----SSSSSSSSSS--SSSSSSX-----------------------------XX---------------QQQ?-----------------QQQSS----------QQQ--------[]-------------XXXXX----SSSSSS
-----X------[]----------------------------------------<>--------EXXX----------------------B---------------------------------------[]-------------XXXXX----------
-----X------[]----------------------------------------[]--------XXXX----------------------b--------------------<>--------------E--[]----------E--XXXXX----------
-----X---E--[]----------------------------------------[]-------XXXXX---------EE-------B------------------------[]---------------XXXXXXXXXXXXX<>--XXXXX----------
XXXXXXX-XXXXXXXXXXXXXXXXXXXXXXXXXXXXXXXXXXXXXXXXXXXXX-XXXXXXXXXXXXXXXX-------XXXXXXX-XXXXXXXXXXXXXXXXXXXXXXXXXXXXXXXXXXXXXXXXXXXXXXXXXXXXXXXX[]--XXXXXXXXXXXXXXX