----------------------------------------------------------------------------------------------------------------------------------------------------------------
----------------------------------------------------------------------------------------------------------------------------------------------------------------
----------------------------------------------------------------------------------------------------------------------------------------------------------------
----------------------------------------------------------------------------------------------------------------------------------------------------------------
----------------------------------------------------------------------------------------------------------------------------------------------------------------
----------------------------------------------------------------------------------------------------------------------------------------------------------------
-----------------------------------------------------------------------------------------------------------------SSSSSSS--------------------XXXXXX--------------
----------------------------------------------------------oooo-----------?SS-------------------------------------------------------------------------------XXoo-
----------------------------------------------------------o--o--------------------------------------------------------------------------------------------------
----------------------------------------------------------------------------------------------------------------------------------------------------------------
----------<>-------------------------------------------------XXXXX------------------------------SS---QQQ?QQQQQQ-----SSSS----------------------------------------
---S------[]------------------------------XXXX--------------------------------------------------------------------<>-------------------------------XXXXXXXX----X
----------[]-------------------------------------E------XX----------------B---------------------------------------[]--------------------------XXX---------------
----------[]--------------------------B---------<>------------------------b------------------<>-------------------[]--------------------------------------------
----------[]------------------------------------[]------------------------------------E---E--[]------XXXEEXXXXXXXXXXXXXX----------XXXXXX------------------------
XXXXXXXX--XXXXXXXXXXX---XXXXXXXXXXXXXXXXXXX-----XXXX-X-------------XXXXXXXXXXXXXXXXXXXXXXXXXXXXXXX---XXXXXXXXXXXXXXXXXXX----XXX---------------------------------