----------------------------------------------------------------------------------------------------------------------------------------------------------------
----------------------------------------------------------------------------------------------------------------------------------------------------------------
----------------------------------------------------------------------------------------------------------------------------------------------------------------
----------------------------------------------------------------------------------------------------------------------------------------------------------------
---------------------------------------?SSSSSSSSSS-------------------------------------------------------------------------------------------------------ooo----
--------------------------------------------SSSS----------------------------------------------------------ooo--------------------------------------------XXXX---
------------------E-------------------------SSSS----------------------------------------------------------XXX--------------------?--XXX-------------------------
------------QQQ?QQQQQ?QQQQQ------------------------E------------------------------X----------------XXX---------------------XXX--------------------E-------------
--------------------------------------------------------------------------------------------------XXXX----------------------------------------------------------
--------------------------------------------------------------------------------X---------------XXXXXX---------------------o-o----------------XX----------------
---------------E---E-E---------------SS------E--------------XXXX---------------XX---------------XXXXXX---------------------o-o-XXX------XXXX------------------XX
-------<>--E?QQ-QQQQQ-QQQQQ-----------------SSSS----------------------<>------XXX------X--------XXXXXX----------------------------------------------XXXX--------
<>-----[]----------------------------------EE-----------E-------------[]-----XXXX------X-------XXXXXXX-----------XXXXXXX---------------------------------XXXXXX-
[]-----[]-------------------------<>-------------------<>-------------[]----XXXXX------XX------XXXXXXX-----------------X-----------o----------------------------
[]E----[]-------------------------[]-----E-------------[]-------------[]---XXXXXX------XX-E----XXXXXXX--XXXXX----------X-----------X-------------ooo------------
XXXXXXXXXXXXXXXXXXXXXXXXXXXXXXXXXXXXXXXXXXXXXXXX-------XX-XXX--XXXXXXXXXXXXXXXXXX--XXXXXXXXXXXXXXXXXXX-------XXXX------X---------------XX--------XXX------------