----------------------------------------------------------------------------------------------------------------------------------------------------------------
----------------------------------------------------------------------------------------------------------------------------------------------------------------
----------------------------------------------------------------------------------------------------------------------------------------------------------------
----------------------------------------------------------------------------------------------------------------------------------------------------------------
----------------------------------------------------------------------------------------------------------------------------------------------------------------
-----------------------------------------------------------------------------------E----------------------------------------------------------------------------
------------------------------E----------------------E----------------------------------------------------------------------------------------------------------
---------------SSSSSSS------SSSSS-----------------SSSSS---------------------E---------------o-o------XXXX-------S-----------------------------------oo----------
---------------------------------------------------------------------E---------XXX-----------------------------------------------------------------XX-----------
-------X--------------------------------------------------------------------------------------------------------------------------------------------------------
------XX----------S------------------------ooo----------------------------------------------XXXX-----------------------------------------------------------QQQQQ
-----XXX-----------------------------------------S-------------XXX------------------XXXX----------------------S?S----------SSSS-----------------------X---------
----XXXX---------------------E---------X------------X---------XXXX-----XX----------------------------------------------------------E----------------------------
---XXXXX-------<>-------<>-------------X------------X--------XXXXX-----------------------XXX--------------------------------------<>----------------------------
---XXXXX-------[]---EE--[]-------------X------------X-------XXXXXX--------------------------------------------------------------------E----E--------------XXXXXX
XXXXXXXXXXXXXXXXXXXXXXXXXXXXXXXXXXXXXXXXXXXXXXXXXXXXXXXXXXXXXXXXXXXXX----------------------------XXXXXXXX---XXXXXXXX-XXXXXXXXXXXXXXXXXXXXXXXXXXXXXX-------XXXXXX