----------------------------------------------------------------------------------------------------------------------------------------------------------------
----------------------------------------------------------------------------------------------------------------------------------------------------------------
----------------------------------------------------------------------------------------------------------------------------------------------------------------
----------------------------------------------------------------------------------------------------------------------------------------------------------------
----------------------------------------------------------------------------------------------------------------------------------------------------------------
----------------------------------------------o-o---------------------------------------------------------------------------------------------------------------
---------------------------oo--------ooo------o-o--------E---------------XXXXXXXXX------------------------------------------------------XXXXX-------------------
-------------------------------------ooo-----------------S----------XX----------------oo----oo------------------X-----------------------------------------XXXXX-
----------------------E-----------------------------------------------------------------------------XX---------------E-------------------------oo---------------
---------------------<>----XX----------------------------?--------------------------------------------------------------------------------------------E---------
---------------------[]------------------------XX---------------------X-------------------------E----o----------------------------------------------------------
---------------------XX-----------E-----XXXXX---------------?--XXX------------------XX--XXXX--XXXX---o----------------------------------------------------------
----------------------------------------X----------------X-----------------------------------------------------------------<>----B------------------------------
----------<>------------B-----XXXXXX----X----------------X-----------------------------------------------------------------[]----b-----------------E------------
----------[]-------------E---------X----X-----------XX---X---------------------XXX-----------------------------------------[]-----------------------------------
XXXXXXXXXXXXXXXXXXXXXXXXXXXX-------X----X--------------XXXX---------------------------------------------------------------XXXXXXXXXXXXXX-------XXXXXX------XXXXX