----------------------------------------------------------------------------------------------------------------------------------------------------------------
----------------------------------------------------------------------------------------------------------------------------------------------------------------
----------------------------------------------------------------------------------------------------------------------------------------------------------------
----------------------------------------------------------------------------------------------------------------------------------------------------------------
----------------------------------------------------------------------------------------------------------------------------------------------------------------
----------------------------------------------------------------------------------------------------------------------------------------------------------------
-------------------------------------------------------------------------------------------SS-------------------------------------------------------------------
----------E-------------------------------X------------XXXX------SSSS-------------------------------------------------------------------------------------------
------------------------------------------X------------XXXX-----------------------------------------------------------------------------------------------------
------------------------------------------X------------XXXX------------B------------------o---------------------------------------------------------------------
-------XSS-----XXXXX---------------------oX----------o-XXXX-------E----b-----XXXX---------XXXXX-----S-----------------------------------------------------------
------XX----------------------------------X------E-----XXXX------SSSSSSXSS------------<>----------------------------------------QQQQQQ?------------QQQQQQQ?-----
-----XXX----------------------------------X-----<>-----XXXX---------------------------[]------------------------------------------------------------------------
----XXXX-----------------------------------------------XXXX---------------------------[]------------------------------------------------------------------------
---XXXXX-----------------------------------------------XXXX---------------------------XX------XXXXXXXXEEXEXXXXXXXXXXXX--XXXXXXXXXXXXXXXXXXXXXXXXXXXXXXXXXXXXXE--
XXXXXXXXXX-----------XXXXXXXXXXXXXXXXXX---XXXXXXXXXX---XXXX--XXXXXXXXXXXXX------------XX--------------------------------XXXXXXXXXXXXXXXXXXXXXXXXXXXXXXXXXXXXXXXX