----------------------------------------------------------------------------------------------------------------------------------------------------------------
----------------------------------------------------------------------------------------------------------------------------------------------------------------
----------------------------------------------------------------------------------------------------------------------------------------------------------------
----------------------------------------------------------------------------------------------------------------------------------------------------------------
----------------------------------------------------------------------------------------------------------------------------------------------------------------
----------------------------------------------------------------------------------------------------------------------------------------------------------------
----------------------------------------------------------------------------------------------------------------------------------------------------------------
----------E--------------------E-----------------------------------------------------------XX------SSSS---------------------------------------------------------
------------------------------------------------------------------------------------------XXX-------------------------------------------------------------------
-----------------------------------------------------------------------------------------XXXX-------------------------------------------------------------------
------XXSS------------------------------------------------------------QQQQQQQQQ---------XXXXX-------------------------------------------------------------------
-----XXX-------SSSSQ-------------------------------------------------------------------XXXXXX-----S--SSSS---------------SSS?------------------------------------
----XXXX-----------------------------------------------------------------E---E--------XXXXXXX-------------------------------------------------------------------
---XXXXX---------------------E----------X---------XX---------------------------------XXXXXXXX------------------------------S------------------------------------
XXXXXXXX------------XXXXXXXXXXXXXXXXXXXXXXXXXXXXXXXXX-----------XXXXXXXXXXXXXXXXEE--XXXXXXXXX----------------------------------------XXXXXXXXXXXXXXXXXXXXXXXXXXX
XXXXXXXXXX-----XXXXXXXXXXXXXXXXXXXXXXXXXXXXXXXXXXXXXXXXXXXXXXXXXXXXXXXXXXXXXXXXXXXXXXXXXXXXXXXXXXXXXXXXXXXXXXXXXXXXXXXXXXXXXX-XXXXXXXXXXXXXXXXXXXXXXXXXXXXXXXXXX