----------------------------------------------------------------------------------------------------------------------------------------------------------------
----------------------------------------------------------------------------------------------------------------------------------------------------------------
----------------------------------------------------------------------------------------------------------------------------------------------------------------
----------------------------------------------------------------------------------------------------------------------------------------------------------------
-------------------------------------------------------------------------------------------------------SSSSSSSSSSSSSSSSSSSSSSSSSSS------------------------------
-------------------------------------------------------------------------------------------------------SS--------------------SSSSS------------------------------
---------------------------------------------------------------------------------------ooooo-----------SS--------------------SSSSS------------------------------
-------XX------------------------------------------S----------------------------------SSSSSSSSS--------SS--------------------SSSSS------------------------------
-----------------------------------------------------------------------------------------------------------------------------SSSSS------------------------------
-----------------------------------------------------------------------------------------------------------------------------SSSSS------------------------------
------------E----------------------------------------------------------------------------------------------------------------SSSSS------------------------------
---<>-----XXXX----------SSS---------------------------S-------------------------------SSSSSSSSSS-------SS-------E---------------SS----------------------QQ------
---[]--------------------------------------------------------------------------------------------------S-------<>---------E-----SS-------------E----------------
---[]-----------------------B----------------------------------------------------------------------------------[]--<>----<>-----SS------------------------------
---[]-----------------------------EE------------------------------------------E-----------E------------E-EE--E-[]--[]----[]--------------E----------------------
XXXXX----------XXXXXXXXXXXXXXXXXXXXXXXXXXXXXXXXXXXXXXXXXXXXXXXXXXXXXXXXXXXXXX--XXXXXXXXXXXXXXXXXXXXXXXX-XXXXXXXXX--XX--XXXXXXXXXXXXXXXXXXXXXXXXXXXXXXXXXXXXXXXXX