----------------------------------------------------------------------------------------------------------------------------------------------------------------
----------------------------------------------------------------------------------------------------------------------------------------------------------------
----------------------------------------------------------------------------------------------------------------------------------------------------------------
----------------------------------------------------------------------------------------------------------------------------------------------------------------
----------------------------------------------------------------------------------------------------------------------------------------------------------------
----------------------------------------------------------------------------------------------------------------------------------------------------------------
---------------------------------------------------------------------------------------------------o-ooo----------ooooo----------------XXXXXXXXX-----XXXXXXXXX--
-------------SS-----------------------------o----------------------------------SSSSSSS--------XXXX----------------ooooo-----------------------------------------
------------------------E---------------------------------------------------------------------------------------------------------------------------------------
--------<>-----------------------------------------------X------------------------------B-------------XX--------------------------------------------------------
--------[]-----------XXXXXXXXXX--------S---XXX----------XX------------------------------b------------------------------------------------------------XXXXXXXXXXX
-------QQQQQ?SS----------------------------------------XXX--------------------------SSSSXSSS-------------------E-------XXXX---QQ--------------------------------
-----------------------------------------------------EXXXX----------E-------------<>-----------------------------------X----------------------------------------
-------------------------------------------------X---XXXXX---------<>-------------[]---------------------XXEXXXXX------X----------------------------------------
------------------E------------------------------X--XXXXXX---E--------------------[]----------------------------X------X---------------------------------------X
XXXXXXXXX-X-XXXXXXX------------------------------XXXXXXXXXXXXXXXXXXXXXXXXXXXXXXXXXXXXXXXXXXXX------XXXX---------X------X--XXXXXXXXXX----------------------------