----------------------------------------------------------------------------------------------------------------------------------------------------------------
----------------------------------------------------------------------------------------------------------------------------------------------------------------
----------------------------------------------------------------------------------------------------------------------------------------------------------------
----------------------------------------------------------------------------------------------------------------------------------------------------------------
--------------------XXXXXXXXXXXXXXXXXXXXXXXXX-------------------------------------------------------------------------------------------------------------------
--------------------XXXXXXXXXXXXXXXXXXXXXXXXX-------------------------------------------------------------------------------------------------------------------
---------E----------XXXXXXXXXXXXXXXXXXXXXXXXX----------------------------------------------------------------------XXXXXX---------------------------------------
---------S----------XXXXXXXXXXXXXXXXXXXXXXXXX-----------------------------------------------------------------------------------E--------XXX--------------------
--------------------XXXXXXXXXXXXXXXXXXXXXXXXX--------------------------------------------------------------------------------------------------------o----------
---------?----------XXXXXXXXXXXXXXXXXXXXXXXXX--------------------------------------------------------------------------------X---------------------------------E
-------o------------XXXXXXXXXXXXXXXXXXXXXXXXX---------Q----------------------QQQQ?QQQQQ---<>---------------------------------------------------------------XXXXX
------------?----<>-XXXXXXXXXXXXXXXXXXXXXXXXX------Q-E------------------------------------[]----------SSSSSS---------------X------XXXXXX------------XXX---------
---------X-------[]-XXXXXXXXXXXXXXXXXXXXXXXXX--------E--------E---E------------------E----[]--------------------------XXX--X------------------------------------
---------X-------[]-XXXXXXXXXXXXXXXXXXXXXXXXX---------------------------------------------[]---E---------------------------X------------------------------------
--E------X-------[]-XXXXXXXXXXXXXXXXXXXXXXXXX-------------------------------XXXXXEEXXXXXXXX]-------------------------------X---ooo-------------XX---------------
X--XXX--XXX------XXXXXXXXXXXXXXXXXXXXXXXXXXXXXXXXXXXXXXXXXXXXXXXXXXXXXXXXX--XXXXXXXXXXXXXXXXXXXXXXXXXXXXXXXXXXXXXX---------X---XXX-------------X----------------