----------------------------------------------------------------------------------------------------------------------------------------------------------------
----------------------------------------------------------------------------------------------------------------------------------------------------------------
----------------------------------------------------------------------------------------------------------------------------------------------------------------
----------------------------------------------------------------------------------------------------------------------------------------------------------------
----------------------------------------------------------------------------------------------------------------------------------------------------------------
----------------------------------------------------------------------------------------------------------------------------------------------------------------
----------------------------------------------------------ooo-------------------------------------------------------E-E-----------------------------------------
----------------------------------------<>----------------ooo------XX---------------------oooo-------------X-------<><>----------------------------XSSSSS-------
----------------------------------------[]------------------------------------------------o--o---------------------[][]--------------oo------------X------------
---------<>-----------------------------[]-------------------------------------------------------------------------QQQQ----------------------------X------------
---------[]---------------------?QQQQ--S[]---------------------------------------------------XXXXXX-----------------------------------------------EX--E-X--B--o-
--------QQQQQQ--------------------------[]-------------E-----XXXX---------------------------------------XXX----------------------------------------XSS?SX-------
-----------------------------------E----[]-------------------X----------------XXXXXXXXXXXX----------------------------------------------------------------------
--------E-------------------------------[]----XXXXXEXXXXX----X-------------XXXX---------------------------------------------------------------------------------
-------------------XXXXXXXX--XXXXXXXXXXXXXXXX-X---------X----X-------------XXXX------------------------------------XXXXXXXXXXXXXXX-----------E------------------
XXXXXXXXXX-X-XXXXXXXXXXXXXX--XXXXXXXXXXXXXXXX-X---------X----X-------------XX--------------------------------------XXXXXXXXXXXXXXX---XXXXXXXXXXXXXXXXXXXXXXXX---