----------------------------------------------------------------------------------------------------------------------------------------------------------------
----------------------------------------------------------------------------------------------------------------------------------------------------------------
----------------------------------------------------------------------------------------------------------------------------------------------------------------
----------------------------------------------------------------------------------------------------------------------------------------------------------------
----------------------------------------------------------------------------------------------------------------------------------------------------------------
---------------------------------------------------------------------------------------------------E------------------------------------------------------------
---------------------------------------------------------------------------SSSSSSSSSSSSSS-------SSSSSSSSS-------------------------------------------------------
-----------------------------------------------------------------------------------------------------------------------------XXoo-------------------------------
----------------------------------------------------------------------------------------------------------------------------------------------------------------
-----------------------------------------------------------------------------------------------------E----------------------------------------------------------
---------------------------------<>---------------------------ooo--------S------------------QQ--SSSSSS?SS-QQQQ-----X----------------------------o---------------
----------------<>---------------[]----------------------Q---------------------------E----------------------------XX-----XXXX----XXXXX--------------------------
---------<>-----[]---------------[]-----------------------------------<-------------<>----------------------E----XXX-----------------------------------<>-------
-----B---[]-----[]---------------[]-----------------X-----------------[-------------[]--------------------------XXXX-----------------------------------[]-------
-XXXXX---[]-----[]---------------[]-----------------X-----------------[X------------XXXXXXXXXXXXXXXXXXXXXXXXXXXXXXXX-----------------------------------[]-------
XXXXXX--XXXXXXXXXXXXXXXXXXXXXXXXXXXXXXXXXXXXXXXXXXXXXXXXXXXXXXXXXXXXXXXX------------XXXXXXXXXXXXXXXXXXXXXXXXXXXXXXXXXX---------------------XXXXXXXXXXXXXXXXXXXXX