----------------------------------------------------------------------------------------------------------------------------------------------------------------
----------------------------------------------------------------------------------------------------------------------------------------------------------------
----------------------------------------------------------------------------------------------------------------------------------------------------------------
---------------------------------------------------------------?--------------------------------------X-------------------------------------------------ooo-----
-------------------------------------------oo-----------------------------------------------------------------------------------------------------------o-ooo---
----------------------------------------------------------------------------------------------------------------------------------------------------------------
-----------------------------oo---------------XXX-------------S-----------------SSSSSSSSSSSSSSS------XXXXXXXXX--------?----------------------------SS---XX------
-----------------------------------------------------------------------------------------------------E----------------------------------------------------------
-----------------------------------------------------------------------------------------------------------------------------ooo--------------------------------
------------------------------------------------------------------------------------------------------------------------------------------------------------XX--
-------------------X---------------------XXXXX----------XXXXXXXXX-------------S--------------------<>----------XXXXXXEX-----------------------------X-----------
-------XXX---------X------XX--------E-------------------------------------------------------E-----X[]--------------------------------------ESSSSSSSSX-----------
-------------------X-----------------------------------------------------------------------<>----XX[]----------------------------------E------------------------
-------------XX---EX----------XXXX---------------o------------------XX---------------------[]---XXX[]-----------------------------------------------------------
-------------XXXXXXX----------------XXXXX--------X-XXXXX-----------------------------------XXXXXXXXXX-----------------------------------------------------------
XXXX---------XXXXXXX-----------------------------------------------------------------------XXXXXXXXXX---------XXX--------XXXXXXXXXXXXXXXXXXXXXXXXXXXX-----------