----------------------------------------------------------------------------------------------------------------------------------------------------------------
----------------------------------------------------------------------------------------------------------------------------------------------------------------
----------------------------------------------------------------------------------------------------------------------------------------------------------------
----------------------------------------------------------------------------------------------------------------------------------------------------------------
----------------------------------------------------------------------------------------------------------------------------------------------------------------
----------------------------------------------------------------------------------------------------------------------------------------------------------------
---oooo---------------------------------------------------------------------------oo------------------------------------------------------------SSSS------------
--XXXXXX-------------------------------E---------------------XXX----XX-----------XXXX------------------------------------------------E-----------[]-------------
--------------------------------------------------------------------------------------o----------------------------------------------------------[]-------------
-------------------------------------------------------------------------------------XXX---XXXX--------------------------------------------------[]-------------
-----------------------------------------QQQQ----------------------------------------------------------------------------------------------------[]-------------
-----------------XX------------------------------------XXX---------------------------------------------------------------XXXX--------------------<>-------------
-------------------------------------------------------------------------------------------------------------XXXXXXXXXX-----------------------------------------
------------------------------------------------B---------------------------XXXXX---XXXXX-------------------XXXXX----------------XXX--------------E-------------
-----------------------------------------XXXXXXXX--XX-----------------------X------------------------------XXXXXX----------------------XXXXXXXXXXXXXXXXXXXXXXXXX
XXXXXXXX------XX-------X---------X-------XXXXXXXX--X------------------------X--------------XXXXXXXXXXXXXXXXXXXXXX---------------------XXXXXXXXXXXXXXXXXXXXXXXXXX