----------------------------------------------------------------------------------------------------------------------------------------------------------------
----------------------------------------------------------------------------------------------------------------------------------------------------------------
----------------------------------------------------------------------------------------------------------------------------------------------------------------
----------------------------------------------------------------------------------------------------------------------------------------------SSSSSSSSSSSSSSSSSS
------------------------------------------------------------------------------------------------------------------------------------------------[]--------------
-----------------------------E-----------E------------------------------------------------------------------------------------------------------[]------EE------
------------------------SSSSSSSSSSSSSSSSSSSSSSSSS--------XXXXXX---------------------------------------------------------------------------------[]---QQQQQQ-----
------------------------------------------------------------------------------------------------------------------------------------------------[]--------------
------------------------------------------------------------------------------------------------------------------------------------------------[]--------------
-------------------------------E-E---------E----------------------------------------------------------------------------------------oo----------[]--------------
---------------------------SSSSSSS?SSSSSSSSS?SSSS---------------------------------------------------Q-----------------o-------------------------[]---SSSSSSSSSSS
-------------------------<>--------------------------?-------------------------------------------Q-E----------------------------XXX-------------<>---SSSSSSSSSSS
-------------------------[]-------------------------------------------------------------------E----E---------------------------XXXX------------------SSSSSSSSSSS
-------------------------[]--------------------------------------------------------------<>-----------------------------------XXXXX------------------SSSSSSSSSSS
XXXXXXXXXXXXXXXXXXXXXXXXXXXXXXXXXXXXXXXXXXXXXXXXXXX---------------------EEXEXX-E------E--[]----------------------------XXXXX-XXXXXX-----XXXXXXXXXXE--XXXXXXXXXXX
XXXXXXXXXXXXXXXXXXXXXXXXXXXXXXXXXXXXXXXXXXXXXXXXXXXX--------------XXXXXXXXXXXX-XXXXXXXXXXXXXXXXXXXXXXXXXXXXXXXXXXXXXX--XXXXXXXXXXX---XXXXXXXXXXXXXX--XXXXXXXXXXX