----------------------------------------------------------------------------------------------------------------------------------------------------------------
----------------------------------------------------------------------------------------------------------------------------------------------------------------
----------------------------------------------------------------------------------------------------------------------------------------------------------------
----------------------------------------------------------------------------------------------------------------------------------------------------------------
----------------------------------------------------------------------------------------------------------------------------------------------------------------
---------------------------------------o--------------------------------------XXXXX-----------------------------------------------------------------------------
---------------------------------------X-------------------------------------------EX---------------------------------------------------------------------------
-------------------------------------------------------------------------SS-----------------XX-------------------------------------------XX---E---------------S-
--------------------XX---o-----------------------------------------------------------------------E------------------------------------------------oo------------
---------E--------------------------------ooooooooo--------------X------------------------------<>---------X----------------------------------------------------
----------XXX--------o------------------------------------------XX-----------<------------------[]--------XX----------------------------------------------------
---------------XXX---o-----------------------------------------XXX-------<>--[------------------XX--------XX----------<>----------------------------------------
--------------------------------------------------------------XXXX-------[]--[----<-----<>--------------XXXX----------[]----------------------------------------
-------------------------------------------------------------XXXXX-------[]--[----[-----[]---------B---XXXXX----------[]--------------E-----------------------<>
------------------------XXXXXXXXXXXXXXXX-<>--------XXXXXEXXXXXXXXX-------[]--[----[-----[]----------------XX----------[]----------XXX<>-----------------------[]
XXXXXXXXX--------------------------------[]---------XXXXXXXXXXXXXXXXXXXXXXX--[XXXXX-----XXXXXXXXXXXXXXXXXXXXXXXXXXXXXXXX-XXXX-X--XXXX[]-----------XXXXXXXXXXXXXX