----------------------------------------------------------------------------------------------------------------------------------------------------------------
----------------------------------------------------------------------------------------------------------------------------------------------------------------
----------------------------------------------------------------------------------------------------------------------------------------------------------------
--------------------------------------------------------------------------------ooo-----------------------------------------------------------------------------
--------------------------------------------------------------------------------o-o-----------------------------------------------------------------------------
----------------------------------------------------------------------------------------------------------------------------------------------------------------
--------------------------------------------------------------------------------XXX----------------------------------------------------------E----XXXXXXXXXXXXX-
-------------XXX---------------E------------------------------------------------------------------------------------------------------------SXX-----------------
------------XXXX---------------------------------------------E--------------------------------------------------------------------------------------------------
-----------XXXXX----------------------------------X---------<>--------------------------------------------------------------------------------------------------
----------XXXXXX---------------------------------XX---------[]----------?-----------------------------------------------------?-------ooo---------------------X-
----------XXXXXX------------------<>-------------XX---------XX-----------------------------<>-----------------------------<>---------o------S-------------------
--------XXXXXXXX------------------[]-----------XXXX--------------E-------------------------[]-----------------------------[]------------------------------------
-------XXXXXXXXX------------------[]----------XXXXX------------B---------------------------[]-------------------------B---[]------------------------------------
----------XXXXXX-E----------XXXX--XX-------------XX----------------------------------------[]-----------------------------[]---------------------X--------------
XXXXXXXXXXXXXXXXXXXXXXXXXXXXXXXX--XX---XXXXXXXXXXXXXXXXXXXXXXXXXXXXXXXXXXX<>X--------XXXXXXXXXXXXXXXXXXXXXXXXXXXXXXXXXXXXXXXXXXX<>XXXXXXXXXXXXXXXX--------------