----------------------------------------------------------------------------------------------------------------------------------------------------------------
----------------------------------------------------------------------------------------------------------------------------------------------------------------
----------------------------------------------------------------------------------------------------------------------------------------------------------------
----------------------------------------------------------------------------------------------------------------------------------------------------------------
-----SSSSSSS----------------------------------------------------------------------------------------------------------------------------------------------------
-------------------------------------------------------------------------o--------------------------------------------------------------------------------------
---------------XXX------------------------------------------------------XXX-------------------------------------------------------------------------------------
----------------------------------------QQ----------------------------------o---------------------------------------------------------------------------oo------
-----------------------------------------------------o---o---o---o---o------XXXXXXXXXXXX----------------------ooo--------------------------------------XX-------
-----------------------------oooooo-----------------XXX-XXX-XXX-XXX-XXX-----------------------------------------------------------------------------------------
-------------------------------------------------------------------------------------------------------------------------X--------------------------------------
----------XXX--------------------------QQQ-----------------------------------------------------------------<>-----------EX---------------B----------------XXXXXX
---------EXXX----------------------------------------------------------------------------------------------[]----------XXX----------B----b----------------------
--------XXXXX----------------------------------------------------------------------------------------------[]---------XXXX---------------B----------------------
-------XXXXXX---------------<>-----------------------------------------------------------------------------[]--------XXXXX-------XXXXXXXXXXXXXXXX---------------
XXXXXXXXXXXX----------------[]------XXXXXXXXXXXXXXXXXXXXXXXXXXXXXXXXXXXXXXXX------------------XXXXXXXXXXXXXXXXXXXXXXXXXXXXXXX<>--XXXXXXXXXXXXXXXXXXXXXX---------