----------------------------------------------------------------------------------------------------------------------------------------------------------------
----------------------------------------------------------------------------------------------------------------------------------------------------------------
----------------------------------------------------------------------------------------------------------------------------------------------------------------
--------------------------------------------------------------------------------------------------------------SSSSSSSSSSSSSSSSSSSSSSSSSSSSSSSSSSSSSSSSSSSSSSSSSS
--------------------------------------------------------------------------------------------------------------------SSSSSSSSSSSSSSSSSSSSSSSSSSSSSSSSS-----------
--------------------------------------------------------------------------------------------------------------------SSSSSSSSSSSSSSSSSSSSSSSSSSSSSSSSS-----------
---------------------------------------------------------X---XX-----XXX---------------------------------------------SSSSSSSSSSSSSSSSSSSSSSSSSSSSSSSSS-----------
----------------------------------------------------------------------------------------------------------------SSS---------------------------------------------
-----------------------------------------------------------ooooooo-------SS-------------------------------------SSS---------------------------------------------
--------------<>-------------------oo----------------------ooooooo------------X---------------------------------SSS---------------------------------E-----------
---------QQQ?-[]------------------------------XEXX---------------E-----------XX----------------------------o---?SSS---SSSSSSSSSSSSSSSSSSSSSSSSSSSSSSS-------SS?<
--------------[]---------------XXX------------------------------<>----------XXX------<>------------<>----------------------------------------------------------[
--------------[]--------------XXXX-------------------------E----[]---------XXXX------[]------------[]--------------<>------------------------------------------[
----E---------[]--------------XXXX------------------------<>----[]-----o--XXXXX------[]------------[]--------------[]------------------------------------------[
-----XXXXXXXXXXXXXXXXXXXXXXXXXXXXX---------XXX-------XX---[]----[]-----X-XXXXXX------[]------------[]---------XXXXXXXXXXXXXXXXXXXXXXXXXXXXXXXXXXXXXXXXXXXXXX---[
XXXXXXXXXXXXXXXXXXXXXXXXXXXXXXXXX---XXXXX-----------------[]----[]-------XXXXXXXXXXXXXXXXXXXXXXXXXXXXXXXXX----XXXXXXXXXXXXXXXXXXXXXXXXXXXXXXXXXXXXXXXXXXXXXX---[