----------------------------------------------------------------------------------------------------------------------------------------------------------------
----------------------------------------------------------------------------------------------------------------------------------------------------------------
----------------------------------------------------------------------------------------------------------------------------------------------------------------
----------------------------------------------------------------------------------------------------------------------------------------------------------------
----------------------------------------------------------------------------------------------------------------------------------------------------------------
----------------------------------------------------------------------------------------------------------------------------------------------------------------
------------XX-----XX----------------------------------------------------------SSSS---------------XXX-----------------------------------------------------------
--------E------------------------------------------------X--------------------SS------------QQ?--------------X--XX----------------------------------------------
---------------------------------------------------------X-------------------SSS-----------------------------X--------------------------------------------------
---------------------------------------------------------X------------------SSS----------------------------XXX--------------------------------------------------
---o-----------XX-------------------------------------XX-X-----------------SSSS-------------SSS------------XXX-----------------------------------------XXXXX----
----------------------------------------SSSSQ--------XXX-X------QQQQQQ?----------------------------------XXXXX--------------------------------------------------
----------------------------------------------------XXXX-X-----------------------------------------------XXXXX--------------------------------------------------
----------------------------------<>---------------XXXXX-X-----------------B--------X------------o-------XXXXX------------------------------------------------XX
------------------------------------------------XXXXXXXX-XXXXXXXXXXXXXXXXXXXXXXXXXXXX------------X-------XXXXX--------XXXXXXXXXXXXXXXXXXXXXXXXXE------X---------
XXXXXXXXX------------XXXXXXXXXXXXXXXXXXXXXXXXXXXXXXXXXX--XXXXXXXXXXXXXXXXXXXXXXXXXXXX----------------XXXXXXXXX----XXXXXXXXXXXXXXXXXXXXXXXXXXXXXXXXXX--X---------