----------------------------------------------------------------------------------------------------------------------------------------------------------------
----------------------------------------------------------------------------------------------------------------------------------------------------------------
----------------------------------------------------------------------------------------------------------------------------------------------------------------
----------------------------------------------------------------------------------------------------------------------------------------------SSS---------------
--XXXXXX--------------------------------------------------------------------------------------------SSSSSSSSSSSSSSSSSSSSSSSSSSSSSSSSSSSSSSSSSS------------------
--XXXXXX--------------------------------------------------------------------------------------------S-----------------------------------------------------------
--XXXXXX------------------------------------------------------o-ooo---------------------------------S-----------------------------------------------SSSSSS------
--XXXXXX-----------------------------------------XXXXX------------------------------------------------------------------------------------------------------o---
--XXXXXX-----------------------------------------XXXXX-----------------------------XXXXXXXX----------------------------------------------------------------XXX-X
--XXXXXX-----------------------------------------XXXXX-----------XX----E----------XXXXXXXX-----------------------------------------------------------E--E-------
--XXXXXX------------------------<>--------------XXXXXX----------------<>---------XXXX--------------------------------XXX----------------XXX--XXXX---SSSSSS------
--XXXXXX------------------------[]---<>--------XXXXXXX----------------[]--------XXXXX--------------SS-----------------------------------------------------------
--XXXXXX--------<>---<>---------[]---[]-------XXXXXXXX----------------[]-------XXXXXX---------------------<>-----<>-----------------<>--------------------------
--XXXXXX--------[]---[]---------[]---[]------XXXXXXXXX--------------X-[]------XXXXXX----<>----<--------<>-[]-----[]--------XXX---<>-[]--------------------------
--XXXXXXXXXXXXXXXXXXXXXXXXEEXEXXX]---[]-----XXXXXXXXXX----------------XXXXXX-XXXXXXX----[]----[--------[]-[]-----[]--------------[]-[]------------XXXXXXXXXXXXXX
XXXXXXXXXXXXXXXXXXXXXXXXXXXXXXXXXXXXXXXXXXXXXXXXXXXXXXXXXX----XXXX----XXXXXXXXXXXXXX----[]----XXXXXXX--XX-XX-----XX--------------XX-XX--------------------------