----------------------------------------------------------------------------------------------------------------------------------------------------------------
----------------------------------------------------------------------------------------------------------------------------------------------------------------
----------------------------------------------------------------------------------------------------------------------------------------------------------------
----------------------------------------------------------------------------------------------------------------------------------------------------------------
----------------------------------------------------------------X-----------------------------------------------------------------------------------------------
----------------------------------------------------------------------------------------------------------------------------------------------------------------
--------------------------------------------------------------------------------------------------XXXXXXX-------------------------------------------------XXXXX-
--------------------------------------------S---------------------------------------------------------------------------------------------------SS--------------
----------------------------------------------------------------------------------------------------------------------------------------------------------------
--------------------<>------------------------------------------------------------------------------------------------------------------------------------------
--------------------[]-----------------------S-----------?---------------------E--------------------------EXX---------------------------------------------XXXXXX
------------X-------XXS-----------SS--------------------------------------<>--<>-----QQ----------------------<>--------------------------------X----------------
------------X------------------------------X----------------E---X---------[]---------------------------------[]-------------------------------XX----------------
------------------------------------------XX------------------------------[]---------------B-----------------[]------------------------------XXX----<>----------
-----------------------------------------XXX------------------------------[]---------------b-----------------[]-----------------------------XXXX----[]----------
XXXXXXXXX----XXXXXXXXXXX-XXXXXXXXXXXXXXXXXXXXXX-XXXXXXXXXXXXXX-----XXXXXXXXXXXXXXXXXXXXXXXXXXXX--------------XXXXXX------------XX-----XXXXXXXXXXXXXXXXX---------