----------------------------------------------------------------------------------------------------------------------------------------------------------------
----------------------------------------------------------------------------------------------------------------------------------------------------------------
----------------------------------------------------------------------------------------------------------------------------------------------------------------
----------------------------------------------------------------------------------------------------------------------------------------------------------------
--------------------------------------S--------------------------------------------------------SSSSSSSSSSSSSSSSSSSSSSSSSSSSSSSSSSSSSSSSSSSSSSSSSSSSSSS----------
----------------------------------------------------------------------------------------------------------------------------------------------------------------
---------------------------------------------------X---XXXXXXX---------------------XXXXXXX----------------------------------------------------------------------
-------------XX-------------SSSSSSSSSSS-------------------------XXX-------------------------SSS------------------E---E---E-------oooo--------------------------X
------------XXX---SS-----------------------------------------------------E--------------------------------------<>--<>--<>-------------------------------------X
-----------XXXX--------X----------------------------------------o-o-------------------------S-------------------[]--[]--[]-----S-SSSS-S------------------------X
-----------XXXX-------XX-XX-------------------------------------o-o-XXXXXXXXXX-------------S-S------------------[]--[]--[]-----SoS--SoS------------------------X
--XX-------XXXX------XXXXXX----<>-------------------------------------------------------------S--E---------E--SS[]SS[]SS[]SS---SSS--SSS------------XXX---------X
-XXXX------XXXX-----XXXXXXX----[]---------------------------------------------------------------<>--------<>----[]--[]--[]--------------------------------------
-XXXXX-----XXXX----XXXXXXXX----[]---------------------o-----------------------------------------[]--------[]----[]--[]--[]--------------------------------------
-XXXXXXXXXXXXXX---XXXXXXXXXX---[]---------------------X-----------------------------------------[]------E-[]-E--[]--[]--[]------------------X-------------------
XXXXXXXXXXXXXXX---XXXXXXXXXX---XX----XXXXXXXXXXX-----------------------------XXXXXX--------XXXXXXXXXXXXXXXXXXXXXXXXXXXXXXXXXXXXXXXXXXXXXXXXXX------X--------XXXX