----------------------------------------------------------------------------------------------------------------------------------------------------------------
----------------------------------------------------------------------------------------------------------------------------------------------------------------
----------------------------------------------------------------------------------------------------------------------------------------------------------------
----------------------------------------------------------------------------------------------------------------------------------------------------------------
----------------------------------------------------------------------------------------------------------------------------------------------------------------
----------------------------------------------------------------------------------------------------------------------------------------------------------------
-----------------------------------XXXXXX-----------------------------------------------------E-----------------SSSSSSSSSSSSSSSSS-------------------------------
-------XXX--XXXXoo-----------------------------------------------SSS--------------SSSSSS-----------------------S------------------------------XXXXX-------------
------XXXX------------XX---o----------------------------------------------------------------------------------SS-----------------------------XXXXXX-------------
-----XXXXX---------------------------------------------------------------------------------E----------------SSSS----------------------------XXXXXXX-------------
----oXXXXX-------------o------------------------------------------------------------------<>--------------<>-SSS-----------SSSSSS----------XXXXXXXX---o----oo---
-----XXXXX--------XX---o--------------------XXXX------------------E-E------------S----<>--[]-------------X[]-------------<>-------------X-XXXXXXXXX----X--------
-----XXXXX-------------------------------------------->-------------X-----------------[]--[]------------XX[]-------------[]------------XXXXXXXXXXXX-------------
-----XXXXX-------------------------------------------<]-------------X-----------------[]--[]-----------XXX[]-----------X-[]-----------XXXXXXXXXXXXX-------------
-----XXXXX----------------XXXXXXX--------------------[]E------------X-----------------[]--[]---XXE----XXXXXXXXXXXXXXXXXXXXXXXXXXXXXXXXXXXXXXXXXXXXX-------------
XXX--XXXXX-------------------------------------------XXXXXXXXXXXXXXXXXXXXXXXXXXXXXXX--XX--[]---XXXXXXXXXXXXXXXXXXXXXXXXXXXXXXXXXXXXXXXXXXXXXXXXXXXXXX----XXXXXXX