----------------------------------------------------------------------------------------------------------------------------------------------------------------
----------------------------------------------------------------------------------------------------------------------------------------------------------------
----------------------------------------------------------------------------------------------------------------------------------------------------------------
----------------------------------------------------------------------------------------------------------------------------------------------------------------
----------------------------------------------------------------------------------------------------------------------------------------------------------------
----------------------------------------------------------------------------------------------------------------------------------------------------------------
--------------------------------------------------------XXXX--------------------------------------------------------------------XX------------------------------
----------------------------------------------------------------XX----------------------------------------------------------------------------------------------
------------------------------------------SS---------------------------oooo---------------------------------------------------E----------o----------------------
--------------------------------------------------------------------------------------------------------------------------XXXXXX--------------------------------
------ooooo---------------------------<>-------------------------------------------------------------------------------------------XXX--------------------------
--------------------------------------[]-----X----------------XX----<>-----------------------------------------------------------------------------E----ooo-----
---------------E?QQ-------------------[]----XX----------------------[]------------------------------------------------XXXXX-------------------------------------
--E-----------------------------------[]---XXX----------------------[]-----------<>-----------------------------------------------------------------------------
--------------------------------------[]--XXXXXXXXXXX---------------[]-----------[]----XXXXX---XXXXXXXXXXXX-----------------------------XXXXXXX----XXXXX--------
XXXXXXXXX---X-X-XXXXXXXXXXXX--XXX-----XXX-XXXXXXXXXXXXX---------XXXXXXXXXXXXXXXXXXXXXXXXXXXX--------------------XXXX--------------XXX-------------------XXXXXXXX