----------------------------------------------------------------------------------------------------------------------------------------------------------------
----------------------------------------------------------------------------------------------------------------------------------------------------------------
----------------------------------------------------------------------------------------------------------------------------------------------------------------
----------------------------------------------------------------------------------------------------------------------------------------------------------------
----------------------------------------------------------------------------------------------------------------------------------------------------------------
----------------------------------------------------------------------------------------------------------------------------------------------------------------
----------------------------------------------------------E-------------------------------------------oo--------------------------------------------------------
----------------------------------------------------------S------------------------------------------------SS-----XXXXX------------E----------------------------
-------------------------------------------------------------------------------------E--------E-----------------------------------<>----------------------------
----------------------------------------------------<>----?-------E------------------------------?--------------------------------[]----------------------------
------------------------QQQQQQQQQQQ-----------------[]----------------------------XSSSSSSSSSSSSSSSSSS--------S--------------------[]------------------------XXX-
----------------------------------------------------XXS------?-------------------XX-------------------------------------------<>--XXS---------------XXX---------
----------------------------------------------------------X--------XXXXX---------XX----ooooo----o-----------------------------[]--------------------------------
----<>----------------------------------X-----------------X----------------------XX-------------------------------------------[]--------------------------------
----[]-------------E----XXXXXXXXXXXXXXXXX-----------------X----------------------XX----ooooo----o-----E-----------------------[]--------------------------------
XXXXXXXXX--XXXXXXXXXX---XXXXXXXXXXXXXXXXXXXXXXXXXXXXXXXXXXXX---------------------XXXXXXXXXXXXXXXXXXXXXXXXXXXXXX----------XXXXXXXXXXXXXXXXXXXXXXXXXXX------------