----------------------------------------------------------------------------------------------------------------------------------------------------------------
----------------------------------------------------------------------------------------------------------------------------------------------------------------
----------------------------------------------------------------------------------------------------------------------------------------------------------------
----------------------------------------------------------------------------------------------------------------------------------------------------------------
----------------------------------------------------------------------------------------------------------------------------------------------------------------
----------------------------------------------------------------------------------------------------------------------------------------------------------------
-------oo-ooo----------------------------------------------?QQQQQQ--------------XXXXX------------------------------------------------------------------------E--
------------------E--------------------X--------------------------------------------------------X-----------------oo---------------------SSSSSSSSSSSSSSS--------
--------------------XXX-----------------------------------------------------------------------------------------------------------------------------------------
-----------XX-------oo-----------------------------------------------------------------------------------------------------E------------------------------------
-----------------------------------------------------------S--------XXXXXXX-----------------------------------------------<>--------------E--------SS-----------
--<>-----------------------------------------------------------------------------------E---XX-----------------------XXXX--[]-------------->------SS-------------
--[]--------------------------XXXXXX--------------------------------------------------<>----------------------------------[]-------------<]----<>---------------
--[]----------XXX-------------------------------------------EE------------------------[]--------------E-------------------[]-------------[]----[]---------------
--[]-E-E-----------------XXXX---------------XXXXXXXXXXXXXXXXXXX----X-----------------X[]X---------------------------------[]----E--------[]----[]----E----------
XXXXXXXXXXXX---------------------------XXXXXXXXXXXXXXXXXXXXXXXX----X----------------------------XXXXXXXXXXXXX<>X-------XXXXXXXXXXXXXXXXXXXXXXXXXXXXXXXXXXXXXXXXX