----------------------------------------------------------------------------------------------------------------------------------------------------------------
----------------------------------------------------------------------------------------------------------------------------------------------------------------
----------------------------------------------------------------------------------------------------------------------------------------------------------------
--------------------------------------------------------------------------------------------------------------SSSSSSSSSSSSSS------------------------------------
----------------------------------------------------------------------------------------------------------------------[]----------------------------------------
----------------------------------------------------------------------------------------------------------------------[]----------------------------------------
----------------------------------------------------------------X----------------------------SSS----------------------[]--------------------------XXX-----Eooooo
---S--------------------------------------------------------------------------EXX-------------------------------------[]----SSS---------------------------XXXXXX
-----------------------------------------------------------------------------EXXX-------------------------------------[]---S------------------------------------
-----------------------------------------------------o-------------------<>--XXXX-------------------------------------[]---S------------------------------------
--------------------------------------------X------------------------QQ?-[]--XXXX-------------------------------------[]---S--------XXXXXXXXXX------------------
------------------------------------SSSSSSSSX-----SSS--------------------[]--XXXX-------------------------------------<>------------X-------------------XXXXXXXX
-------------------------------------------------------------------------[]--XXXX-------------------------------------------------------------------------------
-----------------------------------------------------------E-------------[]--XXXX-------------------------------------------------------------------------------
------------------------EE----------------------------------XXXXXXXXXXXXXXXXXXXXX---------XXXXXXXXXXXXXXXXXXXXXXXXXXXXXXE--XE-----------------------------------
XXXXXXXXXXXXXXXXXXXXXX--XXXX-XXXXXX--XXXXXXXXXXXX--XXXXXXXXXXXXXXXXXXXXXXXXXXXXXXXXXXXXXXXXXXXXXXXXXXXXXXXXXXXXXXXXXXXXXX--XXXXXXX------------X-----------------