----------------------------------------------------------------------------------------------------------------------------------------------------------------
----------------------------------------------------------------------------------------------------------------------------------------------------------------
----------------------------------------------------------------------------------------------------------------------------------------------------------------
----------------------------------------------------------------------------------------------------------------------------------------------------------------
-------------------------------------------------------------?--------------------------------SSSSSSSSSSSSSSSSSSSSSSSSS-----------------------------------------
----------------------------------------------------------------------------------------------SSSSSSSSSSSSSSSSSSSSSS--------------------------------------------
----------------------E-----------------------------------------------------------------------SSSSSSSSSSSSSSSSSSSSSS--------------------------------------------
-------------E---SSSSSSSS----S--------XXXXX---------------------------------------------------SSSSSSSSSSSSSSSSSSSSSS---------------------------------------E----
------------<>--------------------------------------------------------------------------------------------------------------------------------------------------
------------[]--------------------------------------------------------------------E--------------------------------------------------------XXXXXXXX-----X-------
------------[]-------------------------------------ooo-----SS---------------------oX-----------oooooooooooooooooo-----------------------------------------------
------------XXX--QQ---------SS----------------------------------------------------------------S?SSSSSSSSSSSSSSSSS--------------------------------------------XXX
---------------------X----E---------------------<>-------------------XXXXXXXXXXXXXXX----------SSS---------------------E-----------------------------------------
--------<>-----------X----------------------<>--[]------------------XXXXX---------------X-----SS-------------------X-<>-----------------------------------------
--------[]-----------X----------------------[]--[]------------------XXXXX---------------X----------EE---EE---EE---XX-[]-----------------------------------ooo---
XXXXXXXXXXXXXXXXXXXXXXXXXXXXXXXX--X--------XXXXXXXXXXXXXXXXXXXXXX--XXXXXX-------------XXXXXXXXXXXXXXXXXXXXXXXXXXXXXXXXXXXXXXXXXXXXX-----------------------XXX---