----------------------------------------------------------------------------------------------------------------------------------------------------------------
----------------------------------------------------------------------------------------------------------------------------------------------------------------
----------------------------------------------------------------------------------------------------------------------------------------------------------------
----------------------------------------------------------------------------------------------------------------------------------------------------------------
-----------------------------------------------------------------------------SSSSSSSSSSSSS----------------------------------------------------------------------
----------------------------------------------------------------------------------------------------------------------------------------------------------------
-------------XX------------------------oooo---------------------------------------------------------------------------------------------------------------------
---------------------------------------XXXXXX----------------------------------------------------X--------------------------------------------------------------
---------------------------------------------------XX-----------------------------------------------------------------------------------------------------------
-------------------E---ooo--------------------------------------------------------------------------------------------------------------------------------------
----------------------o-oo--------------------------o---ooooo-----------------------E-------------------------------------ooooo---------------------------------
--------------------------------------------XXXX----o--XXXXXXX---------------------<>------------------------------------XXXXXXX-----------E----XX--------------
--?QQ---------------XXXXXXXXXXXXXXXXX-?---------------------------------E----------[]-SSSSSSS-S--------------------XXXX-------------------------XX----E---------
-----------------------------------------------------------------------------------[]-SSSSSSS-S-------------------------------------------------XXX-------------
-----------------------------------------------------------------------------------[]-SSSSSSS-S-----XX------------------------------------------XXX-------X---XX
XXXXXXXX-X----------------------------XXXXXXX----------------XXXXXXXXXXXXXXXXXXXXXXXX-XXXXSSS-S--X--X--XXXXXXXXXXXX------------XXXXXXXXXXXXXXXXXXXXXXXXXXXX---XX