----------------------------------------------------------------------------------------------------------------------------------------------------------------
----------------------------------------------------------------------------------------------------------------------------------------------------------------
----------------------------------------------------------------------------------------------------------------------------------------------------------------
----------------------------------------------------------------------------------------------------------------------------------------------------------------
----------------------------------------------------------------------------------------------------------------------------------------------------------------
----------------------------------------------------------------------------------------------------------------------------------------------------------------
-------------------------------------------------------------------------------------Q-?-----------------------------------E------------------------------------
--------------XX---------SSSSSS-----SSSSS---------------------XX------------------------------------------------------SSSSSSSSS---------------------------------
----------------------------------------------------------------------------------------------------------------------------------------------------------------
------------------------------------------------------------------XXX---------------------------------E---------------------------------------------------------
-------------------------------------------oo------------X---------------ooo---------E-----XXX-----XXXXXXXXXX-------------------------------ooooo---------------
-----------------------QQQQ---ES---------------XX--------X-----------------------XXXXEXXX---------------------------QQQQ-------------------XXXXXXX--------------
-----------------------------<>---E-----------XXX--------X----------------------------------------------------------------X-------XXXXXXX-----------------------
-----------------------------[]--<>-----------XXX-------EX----------------------------------------------------------------X-------------------------------------
-----E-----------------------[]--[]-----------XXX--XXXXXXX----------------------------------------------------------------X-------------------------------------
-XXXXXXXXXXXXXXXXXXXXXXXXXXXXXXXXXXXX----XXXXXXXX--XXXXXXX--------XXXXXXXXXXXX-----------------X--------------XXXXXXXXXXXXXXXX-XXX---------------XXXXXXXXXXXXXXX