----------------------------------------------------------------------------------------------------------------------------------------------------------------
----------------------------------------------------------------------------------------------------------------------------------------------------------------
----------------------------------------------------------------------------------------------------------------------------------------------------------------
----------------------------------------------------------------------------------------------------------------------------------------------------------------
----------------------------------------------------------------------------------------------------------------------------------------------------------------
----------------------------------------------------------------------------------------------------------------------------------------------------------------
------------------------------------------E-------E-------------------------------------------------------------------------------------------------------------
---------------------XXXXX----------SSSSSSSSSSSSSSSS------------------------------------------------XX--------------------------------------------------------S-
-----------------------------------------------------------------------------------------XXX-------EXX----------------------------------------------------------
--------------------------------------------------------------------------------------------------EXXX----------------------------------------------------------
----------------------------------------------------------?--------------------------------------XXXXX------SSSSSS------XXX-------------------------------------
-------------XX--XXXX-------------<>------------SSSS------------------------------------------XXXXXXXX------------------------------------------<>--------------
--------------------------------<>[]----------<>---------------XXXXXXXXXXXXXXXXXXXXXXXXXXX----XXXXXXXX------------------------------------------[]---------E----
--------------------------------[][]----------[]----------E-------------------------------------XXXXXX------------------------------------------[]--------<>----
--------XXX---------------------[][]---X------[]------------------------------------------------XXXXXX----------------------XXXXXXXXXX-----E--E-[]-----E--[]----
--XX----X------------XXX--XXXXXXXXXX---XXXXXXXXXXXXXXXXXXXXXX-----------------------------------XXXXXXXXXXXXXXXXXXX-----------------------XXXXXXXXXXXXXXX-XXXXXX