----------------------------------------------------------------------------------------------------------------------------------------------------------------
----------------------------------------------------------------------------------------------------------------------------------------------------------------
----------------------------------------------------------------------------------------------------------------------------------------------------------------
----------------------------------------------------------------------------------------------------------------------------------------------------------------
----------------------------------------------------------------------------------------------------------------------------------------------------------------
----------------------------------------------------------------------------------------------------------------------------------------------------------------
--------------------------------------XXXX-----------------oo-ooo-----------------------------------------------------------------------------------------------
--------------------------QQQQQX----------------------------------------------SQS----------------------------------------Q--------------------------------------
-------------------------------X--------------------XX----------------------------------------------------------------------------------------------------------
-------------------------------X-------------------------------XX-------------------------ooooo-----------------------------------------------------------------
-------------------E-----------X---------------------o------------------------------------ooooo---------------------------------------------------------------XX
---<>-------------<>-----E?QQQQX------------XXXXXX---o------------------------S?S--------------------E---XXXXXX--------S?SQSS?----------------------------------
---[]---------------------------------------------------------------------------------<------------------------------E--------------------------E---------<>----
---[]--------------------------E----------------------------------XX------<>----------[-XXXXXXXXXXXXXXXX---------------------S-----<>---------------------[]----
---[]------------------------------X--------------------------------------[]----------[-X------------------------------------------[]---------------------[]----
XXXXXXXXXXXXXXXXXXXXXXXXXXXXXXXXXXXX------------------------XXXX------XXXXXXXXXXXXXXXXX-X-----------------------XXXXXXXXXXXXXXX-XXXXXXXXXXXXXXXXXXXXXXXX--[]X---