----------------------------------------------------------------------------------------------------------------------------------------------------------------
----------------------------------------------------------------------------------------------------------------------------------------------------------------
----------------------------------------------------------------------------------------------------------------------------------------------------------------
----------------------------------------------------------------------------------------------------------------------------------------------------------------
---------------------------------------------SSSSSSSSSSSSSSSSSSSSSSSSSSSSSSSSSSSSSSSSSSS------------------------------------------------------------------------
----------------------------------------------------------------------------------------------------------------------------------------------------------------
----------------------------------------------------------------------------------------------------------------------------------------------------------------
---------XXXX---oo----------------------------E---------------------------------E------------------SSS----------------------------------------------------------
---------------------------------------------<>--------------------------------<>-------------------------ooo---------------------------------------------------
---------------------------------------------[]--------------------------------[]-----------------------------------------------------------E-------------------
---------------------------------------------[]-----------------S--------------[]----------------------------------------------------------<>-------------------
--X-----------XX--XXXXXXEXX------------------[]--------E--E---E----E------E--SS[]SS--QQQ---------X?----<>--------X----oo-------------------[]-------------------
--X-----------------------X------------------[]-------<>-->--<>---<>-----<>----[]---------------XX-----[]--------X--------------------<>---[]-------------------
--X-----------------------X---------B--------[]-------[]-<]--[]---[]-----[]----[]--------------XXX-----[]--------X--------------------[]---[]-------------B-----
--X-----------------------X---------------E--[]-----E-[]-[]--[]---[]---E-[]-E--[]---------XXXXXXXX-----[]--------X--------------------[]---[]-------------------
XXXXXXXX------------------X-----XXXXXXXXX--XXXXXXXXXXXXXXXXXXXXXXXXXXXXXXXXXXXXXXXXXXXXX--XXXXXXXXXXXXXXXXXXXXXXXXXXXXXX--XXXXXXXXXXXXXXXXXXXXXXXXXXXXXXXXXXXXX-