----------------------------------------------------------------------------------------------------------------------------------------------------------------
----------------------------------------------------------------------------------------------------------------------------------------------------------------
----------------------------------------------------------------------------------------------------------------------------------------------------------------
----------------------------------------------------------------------------------------------------------------------------------------------------------------
----------------------------------------------------------------------------------------------------------------------------------------------------------------
----------------------------------------------------------------------------------------------------------------------------------------------------------------
---------------------------------------------------------------------------------------------------------------------------X-------------------------XX-------oo
--------------------------------------------------------------------------------------------------E-------------------------------------------------------------
------------------------------XSSS------------------------------------------------------oo----------------------------------------------------------------------
-----------------------------XXX--------------------------------------------------------------------------------------------------------------------------------
----------------------------XXXS----------------------------------------------------------------SS------------------------------S-SQ----------------------------
----------------------------XXXX------>--------------------------------E---------------------------------------------------------------------------------XXXXX--
-------------------------XXXXXXX-SSS--]--------E-----------------------E----------------------------------------------------------------------------------------
------------------------XXXXXXXX------]--------------------E----------------------------------------------------------------<>---------------------------------X
-------------------EE-------XXXX------]---------------------------------------------------------------XXXXXXXXXXXXXXXXXXX---[]----SSSSS-------------------------
XXXXXXXXXXXXXXXXXXXXXXXXXXXXXXXXXX---XXXXXXXXXXXXXXXXXXXXXXXXXXXXXXXXXXXXXXXXXXXXXXXX---XXXX-XXXXX--------------------------[]--------XXXXXXX-------------------