----------------------------------------------------------------------------------------------------------------------------------------------------------------
----------------------------------------------------------------------------------------------------------------------------------------------------------------
----------------------------------------------------------------------------------------------------------------------------------------------------------------
------------------------------------------------------------------------------------------------------------------------------------------XXXX------------------
-------------------------------------------------------------------------------------------------------------------------------------------[]-------------------
-------------------------------------------------------------------------------------------------------------------------------------------[]-------------------
---------------------------------------XXXX--------------------------------------------------ooooo-----------------------------------------<>-------------------
--------------XXX----------XXX---------------------------------------------------------------ooooo---------------------------------E----------------------------
---------------------------------------------------------------------------------------------------------------Eo---------SS----------------E-------------------
---------------------------o-o---------------------------------------------------------------------------------SS--------------------X--------------------------
----------?----------------o-o-XXXXXX-------------------------------ooooooooooooooooooo---------------------------------------XX----XX------------------E-------
--------------------------------------------------X-----------------ooooooooooooooooooo---E-------XXXXXXXEXX-----------------XXX--<>XX-------->--------<>-------
----------------------------------------XXX------XX-----------------------------------------------X--------X----------------XXXX--[]XX-------<]-----------------
----------E-------------------------------------XXX--------------XXXXXXXXXXXXXXXXXXXXEXXXXXX------X--------X---------------XXXXX-X[]XX-------[]-----------------
---------------------------------------------XXXXXXXXXXXXXXXXXX-XXX------------------------X------X--------X-----------E--XXXXXXXX[]XX-------[]-----------------
XXXXXXXXXXXXX--------------------------------XXXXXXXXXXXXXXXXXX-XXX------------------------X------X--------X-----XXXXXXXX-XXXXXXXXXXXXXXX----[XXXXXXXXXXXXXXXXXX