----------------------------------------------------------------------------------------------------------------------------------------------------------------
----------------------------------------------------------------------------------------------------------------------------------------------------------------
----------------------------------------------------------------------------------------------------------------------------------------------------------------
----------------------------------------------------------------------------------------------------------------------------------------------------------------
-------------------------------------XXXXXXXXXXX-----------------------------------------------------------------oo---------------------------------------------
-------------------------------------XXXXXXXXXXX------------------------------------------------o-o-------------------------------------------------------------
------------XX-----------------------XXXXXXXXXXX------------------------------------------------o-o---------------------E---------------------------------------
------------------------------SS-----XXXXXXXXXXX--------?------------------SQS-----------------------------------XXX-------------------------------------?SSS---
-------------------------------------XXXXXXXXXXX----------------------------------------------------------------------------------------------------------------
-------------------------------------XXXXXXXXXXX-----------------XSS--o----------------------------------------------------------------------------------------E
------------------------------------oXXXXXXXXXXX----------------XXX------------------------------XX--------E------------------XEXXXXXX-----------------E------<>
------------------------------SS-----XXXXXXXXXXX----------------XXX-SS-----S?S--------------<>------------<>--------XX--------------------------------<>---E--[]
----------------------<>-------------XXXXXXXXXXX--------------XXXXX-------------------------[]--------------------------------------------------------[]--<>--[]
----------------------[]-------------XXXXXXXXXXX-----B-------XXXXXX--SSS--------------------[]--------------------------------------------------------[]--[]--[]
----------------------[]E------------XXXXXXXXXXX-----b----------XXX-------------------------[]---------E-----------------XXXXX---------------E--------[]--[]--[]
XXXXXXXXX------XXXXXXXXXXXXXXXXXXXX--XXXXXXXXXXX----XXXXXXXXXXXXXX------XXXXXXXXXXXXXXXXXXXXXXX------XXXXXXXXXXXX--------X-----------XXXXXXXXXXXXXXXXXXXXXXXXXXX