----------------------------------------------------------------------------------------------------------------------------------------------------------------
----------------------------------------------------------------------------------------------------------------------------------------------------------------
----------------------------------------------------------------------------------------------------------------------------------------------------------------
----------------------------------------------------------------------------------------------------------------------------------------------------------------
--------------------------X--------------------------oo---------------------------------------------------------------------------------------------------------
----------------------------------------------------------------------------------------------------------------------------------------------------------------
----------------Q-?-------------------------------------------------------------------------------------SSSS-------SSSSSSSSSS-----------------------------------
-----------------------------------------------------XXX--oo---------------------------------------------[]-----------------------------------------------------
---------------------------------------------------------------------------------------------------------[]-----------------------------------------------------
---------------------------------------------------------------------------------------------------------[]--------------E--------------------------------------
----------------E---------------------------------------------------------------------E-------------<>---[]-------------<>---------------ooo--------------------
-<>----------XXXEXXX--------------------------SS--------XX--XXX----------------------<>-------------[]---<>-------------[]-------------------------------------X
-[]-----------------------X-------------------------------------------------------------------------[]------------------[]---------------------------------E--XX
-[]--------------------------------------------------------------X-B--------------------------------[]----E-------------[]------B-----<>---------------------XXX
-[]--------------------------------------------------------------XXX--XXXX--------------------XXXXXXXXXXXXXXXXXXXXXXXXXXXXXXXXX-------[]--------------------XXXX
XXXXXXXXXXXXX----------------------XXXXXXXXXXXXXXXXXX------------XXX-----------XXXXXXXXX------XXXXXXXXXXXXXXXXXXXXXXXXXXXXXXXXXXXXXXXXXXXXXXXXXXXXXXX-XXXXXXXXXX