----------------------------------------------------------------------------------------------------------------------------------------------------------------
----------------------------------------------------------------------------------------------------------------------------------------------------------------
----------------------------------------------------------------------------------------------------------------------------------------------------------------
----------------------------------------------------------------------------------------------------------------------------------------------------------------
--------------------------------------------------------------------------------------SSSSSSSSSSSSSSSSSSS?SSSSSSSSSSSSSSSSSSS-----------------------------------
------------------------------------------------------------------------------------------------------------------------SSSSS-----------------------------------
-------------------------------XXXXXXXXXXXXXXXXXXXXXXX------------------------XXX---------------------------------------SSSSS-----------------------------------
---S---------E------SSSSSSS-----------------------------------XXX------------------SSS---------------ooooo--------------SSSSS-----------oo----------------------
------------------------------------------------------------------------------------------------------------------------SSSSS----------XX---------XXX-----------
--------------------------------------------------------------o-o------------------S-----------------SSSSS--------------SSSSS------E----------------------------
--------------------------------------------XXXXXXXXXXXX------o-o-XXXXXX----------S-S----------------SSSSS---E----------SSSSS-----<>---------------------E------
---------------------S---<>----------------------------------------------------------S----------------------<>------<>-----SS-----[]--------XXXX--------<>------
--------E--------------E-[]--------------------------------------------------------------------<>-----------[]------[]-----SS-----[]--------------------[]------
---<>--------------------[]---o-------------------------------------------------------------<>-[]-----------[]------[]-----SS--E--[]--------------------[]------
---[]--------------------[]---X------------------------XXXX-------------------------------E-[]-[]-----------[]------[]------------[]--------------------[]-EE---
XXXXXXXXXXXXXXXXXXXXXXXXXXX-------------------------------------------------------XXXXXXXXXXXX-XX---XXXXXXXXXX----XXXXXXXXXXXXXX--[]-XX----------------XXXXXXXXX