----------------------------------------------------------------------------------------------------------------------------------------------------------------
----------------------------------------------------------------------------------------------------------------------------------------------------------------
----------------------------------------------------------------------------------------------------------------------------------------------------------------
----------------------------------------------------------------------------------------------------------------------------------------------------------------
----------------------------------------------------------------------------------------------------------------------------------------------------------------
----------------------------------------------------------------------------------------------------------------------------------------------------------------
-----------ooo------------------------------------------------------------XX-------------------oo----------?-----XXX--------------------------------------------
XX---------ooo--------------------------------------------------------------------------XXXX--------------------------------------------------------------------
-----------------------------------------ooooo--------------------------E---------------------------------------------------XX----------------------------------
-------------------------------------------------------oooo---------XXXXXX--------------------------------------------------------E-----------------------------
----------------------------oooooooo-------------------oooo------------------XX----------------------XXXXXEX-----XXXXX-------o---<>-----------------------------
----------XX--XXXXX------------------------------------------------------------------<>---------XX---------------------------o---[]-----------------------------
--------------X------------------------X-----------------------XXXXXX----------------[]------------------------------------------[]-------<>------<>------------
--------------X------------------------X------------EXXXXXXXX------------------------[]------------------------------------------[]-------[]------[]------------
--------------X------------------------X---------------------------------------------XX------------------------------XXXXX-------[]-------[]------[]------------
XXXXXXX-------X---------XXXXXXXXXXXXXXXXXXXXXXXXXXXX------------------------XX-------XX------------------------------------------XXXXXXXXXXXXXXXXXXXXXXXXXXXXXXX