----------------------------------------------------------------------------------------------------------------------------------------------------------------
----------------------------------------------------------------------------------------------------------------------------------------------------------------
----------------------------------------------------------------------------------------------------------------------------------------------------------------
----------------------------------------------------------------------------------------------------------------------------------------------------------------
---------------------E-----------------SSSSSSSSSSSSSSSSSSSSS----------------------------------------------------------------------------------------------------
---------------------------------------------------------------------------------o-----------E------------------------------------------------------------------
----------------------------XXXXXX----------------------------------------------XXXX-----------------------------------SS------E---E------XXXX------------------
----------XXXXXXXXXX--XXX-----------SSS----------------------------------------------o----------------------------------------SSSSSSS--oo-----------------------
------------------------------------------------------------------XXXXX--o---o-------XXXXXXX--------XX--------------------------------XX------------------------
------------------------------------S-----------------------------------XXX-XXX---------------------------------------o-----------------------------------------
-----------------------------------S-S-------E-------E-----------------------------------------------o-------o--------XXXXX---------------------XX---<----------
--------------------------------------S-----<>------<>----------X-----------------------------XXXX---o----------S?S----------------------------------[----------
Q-------------------------------------------[]------[]---SSS---XX-----------------------------------------------------------------X------------------[---<>-----
--------------------------------------------[]------[]---SSS--XXX-----------------------------------------------------------------X------------------[---[]-----
---------------------X------------------E---[]------[]---SSSXXXXX-----------------------------------------------------------------X------------------[---[]-----
XXXXXXXX---XXX-XX---XX-------------XXXXXXXXXXX--XXXXXX---XXXXXXXXX------XXXXXXXXXXXXX---------------------XX--XXXXXX----------XXXXXXXX------------X--XXXXXXXXXXX