----------------------------------------------------------------------------------------------------------------------------------------------------------------
----------------------------------------------------------------------------------------------------------------------------------------------------------------
----------------------------------------------------------------------------------------------------------------------------------------------------------------
----------------------------------------------------------------------------------------------------------------------------------------------------------------
----------------------------------------------------------------------------------------------------------------------------------------------------------------
------oo--------------------------------------------------------------------------------------XX----------------------------------------------------oo----------
XXX---oo----------------XXX--------------------------------------------ooooooo----------------XX----------------------------------------------------oo----------
-----------------------------------------------SSSS------SS----------SSSSSSSSSS---------------XX----------------------------------------------------------------
--------------------------------------------------------------XXX-----------------------------XX----------------------------------------------------------------
----------------------------------------------------------------------------------------------XX----------------------------------------------------------------
---------?--------------------------------------E---------------------------------------------XX-------------------XX-------ooooo----------------------?--------
-----------------------------------------------SSSS--------------------?SSSSS-----------------XX------------------XXX----------------------------------------<>-
--------------------------------<>-------------------<----------------------------------------XX-----------------XXXX--------------------------E-------------[]-
--------------------------------[]-------------------[----------------------------------------XX-----------<>---XXXXX----------------------------------------[]-
------------X--XXXXXXXEXXXXXX---[]------E------------[----------------------EE------------E---XX--------E--[]--XXXXXXX---------------------------------------[]-
---------XXXX-------------------[]XXXXXXXXXXXXXXXXXXXXXXXX-X---------XXXXXXXXXXXXXXXXXXXXXXXXXXX-XXXXXXXXXXXXXXXXXXXXXXXXXXXXXXXXXXXXXXXXXXXX-X--------XXXXXXXXX