----------------------------------------------------------------------------------------------------------------------------------------------------------------
----------------------------------------------------------------------------------------------------------------------------------------------------------------
----------------------------------------------------------------------------------------------------------------------------------------------------------------
----------------------------------------ooo----------------------------SSSSSSSSSSSSSSSSSSSSSS-------------------------------------------------------------------
----------------------------------------o-o------------------------------[]------------------SSSSSSSSSSSSSSSSSSSSS----------------------------------------------
-------------------------------------------------------------------------[]-------------------------------------------------------------------------------------
---------------E--XX--------------------XXX----oo------------------------[]-----------------------------------------------------XXX---SSS---------------E-------
-------------------------------------------------------------------------[]----------------------------------------------------------------X---SSSS----SQSSS----
----oo-------------------------------------------------------------------[]---------------------------------------------------------------XX--------------------
---------------X---------------------------------------------------------[]--------------------------------------------------------------XXX--------------------
----------------------XXXX-----------------------------------------------[]----<>---<>---<>---------------------------------------------XXXX----E------------QQQ
--------------------------------------------------?----------------------<>----[]---[]---[]---------------------------XXXXXXEX---------XXXXX---SSSS----SQSSS----
----------E--X-----------------------------------------------------------------[]---[]---[]--<>---------------------------------------XXXXXX-------------------E
------------XX-----------------------------------------X-----------------------[]---[]---[]--[]-----<>--XXX--XX----------------------XXXXXXX--------------------
E-------X--XXX-----------------------------------------XXXXXXXXXXXXXXXXXXXXE---[]---[]---[]--[]-----[]-------------------------------XXXXXXX---------E------XXXX
X---XXXXXXXXXX-----------XXXXXXXXXXXX---------XXX------XXXXXXXXXXXXXXXXXXXXX---[]---[]---[]--XX-----XX------------XXXXX--------------XXXXXXXXXXXXXXXXXXXXX-XXXXX