----------------------------------------------------------------------------------------------------------------------------------------------------------------
----------------------------------------------------------------------------------------------------------------------------------------------------------------
----------------------------------------------------------------------------------------------------------------------------------------------------------------
--------------------------------------------------------------SSSSSSSSSSSSSSS-----------------------------------------------------------------------------------
--------------------------X-------------------------------------------------------------------------oo----------------------oo----------------------------------
----------------------------------------------------------------------------------------------------------------------------------------------------------------
------XX-----------XXXX--------------------------XXXXXXXXX-------------------------XX------------------XXXXX----------XXX------XXXX-----------------------------
XXXXXX----------------------------------------------------------SSSSSSSSSSSSSS----------------------------------------------------------------------------------
----------------------------------------------------------------SSSSSSSSSSSSS-----------------------------------------------------------------------------------
----------------------------------------------------------------SSSSSSSSSSSS------------------------------------------------------------------------------------
--------------------------------ooo----------------------------?SSSSSSSSSSS-----------------------XXXXX-------------------XXXXX---------------------------------
-----------------------------XX--------------------------------------------------------E------------------------------------------------------------------------
--------------------------X--XX-------------------------------------------------------<>--------------------------------------------------E---------------------
------------X-----o----o--------------------------------------------------------<>----[]-----------------------------o---o------------------------<>----X-------
-----XXXXXXXXX----X----X-----------------XXXXXX---------------XXXXXXXXXXXXXXXE--[]---X[]X----XXXXX-------------------X---X------------------------[]----X------X
XXXXXXXXXXXXXXX----------------XXXXX--------------------------XXXXXXXXXXXXXXXXXXXX---------------------------XXXX---------------------XXXXXXXXXXXXXXXXXXXXXXXXXX