----------------------------------------------------------------------------------------------------------------------------------------------------------------
----------------------------------------------------------------------------------------------------------------------------------------------------------------
----------------------------------------------------------------------------------------------------------------------------------------------------------------
---------------------------------------------------------------o------------------------------------------------------------------------------------------------
--------------------------------------------------------------o-------------------------------------------------------------------------------------------------
----------------------------------------------------------------------------------------------------------------------------------------------------------------
---------------------------------------------------------XX---XX-----------------XXXXXXXXXXXXXXXXXXX----------E-------------------------------------------------
---------------------E--------------------XXX-------------------X------------------------------------------------------------------SSSSS------------------------
----------------------------------------------E-----------------------------------------------------------------XX----------------------------------------------
----------------------------------------------------E--------------------E-----------------------------------------------------E--------------------------------
-----------------------------------------------XXXXXXXX-------------------XXXX---XXXXXXXXXXXXXXXXXXX--------------------------<>--------------------------------
--B-------<>----<>----------------XXX--XXXX-XXXX-----------------XXX----------------------------------XXXXXXX-----------------[]----------<>-----------------X-X
--b-------[]----[]---------------XXXXE---------------------------------------------------------------------------------E------[]----------[]----------------XXXX
--B-------[]----[]--------------XXXXX-------------------------------------------------------------------------------------<>--[]----------[]---------------XXXXX
----------[]----[]-------------XXXXX--------------------------------------------------------------------------------------[]--[]----------[]-EE-----------XXXXXX
XXXXXXXXXXXX-XXXXXX-XXXXXXXXXXXXXXXX---------------------------------XXXX----------------------------------------XXXXXXXXXXXXXXXXXXXXXXXXXXXXXXXXXXXXXXXXXXXXXXX