----------------------------------------------------------------------------------------------------------------------------------------------------------------
----------------------------------------------------------------------------------------------------------------------------------------------------------------
----------------------------------------------------------------------------------------------------------------------------------------------------------------
-----------------------------------------------------------------------------------------------------------------------------XXXX-------------------------------
-----------------------------------------------------------------------------------XXX----------------------------------------[]--------------------------------
-----------------------------------------------------------------------------------XXX----------------------------------------[]--------------------------------
-----------------------------------------------------------------------------------XXX----------------------------------------<>--------------------------------
-------------------------------SSS--------------------oo--XX-----------------------XXX-XX-------------------------------------------E------------------X--EX----
-----------------------------------------------------XX----------------------------XXX-----------------------------------------E---<>------------------X---X----
---------------------------------------<>------------------------------------------XXX---------------------------------------------[]-----------X----X-X---X----
---------------------------------------[]-----------------------------------------oXXX----------------oo---------------------------[]-----------XSSSSX-XSS?X----
----------------------------------S----[]---------------XX-------------------<>----XXX----------------------------XXX--------------XXS--------------------------
--------------------------------<>---E-[]---------------------------E--------[]----XXX-------------<>----------------------E----<-------------------------------
-----------<>--------XXXXXXX----[]--<>-[]--------------------------<>--------[]----XXX-------------[]---------------------------[-------------------------------
-----------[]--------X----------[]--[]-[]---------E-----------X----[]--------[]----XXX-------------[]---------------------------[------XXXXXXXXXXXXXXXXXXXXXXXXX
XXXXXXXXXX-[]--------X-------XXXXXXXXXXXXXXXXXXXXXXXX-----XXXXX----XXXXXXXXXXXXXX--XXX-----XXXXXXXXXXXXXXXXXXXXXX---XXXXX-X-----[XXXXXXXXXXXXXXXXXXXXXXXXXXXXXXX