----------------------------------------------------------------------------------------------------------------------------------------------------------------
----------------------------------------------------------------------------------------------------------------------------------------------------------------
----------------------------------------------------------------------------------------------------------------------------------------------------------------
----------------------------------------------------------------------------------------------------------------------------------------------------------------
------------------------------SSSSSSSSSSSSSSSSSSSSSSSSSSSSSSSSSSSSSSSSSSSSSSSSSSSSSSSSSSSSSSSSSSSSSSSSSSSSSSSSSS------------------------------------------------
------------------------------SSSS-------------------------------------------------------SSSS--------------SSSSS------------------------------------------------
------------------------------SSSS-------------------------------------------------------SSSS--------------SSSSS------------------------------------------------
------------------------------SSSS-----------------oooo--------oooo--------oooo----------------------------SSSSS-------------------SSS-------------XXX----------
-----------------------------------------------------------------------------------------------------------SSSSS----------------------------------------------E-
-------------------------------------------------S-SSSS-S----S-SSSS-S----S-SSSS-S--------------------------SSSSS-----------------------------------o-o----------
----------------E------XX-------E----E-----------SoS--SoS----SoS--SoS----SoS--SoS---------E----------------SSSSS----------------------S------X-----o-o-XXXXX----
--------QQQQQQQQQQ-------------<>---<>-----------SSS--SSS----SSS--SSS----SSS--SSS-----E--SSSS-----------------SS--------SSSSS----QQQQ---------------------------
-------------------------------[]---[]-----------------------------------------------<>-EE-----XXX------------SS------------------------------------------------
--------E----------------------[]---[]-----------------------------------------------[]-----------------------SS------------------------------------------------
-------------------------------[]---[]---------------------------------------------E-[]------------------E------------------------------------------------------
XXXXXXXXXXX-X-<><>-----------XXXXXXXXX-------XXXXXXXXXXXXXXXXXXXXXXXXXXXXXXXXXXXXXXXXXXXXXXXX----------XXXXXXXXXXXXXXXX--XXXXXXXXXXXXXXX------------------------