----------------------------------------------------------------------------------------------------------------------------------------------------------------
----------------------------------------------------------------------------------------------------------------------------------------------------------------
----------------------------------o-----------------------------------------------------------------------------------------------------?-----------------------
--------------------------------ooo-----------------------------------------------------------------------------------------------------------------------------
--------------------------------o-ooooo----------------------------------------------------------------------------------------oooo-------------------XXXX------
-----------------------------------oooo---------------------------------------------------------------SS--------SSSSSS--------XXXXXX----XX----------------------
--------------------------------XX------------------------------------------------------------------------------------------------------------------------------
----?--------------------------------------------E-----------------XX-----------------------------------------------------------------------------------------oo
----------------------E---------------------XXXXXXXX--------------XXX-------------------------------------------------------------------------XXXXXX----------oo
--------------------------oo-----------XXXX----------------------XXXX----------E----------------------SS------QQQQ--SS------------------------------------------
------------------XXXXXXXXEXX----------X---------------<>-------XXXXX-------------------------------------------------------------------------------------------
----Q----------------------------------X---------------[]------XXXXXX--------------------------------------------------------------------------------o----o-XXXX
---------------------------------------X---------------[]-----XXXXXXX----------------E---------------------------------------------------------------X----X-X---
---------------------------------------X------------XXXXXXXXXXXXXXXX--XXXXXXXXXXXXXXXXXXXXXXXXXXXXXXXXXXXXXXXXXXXXXXXXXXXXXXXXXXXXXXX-----------------------X---
----------------------------------------------------------------------------------------------------------------------------------------------------------------
XXXXXXXX--------------------------------------------------------------------------------------------------------------------------------------------------------