----------------------------------------------------------------------------------------------------------------------------------------------------------------
----------------------------------------------------------------------------------------------------------------------------------------------------------------
----------------------------------------------------------------------------------------------------------------------------------------------------------------
-------------------------------SSSSSSSSSS-----------------------------------------------------------------------------------------------------------------------
---------------------------------------[]--------------------------------SSSSSSSSSSSSSSSSSSSSSSSSSSSSSSSSSSSSSSSSSSSSSSSSSSSSSSSSSSSSSSSSSSSSSSSSSSSSSSSSSSSSSSS
---------------------------------------[]-----------------------------------------------------------------------------------------------------------------------
---------------------------------------[]---?QQQQQQ-----------------------?-------------------------------------------------------------------------------------
---------------------------------------[]-------------E-----------XXoo---S??---E----------------------------------------------E--------------oooo---------------
---------------------------------------[]------------------oo-----------------<>---------------------------------------------<>---------------------------------
---------------------------------------[]------------------SS-----------------[]---------------------------------------------[]------------S-SSSS-S------------S
---------------------------------------[]---S---------------------------------[]-----E---------------------XXX---------------[]------S-----SoS--SoS------------S
------<>-------------------------------<>-----------------------------XX-SSSSS[]SS--<>----------QQQ-----?---------------E--SS[]SS--E----E--SSS--SSS------------S
------[]----------------------------------------------------------------------[]----[]-<>---------------E-------<>-----<>----[]---<>---<>-----------------------
-<>---[]-------------------------------------EE----------------<>-------------[]----[]-[]-----------------------[]-----[]----[]---[]---[]-----------------------
-[]---[]--XXXXXXXXXXXXXXXXXXXXXXXXXXXXXXXXXXXXXX---------------[]-------------[]----[]-[]-----------------------[]-----[]-E--[]---[]---[]-----------------------
XXXXXXXXXXXXXXXXXXXXXXXXXXXXXXXXXXXXXXXXXXXXXXXX------X-----XXXXX--------XXXXXXXXXXXXX-XX---XXXXXXXXXXXX--------XX--XXXXXXXXXXXXXXXXXXXXXXXXXXXXXXXXXXXXX--XXXXX