----------------------------------------------------------------------------------------------------------------------------------------------------------------
----------------------------------------------------------------------------------------------------------------------------------------------------------------
----------------------------------------------------------------------------------------------------------------------------------------------------------------
----------------------------------------------------------------------------------------------------------------------------------------------------------------
----------SSS?SSSSSSSSSS----------------------------------------------------------------------------------------------------------------------------------------
--------SS------------------------------------------------------------------------------------------------------------------------------------------------------
-----SSS--------------------------------------------------------------------------------------------------------------------------------------------------------
---------------------------------------------------------------------------------------XX----------------XXX-----SSS------------------------QQQQX---------------
---------------------------------------------------------------------------------------------------------XXX------------------------------------X---------------
----S--------------------------------------------------------------------------E-------------------------XXX------------------------------------X---------------
----------XXXX---------------------------------XX-----------------------------<>-------------------------XXX------------------------<>----------X---------------
-<>------XXXXX----<>-----------------------------------------------------SS---[]-------------------------XXXS-----------------------[]-<>--E?QQQX-----------<>--
-[]-----XXXXXX----[]---------------XXXXXXXXXX---------------------------------[]-------------------------XXX---E--------------------[]-[]-------------------[]--
-[]----XXXXXXX----[]------------------------X-------B-------------------------[]--------------------------XX--<>--------------------[]-[]-------E-----------[]--
-[]---XXXXXXXX----[]----------XXXX----------X-----------E---------------------[]--------------------------XX--[]-----E--------------[]-[]----------E--------[]--
XXXXXXXXXXXXXX--XXXX----X-XXX---------------X----XXXXXXXXXXXXXXXXXXXXXXXXXXXXXXXXXXXXXXXX--------XXXXXXXXXXXXXXXXXXXXXXXXXXXXXXX----XXXXXXXXXXXXXXXXXXXXXXXXXX-X