----------------------------------------------------------------------------------------------------------------------------------------------------------------
----------------------------------------------------------------------------------------------------------------------------------------------------------------
----------------------------------------------------------------------------------------------------------------------------------------------------------------
----------------------------------------------------------------------------------------------------------------------------------------------------------------
-------------------------------------------------------X--------------------------------------------------------------------------------------------------------
----------------------------------------------------------------------------------------------------------------------------------------------------------------
--------------------------------------------------------------------------------------------------------------------E--------------------E----------------------
---------------XX---------------------------------E-------------------------------------------SSSSSSSSSSSSSSSS-----<>-------------------SQSSS-----------SSSS----
------------------------XX---o-------------------<>----------------------------------------------------------------[]-------------------------------------------
-------------------------------------------------[]----------------------------------------------------------------[]-------------------------------------------
-------------------------o-----------------------[]--------------------------------<------------------SSSSS--------[]-----------------------------E-------------
------------------XXXX---o-----------------------XXS---------------------------<>--[>-----<>--------SS-------------[]-------------------SQSSS----<>----X---ES---
-------------------------------------------------------X------------------B----[]--[]-----[]------<>---------------[]--------------<>------------------X--<>----
-------------<------------------------------------------------------------b----[]--[]-----[]------[]---------------[]--------------[]------------------X--[]----
-------------[--------------XXXXXXXXEXXXXXXE------------------------------BEE--[]--[]-----[]------[]----E---EE-----XXXX------------[]-E----------------X--[]----
XXXXXXXXXX---X-------------------------------XXXXXXXX-----XXXXXXXXXXXXXXXXXXXXXXX--XX-XXXXXXXXXXXXXXXXXXXXXXXXXXXX-XXXXXXXXXXXXXXXXXXXXXXXX-XXXXXXXXXXXXXXXXXXXX