----------------------------------------------------------------------------------------------------------------------------------------------------------------
----------------------------------------------------------------------------------------------------------------------------------------------------------------
----------------------------------------------------------------------------------------------------------------------------------------------------------------
----------------------------------------------------------------------------------------------------------------------------------------------------------------
------------------------------------------------------E---------------------------------------------------------------------------------------------------------
----------------------------------------------------------------------------------------------------------------------------------------------------------------
-----------------------------------------------------------------XX---------------------------------------------------------------------------------------------
---------------------E---------------------------------XX----------------------------------XXXoooo-----------E--------------------------------------------------
---------------------------E--------------------------------------------------------------------------------<>--------------------------------------------------
---------------XXXX-----------------------------------------------------------------------------------------[]--------------------------------------------------
------------------------------XXXXXX-----Q-----------------------XXXX------------SS--XXX--------------------XXX-------------------------------------------------
-----------------------XXX---------------------XXX---------------------------------------------------------------------------------<>----------------------XXX--
----------------------------------------------XXXX--B--------------------------------------------XX--------------------------------[]---------------------------
---------------------------------------------XXXXX--b----------------------------------------------------------<>------------------[]---------------------------
--------------------ooo------------------XXXXXXXXX----X--------------------------------------------------------[]--------X-------E-[]-----------------X---------
XXXXXXXXXXXXX-------XXX------------------XXXXXXXXXXXXXX-----------------XXXXXXXXXXX-------------------XXXXXXXXXXXXXXXXXXXX--XXXXXXXXXXXXXXXXXXXXXXXXXXX-------XX