----------------------------------------------------------------------------------------------------------------------------------------------------------------
----------------------------------------------------------------------------------------------------------------------------------------------------------------
----------------------------------------------------------------------------------------------------------------------------------------------------------------
----------------------SS------------------------------------------------------------------------------------------------------------X---------------------------
----------------------[]----------------------------------------------------------------------------------------------------------------------------------------
----------------------[]----------------------------------------------------------------------------XXX---------------------------------------------------------
--------------E-------<>-----------------------------------E-----------------------?--XXX-----------XX----------------------------------------------------------
--------S---------------------------------------------SSSSSSSSS-------------------------------------XX---------------XX-------XX--------------------------------
-----------------------E-------------------------E--------------------------------------------------XX----------------------------------------------------E-----
------------------------------------------------<>--------------------------------------------------XX---------E---------------------------------oooooo---------
---------S-----------<>-------------------------[]---------E-----------------XXXXXEX----------------XX---o----<>--E-------------XX--------XEXXX-----------------
----E----------------[]----------------------XX-XX---------QQ?QQ?QQ---------------------------------XX--------[]-<>-------<>------------------------------------
----E----------------[]----------------------XX--------E-------------E------------------------------XX--------[]----------[]--------------------------------XXXX
---------------------[]-------------------X--------B--<>-----------------------------o---o----X-----XX--------[]----------[]-------o----------------------------
-------E-------XXEEXXXXXXXXXXX-XXXXXXXXXXXX-----------[]-----------------------------X---X----XX----XX--------[]----------[]-------XXXXXXX------<>-----XX-------
XXXXXXXXXXX----XXXXXXXXXXXXXXXXXXXXXXXXXXXX----XXXXXXXXXXXXXXXXXXXXXXXX--X--------------------XXXXXXXXXXXXXXXXXXXXXXXX--XXXXX-----------------X-[]------X-------