----------------------------------------------------------------------------------------------------------------------------------------------------------------
----------------------------------------------------------------------------------------------------------------------------------------------------------------
----------------------------------------------------------------------------------------------------------------------------------------------------------------
-----------------------------------------------------------------------------------------------------------------SSSSSSSSSSSSSSSSSSSSSSSSSSSSSSSSSSSSSSSSSSSSSSS
------------------------------------------------------------------------------------------------------------------------------------------------------SSSSSSSSSS
------------------------------------------------------------------------------------------------------------------------------------------------------SSSSSSSSSS
-------E----------SSSS--------------------------------------------------------------------------------------------------------------------------------SSSSSSSSSS
-----SSSS----------------------------------------------------XX------------------S---------------------------XX----SSSSSSSSSS-----------------------------------
------------------------------------------------------------EXX----------------------------------------------------SSSSSSSSSS--SSSSSSSSSS-----------------------
------------------------------------o----o-----------------EXXX----------------------------------------------------SSSSSSSSSS--SSSSSSSSSS-----------------------
---------S-----------X---------------E----E---------------XXXXX-----------------E-EE----------?--------XX---------?SSSSSSSSSS--SSSSSSSSSS?SS?SS???????SS?----SSS
------------SSSSSSSSSX------------SSSSS-SSSS-------------XXXXXX---------------------XX---XX------------XXX----------------------------------SSSSSSSSSS----------
------E-------------------------------------------------XXXXXXX---------------------XX---------------------------------------<>-------------SSSSSSSSSS----<>----
--------------------------------------E----E-----------XXXXXXXX-------<>------------XX---------------------------------------[]---------------------------[]----
------------------------------------------------------XXXXXXXXX-------[]------------X----------------------------XXXXXXXXXXXXXXXXXXXXXXXXXXXXX-XXXXXXXXXXXXXXXXX
XXXXXXXXXXX--XXXXXXXXX--XXXXXXXXX-XXXXXXXXXXXXXXXXXXXXXXXXXXXXXXXXXX-XXX------------X---------XXXXX--------------XXXXXXXXXXXXXXXXXXXXXXXXXXXXX-XXXXXXXXXXXXXXXXX