----------------------------------------------------------------------------------------------------------------------------------------------------------------
----------------------------------------------------------------------------------------------------------------------------------------------------------------
----------------------------------------------------------------------------------------------------------------------------------------------------------------
----------------------------------------------------------------------------------------------------------------------------------------------------------------
---------------------------------------------------------------------------------------------------------------?------------------------------------------------
----------------------------------------------------------------------------------------------------------------------------------------------------------------
----------------------------------------------------------------------------------------------------------------------------E--E--------------------------------
------------------------------------------------------------------------------------------XQQ?QQQ-----------------------SSSSSSSSSSS---?--S----------------------
-----------------------------------XXXXXX-------------------------------------------------X------------------------------------------------------------XX-------
-------------------------------------------oooo-------------------------------------------X---------------------------------------------------------------------
----------------------------------------------------------ooo-----------------------------XE-E---------------SS----------------E-------------------XX-----------
-----------------------------------------------------------------------------<>-----------XQQ-QQQ----------------------X-------QQ?QQ--Q--S----------------XXXXXX
-----------------------------------------------------------------------------[]----------------------------------------X---X------------------------------------
-------------------------------------------------X---------------------------[]----------------------------------------X---X------------------------------------
-----------------------E------------------<>---XXX---------------------------[]----------------------------------------X---X------------------------------------
XXXXXXXXXXXXX<>XXXXXXXXX--XX<>XXX---------[]----XXXXXXXXXXXXXXXXXXXXXXXXXXXXXXXXXXXXXXXXXXXXXXXXXXXXXXXXXXXXXXXXXXXXXXXXXXXXXXXXXXXXXXXXXXXXXX------------------