----------------------------------------------------------------------------------------------------------------------------------------------------------------
----------------------------------------------------------------------------------------------------------------------------------------------------------------
----------------------------------------------------------------------------------------------------------------------------------------------------------------
----------------------------------------------------------------------------------------------------------------------------------------------------------------
----------------------------------------------------------------------------------------------------------------------------------------------------------------
--------------------------E-------------------------------------------------------------------------------------------------------------------------------------
-----------------o-o-----<>-----------------------------E-----------------------------------------------------------------------------------------o-ooo---------
-------------------------[]---------------------------SSSS------------------------------------------------------------------------------XXXXXXXXX---------------
-------------------------[]------------------------------------------------oooo---------------------------------------------------------------------------------
-------------------------[]--------------------------------------------------------------------------------------------------------------------------XX---------
-------------------------[]-------------------------------S-------------------------SSSS-----------X------------------------------------------------------------
-----------------XXXXX---[]-----------------------<>---------SSSS---------------------------------SSS-------------------------<>--------------------------------
-------------------X-----[]-----------------------[]---E-----------------X--------------------------------------------------E-[]--------------------------------
-------------<>----------[]-----------------------[]---------------------X-------<>-------------------------------------------[]------------------------XXXXX---
---------X---[]----------XX-----------------------[]---------------------X-------[]-------------------------------------------[]-E--------------------------X---
XXX-XXXXXXXXXXX----------XX------------XXXXXXXXXXXXXXXXXXXXX--XXXXXXXXXXXXXXXXXXXXXXXXXXXXXXXXXXXXXXXXXXXXXXXXXX-X-------XXXXXXXXX---------XXXXX--XXXX------X---