----------------------------------------------------------------------------------------------------------------------------------------------------------------
----------------------------------------------------------------------------------------------------------------------------------------------------------------
----------------------------------------------------------------------------------------------------------------------------------------------------------------
----------------------------------------------------------------------------------------------------------------------------------------------------------------
----------------------------------------------------------------------------------------------------------------------------------------------------------------
---------------------------------------------------------<>-----------------------------------------------------------------------------------------------------
---------------------------------------------------------[]---------------------------------ooo--------------------------------E-----------------E--------------
----------------------------------------------SSSS-------XX------E--------------------------XXX----SSSSSSSSSSSSSSSS-----------SQSSSSSSSSS-SSSSSSSSSSSSSS--------
----------------------------------------------------------------------------------------------------------------------------------------------------------------
---------------------B--------------------X-------------------------E-----------------------------------------------------------------------------------------B-
------------<>-------b-------------------XX-------------------------------------------------------------------------------------------------------------------b-
-----------X[]----SSSXSSSSSSSSSS--------XXX-----XXXX--X--------------------------------------------------<>------SS-----------SQS---------------------------SSXS
----------XX[]------------------------XXXXX----XXXXX--X--------------XXXXXXXXXXXXXXXXXXXXX-?-------------[]----------------------------------------------E------
---------XXX[]-------------------B----XXXXX---XXXXXX--X------XXX-----------------------------------------[]-----------------------------------------------------
--------XXXXXX------------------------XXXXX--XXXXXXX--X--------------------------------------------------[]-----------------E-----------------X-----------------
XXXXXXXXXXXXXXXXX-XXXXXXXXXXXXXXXXXXXXXXXXXXXXXXXXXX--X------------------------------------XXXX-XXX------XX------XXXXXXXXXXXXXXXXXXXXXXX-------XXXXXXXXXXXXXXXXX