----------------------------------------------------------------------------------------------------------------------------------------------------------------
----------------------------------------------------------------------------------------------------------------------------------------------------------------
----------------------------------------------------------------------------------------------------------------------------------------------------------------
----------------------------------------------------------------------------------------------------------------------------------------------------------------
----------------------------------------------------------------------------------------------------------------------------------------------------------------
---------------------------------------------------------------------E------------------------------------------------------------------------------------------
--------------------------------------------------SSS-----------------------------------------------------------------------------------------XXXXXX------------
--------------------------------------------------------------------------E-------------------------------------------------------------------------------------
------------------------------------------------------XXXXXXXX---------------XXXXoo-----------------------------------------------------------------------------
-----------------------------------------------------XXXXXXXX---------------------------------------------------------------------------------------------------
-------------------------------oooo-----------------XXXX---------------------------------------------------------------------------------XXX--------------------
---------------------------<>-------------XXXX-----XXXXX--------XX--------------------------XX------------------------------------------------------------------
---------------------------[]---------------------XXXXXX-----------------------------------XXX---<>--------------------------------------------------------XXXX-
---------------------------[]--------------------XXXXXX----<>-----------------------------XXXX---[]-------------------------------------------------------------
---X---------------X-------[]--------------------XXXXXX----[]----------------------------XXXXX---[]E-----------------XXXXXXXXXXXXXXXXXXXX-----------------------
XXXX--XXXXXXXXX----XXXXXXXXXXXXXXXXXX------------XXXXXX----[]---------X--------------XXXXXXXXX--XXXXXXXXXXXXXXXXXXXX--------------------------------------------