----------------------------------------------------------------------------------------------------------------------------------------------------------------
----------------------------------------------------------------------------------------------------------------------------------------------------------------
----------------------------------------------------------------------------------------------------------------------------------------------------------------
----------------------------------------------------------------------------------------------------------------------------------------------------------------
---------------------------------------------------S-----------------SS???SSSSSS--[]SSSSSSS---------------------------------------------------SSSSSSSSSSSSS-----
-------------------------------------------------------------------SS-------------[]SSSSSSS---------------------------------------------------------------------
----------------------------------------------------------------SSS---------------[]SSSSSSS---------------------------------------------------------------------
---XQQ?QQQ----oo--------------------------SSSSSSSSSS------------------------------[]SSSSSSS-------------------------QQQQS-----------SSS-------------------------
---X---------XX-------------------------------------------------------------------[]SSSSSSS---------------------------------------------------------------------
---X-----------------------------------------------------------S------------------[]SSSSSSS-----------------------------------------------------------E---------
---XE-E--------------------------------------------------------------XXXX----------]SSSSSSS-Q----------------------------------X---------------------<>---------
---XQQ-QQQ------XX--XXXXXX----------------------------------<>------XXXXX----------]SSSSSSS-------------X----------Q?SSQS-----XX---------------------[]---------
------------------------------------------------------E-----[]-----XXXXXX----SSSSSSSSSSSSSS------------XXX-------------------XXX---------------------[]---XXX<>-
------------------------------------------------------------[]----XXXXXXX----SSSSSSSSSSSSSS-----------XXXX------------------XXXX---------------------[]---XXX[]-
------------------------------------------------------------[]---XXXXXXXX----SSSSSSSSSSSSSS-XXXXXXXXXXXXX------------------XXXXX---------------------[]---XXX[]-
XXXXXXXXXXXXX---------------XXXXXXXXXXXXXX--------XXXXXXXXXXXXXXXXXXXXXXXX---XXXXXXXXXXXXXX-XXXXXXXXXXXXX-------XXXXX--XXXXXXXXXXXXX---XXXXXXXXXXXXX-XX---XX-XXX