----------------------------------------------------------------------------------------------------------------------------------------------------------------
----------------------------------------------------------------------------------------------------------------------------------------------------------------
----------------------------------------------------------------------------------------------------------------------------------------------------------------
----------------------------------------------------------------------------------------------------------------------------------------------------------------
----------------------------------------------------------------------------------------------------------------------------------------------------------------
----------------------------------------------E-----------------------------------------------------------------------------------------------------------------
-----------------------------------------SSSSSSSSSSSS--SS-------------------------------------------------------------------------------------------------------
--------<>-----------------------------------------------------------------------------------SSS--XX-------------------------------XX------------------XX---E---
--------[]-------------------------------------------------------------------XXX------------------XX-------------------------------XX------------------XX-------
--------[]------oo------------------------------E-------------XX----------------------------------XX-------------------------------XX------------------XX-------
-------S[]------oo--------------------------SSSSS?SSS--------XXX----------------------------------XX----------------------------X--XX------------------XX-------
--------[]--------------------------------<>----------------XXXX---------------------------S?SSS--XXS--------------------------EX--XX-------E----------XX-------
--------[]--------------------------------[]---------------XXXXX------XXXXXXXX--------------------XX--------------------------XXX--XX------<>----------XX-------
--------[]--------------------------------[]--------------XXXXXX----------------------------------XX-------------------------XXXX---X------------------XX-------
XXXXXXXXXXXXXXXXXXXXXXXXXXXXXXXXXXXXXXXXXXXXXXXXXXXXXXXXXXXXXXXX----------------------------------XX--------EEXXXXXXXXXXXXEXXXXXX---X------------------XX-------
XXXXXXXXXXXXXXXXXXXXXXXXXXXXXXXXXXXXXXXXXXXXXXXXXXXXXXXXXXXXXXX--XXX----------------XXXXXXXXXX-X-XXXXXX--XXXXXXXXXXXXXXXXXXXXXXXXXXXXXXXXXXXXXXXXXXXXXXXXXXXX---