----------------------------------------------------------------------------------------------------------------------------------------------------------------
----------------------------------------------------------------------------------------------------------------------------------------------------------------
----------------------------------------------------------------------------------------------------------------------------------------------------------------
----------------------------------------------------------------------------------------------------------------------------------------------------------------
----------------------------------------------------------------------------------------------------------------------------------------------------------------
------------------------------------------------------------------------------------------------------------------------------------------E--------------?------
---------------------------------------E---E-----------XX------------E------------------------------------------------------------------------------------------
--------------------------------------SQSSSSS---S------[]-----------SQSSS---SS-----------------------------X-----------------------------------XXXXX------------
-------------------------------------------------------[]-------------------------------------------------XX--------------------------XXX------------------E----
-------------------------------------------------------[]------------------------------------------------XXX-------------------------------------------XXXXXX---
-------------------------------------------------------[]-----------------------------------------------XXXX--------------<>------------------------------------
---<>------------------S?S------------SQSSSS--X?-------<>-----------SQSSS---SS------SSSSS--------------XXXXX---B---------X[]---------------XX------XXXX-----oooo
---[]-------------->-------------------------XX---E---------------------------------------------------XXXXXX---b--------XX[]------------------------------------
---[]---------<>---]------------------------XXX---------E--------------------------------------------XXXXXXX---B-------XXX[]--------------------------XXXXXXXXXX
---[]-----X-X-[]---]----------------E------XXXX--------XXXXEE-----E------------------------XXXXXXXXXXXXXXXXXXXXXXXXXXXXXXXXX------------------------------------
XXXXXXXXXXX-XXXXXXXXXXXXXXXXXXXXXXXXXXXXXXXXXXXXXXXXXXXXXXXXXXXXXXXXXXX-X-XXXXXXXXXXXXXXXXXXXXXXXXXXXXXXXXXXXXXXXXXXXXXXXXXXXXXXXXXX---------XXXXXXX------------