----------------------------------------------------------------------------------------------------------------------------------------------------------------
----------------------------------------------------------------------------------------------------------------------------------------------------------------
----------------------------------------------------------------------------------------------------------------------------------------------------------------
----------------------------------------------------------------------------------------------------------------------------------------------------------------
----------------------------------------------------------------------------------------------------------------------------------------------------------------
----------------------------------------------------------------------------------------------------------------------------------------------------------------
-----------------------------------------------------SS---------------------------------------XX----------------------------------------------------------------
------------------XXXX-----------SSS----------------------------------------------------------------------------------------------------------------------------
----------------------------------------------------------------XX----------------------------------------------------------------------------------------------
--------------oo------------------------------------o-----------------------------------------------------------------------------------------------------------
----------------------------------E-----------------XXXX---------------------------E----------X------?--ooo----ooooo------------------------------?QQ?QQQQ?QQQQQ
----------XXX-------------------SSSS------------<>--------XXXX-------------------XXX-XXXX---------------------XXXXXXX-------------------------------------------
---------XXXX-----------------------------------[]-----------------------------------------------<>------------------------------------------------------------E
--------XXXXX-----------------------------------[]-----------------------------------------------[]-------------------------------------------------------------
-------XXXXXX-----------------------------------[]-----------------------------------------------[]---------------------EEXXXXXXXXXXXXXXXXXXXXXXXXXXXEEXXXEEXXXX
XXXXXXXXXXXX---XXXXXXXXXXXXXXXXXXXXXXXXXXXXXXXXXXXX------------------XXXXXXXXX-------------------[]XXXX<XXXXX-------XXXXXXXXXXXXXXXXXXXXXXXXXXXXXXXXXXXXXXXXXXXX