----------------------------------------------------------------------------------------------------------------------------------------------------------------
----------------------------------------------------------------------------------------------------------------------------------------------------------------
----------------------------------------------------------------------------xxxxxxxxxxxxxxxxxxxxxxxxxxxxxxxxxxxxxxxxxxxxxxxxxxxxxxxxxxxxxxxxxxxxxxxxxxxxxxx-----
-----------------------------------------------------------------xxxxxxxxxxxSSSSSSSSSSSSSSSSSSSSSSSSSSSSSSSSSSSSSSSSSSSSSSSSSSSSSSSSSSSSSSSSSSSSSSSSSSSSSSSxxxxx
-----------------------------------------------------------------SSSSSSSSSSS-------------------------------------------------------------------------------SSSSS
--------------------------------------------------------------xxxSSSSSSSSSSS------------------------------------------------------------------------------------
-----------------------------------------------------------xxxx--SSSSSSSSSSS------------------------------------------------------------------------------------
----------------------------------------------------------xxXXX--SSSSSSSSSSS------------------------------------------------------------------------------------
---------------------------------------------------------xx------S----S-----------------------------------------------------------------------------------------
-------------------------------------------------------xxx-------S----S-----------------------------------------------------------------------------------------
---xxxx-----------------------------------------------xxXX--------?ooo-?o----<>---<>---------<>---------<>---<>--------<>--------------------<>---<>------------
--xx---x------------E------QQQQQQQQQ?-------xx-------xx-X---------??SS-??----[]---[]---------[]---------[]---[]--------[]--------------------[]---[]----------XX
-xx-----x---xxx--------------------------xxxx-x-----xx-----------------------[]---[]--o-oo---[]--oooo---[]---[]--ooo---[]--ooooooooo--ooo----[]---[]--ooo-------
xxX------xxxxE-xxxxxxxxxxxxxxxxxxxxxxxxxxxXXX--xxxxxx----------------------X-[]---[]--oooo---[]--oooo---[]---[]--ooo---[]--ooooooooo--ooo----[]---[]--ooo-------
xXX-----XXXX<>XXXXXXXXXXXXXXXXXXXXXXXXXXXXXXX-XXXXXXX---------------------XX-[]---[]--XXXX---[]--XXXX---[]---[]--XXX---[]--XXXXXXXXX--XXX----[]---[]--XXX-------
XXX-----XXXX[]XXXXXXXXXXXXXXXXXXXXXXXXXXXXXX---------------------XXXXXXXXXXX-[]---[]--XXXX---[]--XXXX---[]---[]--XXX---[]--XXXXXXXXX--XXX----[]---[]--XXX-------