----------------------------------------------------------------------------------------------------------------------------------------------------------------
----------------------------------------------------------------------------------------------------------------------------------------------------------------
----------------------------------------------------------------------------------------------------------------------------------------------------------------
----------------------------------------------------------------------------------------------------------------------------------------------------------------
----------------------------------------------------------------------------------------------------------------------------------------------------------------
----------------------------------------------------------------------------------------------------------------------------------------------------------------
--------------------------------xxxxx---------------------------------------------------------------------------------------------------------------------------
XXXXXXXXSS-xxxxxxxx------------xxXXX------E--E---E---E--E--E--E----E--------E--E-------E---E----E---E--E--E--E---E--E--E--E--E--E---E--E--E--E-------E-----E----
----------xx--XXX-x-----------xxXXXX---E---------------------------------E----------E--------E----------------------------------------------------E-------------
---------xx---XXX-X----------xxXXXXX-xxxxxxxxxxxxxxxxxxxxxxxxxxxxxxxxxxxxxxxxxxxxxxxxxxxxxxxxxxxxxxxxxxxxxxxxxxxxxxxxxxxxxxxxxxxxxxxxxxxxxxxxxxxxxxxxxxxxxxx----
--------xx----XXXXX---------xxXXXXXX--SSSSSSSSSSSSSSSSSSSSSSSSSSSSSSSSSSSSSSSSSSSSSSSSSSSSSSSSSSSSSSSSSSSSSSSSSSSSSSSSSSSSSSSSSSSSSSSSSSSSSSSSSSSSSSSSSSSSS-x---
--------<>----XXXXX--------xxXXXXXXX-S-----------------------------------------------------------------------------------------------------------------------xE-
--------[]----XXXXX-------xxXXXXXXXX-----ooooooooooooooooooooooooooooooo---ooooooo----ooooo----ooooooooooooooooooooooooooooooooooooooooooooooooo----ooooo-----x-
--------[]----XXXXXxxx---xxXXXXXXXXX---------------------------------------------------------------------------------------------------------------------------x
xxxxxxxx[]----XXXXX--xxxxxXXXXXXXXXX-----ooooooooooooooooooooooooooooooo---ooooooo----ooooo----ooooooooooooooooooooooooooooooooooooooooooooooooo----ooooo-----XX
XXXXXXXXXX----X-XXX--XXXXXXXXXXXXXXXXXXXXXXXXXXXXXXXXXXXXXXXXXXXXXXXXXXXXXXXXXXXXXXXXXXXXXXXXXXXXXXXXXXXXXXXXXXXXXXXXXXXXXXXXXXXXXXXXXXXXXXXXXXXXXXXXXXXXXX-----