----------------------------------------------------------------------------------------------------------------------------------------------------------------
----------------------------------------------------------------------------------------------------------------------------------------------------------------
----------------------------------------------------------------------------------------------------------------------------------------------------------------
----------------------------------------------------------------------------------------------------------------------------------------------------------------
-SSSSSSSSSSSSSSS------------------------------------------------------------------------------------------------------------------------------------------------
----------------------------------------------------------------------------------------------------------------------------------------------------------------
------------------XXX-------------------------------------------------------------------------------------------------------------------------------------------
----------------------------------------------------------------------------------------------------------------------------------------------------------------
---------------------------------------------------------o----------------------x-------------------------------------------------------------------------------
---------------------------------------------------------------------------------x------------------------------------------------------------------------------
-------------xxxxx-------------------------------------------------------------o--xxx---------xxxxxx------------------------------------------------------------
-----xxxx---xxXXX-xxxx-----------------------------xxx-------------------xx-------<>-x-------xxXSSS-x---------------------------------------------xxxxxxxxxxxxxx
---Exx---x-xxXXXX-XXX-x-------xxx-----------------xxX-x--xxx------------xx-x------[]--x-----xx-X-----x-------------------------------------------xx--XXXXXXXXXXX
---xx-----xxXXXXX------x-----xxB-x---------------xx-X--xxx-------------xx---xxxx--[]---x---xx--X------x-------xxx--xxx--------------------------xx---X----------
xxxxX-----XXXXXXX-------xxxxxx-b--xxxxxxxxxxxxxxxx--X-XXXX--xxxxxxxxxxxx-----x----[]---Exxxx--EX-------xxxxxxxx--xxx--xxxxxxxxxxxxxxxxxxxxxxxxxxx----X----------
XXXXX-----XXXXXX--------XXXXXXXXXXXXXXXXXX<>XXXXXXXXX-X-----XXXXXXXXXXXX-----X--XXXXXXXXXXXXXXXXXXXX---XXXXXXXX--XXX--XXXXXXXXXXXXXXXXXXXXXXXXXXX----X----------