----------------------------------------------------------------------------------------------------------------------------------------------------------------
----------------------------------------------------------------------------------------------------------------------------------------------------------------
----------------------------------------------------------------------------------------------------------------------------------------------------------------
----------------------------------------------------------------------------------------------------------------------------------------------------------------
----------------------------------------------------------------------------------------------------------------------------------------------------------------
------------------------------------------------------------------------------------------------------x---------------------------------------------------------
-----------------------------------------------xxx----------x----------------------------------------xx---------x-----------------------------------------------
-------------xxxxx----------------------------xxX-x----------x--------------------------------------xxX---S------x-----------------------------xxxxx----------oo
------------xx-<>-x--------------------------xxXX--x------xx--x-------------------------------------xXX-----------x---------------------------xx----x-----------
-----------xx--[]--x------------------------xxXXX---x----xxX---x------------------------------------XXX------------x-------------------------xx------x-------xxx
---------xxx---[]---x------------oooo------xxXXXX----x--xxXX----x-----------------------------------XXX-------------x---------o-------------xx--------xxxxxxxx--
--------xx<>--QQQ?---x--------------------xxXXXXX-----xxxXXX--X--x-------------------Q-------------XXXX-QQQQ---------x---------------------xx--------XXXXXXXXX--
-------xx-[]----------x---xxxx-----------xxXXXXXX-------XXXX--X---x-------------------------------XXXXX--------x------x-------------------xxX-------------------
------xx--[]-----------x-xx<>-x---------xxXXXXXXX------XXXXX--XX---x----------x------------------XXXXXX-------xx-------x-----------------xxXX-------------------
xxxxxxxE--[]------E-----xx-[]--xxxxxxxxxxXXXXXXXXXXXXXXXXXXX--XX---Exxxxxxxxxx-xxxxxxxxxxxxxxxxXXXXXXXXxxxxxxxxX--------xxxxxxxxxxxxxxxxxxXXX-------------------
XXXXXXXXXXXXX-----X-----XXXXXXXXXXXXXXXXXXXXXXXXXXXXXXXXXXXXXXXXXXXXXXXXXXXXXXXXXXXXXXXXXXXXXXXXXXXXXXXXXXXXXXXXXXXXX--XXXXXXXXXXXXXXXXXXXXXX-------------------