----------------------------------------------------------------------------------------------------------------------------------------------------------------
----------------------------------------------------------------------------------------------------------------------------------------------------------------
----------------------------------------------------------------------------------------------------------------------------------------------------------------
-------------------------------------------------------------------------xxxxxxxxxxxxxxxxxxxxxx--------------xxxxxxxxxxxxxxxxxxxxxxxxxxxxxxxxxxxxxxxxxxxxxxxxxxx
-----------------------------------------------------------------------xxxSS????SSSSSSSSSSSSSS-x-----SSSS---xxSSSSSSSSSSSSSSSSSSSSSSSSSSSSSSSSSSSSSSSSSSSSSSSSSS
--------------------------------------------------------------------xxxxSS----------------------x----------xx---------------------------------------------------
-------------------------------------------------x------------------xSSS-------------------------x----?---xx----------------------------------------------------
---------XX--------------------------------------SSSSS--------------x-----------------------------x--S??-xx-----------------------------------------------------
-------------------------------------------------------------------xx------------------------------x----xxXXX---------------------------------------------------
--------------------------------------------xxxxx-xx--------------xxS-------------------------------x--xx---------------------------------------------E---------
------------------------------------------xxx----xS-x-----------xxx-------XXXXX----------------------xxx-----------XXX-------------------E-----------<>---------
--------------------Q--------------------xx<>----S---x---------xx<>------XXXXXX------------------XXX-SSSS-----------------------XXX-----<>--------E--[]---------
-----E----------------------------------xx-[]---------x-------xx-[]-----XXXXXXX--------------XXX------------------------<>--------------[]-------<>--[]---------
-----------------xxxx--------xxxxx-----xx--[]----------x---x-xx--[]----XXXXXXXX---XXXX---<>--XXX------------------------[]--------------[]-------[]--[]--------<
xxxxxxxxxxxxxxxxxxEE-xxxxxxxxx----xxxxxxE--[]-------E---xxxxxx---[]---XXXXXXXXX----------[]--XXX------------------------[]--------------[]-----E-[]--[]--------[
XXXXXXXXXXXXXXXXXXXXXXXXXXXXXX---XXXXXXXXXXXXXXXXXXXXXXXXXXXXXXXXXXXXXXXXXXXXXXX---------XX--XX------XXXX---------------XX----------XXXXXX--XXXXXXX--XX------XXX