----------------------------------------------------------------------------------------------------------------------------------------------------------------
----------------------------------------------------------------------------------------------------------------------------------------------------------------
----------------------------------------------------------------------------------------------------------------------------------------------------------------
----------------------------------------------------------------xxxx--------------------------------------------------------------------------------------------
----------------------------------------------------------------XXXX--------------------------------------------------------------------------------------------
----------------------------------------------------------------XXXXx--------------------------------------------------------------------------------xxx-----XXX
-------------------SSS-----------------------SS-----------------XXXX-xxxxx----------------------------------------------------xx---------------------x--x-------
--------SSS-----------------------------------------------------XXXX-XXX--x--------------------------------------------------xx-x----------------SSS-X---x------
----------------------------------------------------------------XXXX-XXX---x---------------------------oooo-----------------xx---x-------------------X----x-----
-------------------X-------------------------X------------------XXXX-XXX----x--------------------------------------------xxxx-----x------------------X-----x----
------xxxxxxx------XEE-----------------------XE-----X-----------XXXX-XXX-----x---------o-----------xxxx----------------xxx-<>------x-----------------X------x---
-----xxXXXXX-------XSSSS-------ESSSSSS-------XSSSSSSX----------xXXXX-XXX--X---x-------------------xx<>-x-------------xxx-?-[]-------xxx-----QQ-------X----------
----xx-X-----------------------------------------------------xxxXXXX-XXX--X----x-----------E-----xx-[]--x-----------xx<>---[]-------<>-x-------------X------->--
---xx--X-------------------------------B-----------------xx-xx<>XXXX-XXX--X-----xxx-------------xx--[]---x---------xx-[]---[]-------[]--x------------X-------]--
xxxxE--X-----xxxxxxxxxxxxxxxxxxxxxxxxxxxxxxxxxxxxxxxxxxxxx-xx-[]XXXX-XXX--X-----XX-xxxxxxxxxxxxxx---[]----xxxxxxxxxx--[]---[]-------[]---xxxxxxxxxxxxX-------]--
XXXXXXXXXX---XXXXXXXXXXXXXXXXXXXXXXXXXXXXXXXXXXXXXXXXXXXXX-XXXXXXXXX-XXXXXXXXX--XXXXXXXXXXXXXXXXXXXXXXXXXXXXXXXXXXXXXXXXXXXXXXXXXXXXXXXXXXXXXXXXXXXXXXXXXXXXXXXX