----------------------------------------------------------------------------------------------------------------------------------------------------------------
----------------------------------------------------------------------------------------------------------------------------------------------------------------
----------------------------------------------------------------------------------------------------------------------------------------------------------------
----------------------------------------------------------------------------------------------------------------------------------------------------------------
-------------------------------------------xxx------------------------------------------------------------------------------------------------------------------
----------------------------xxxx---------xx---x-----------------------------------------------------------------------------------------------------------------
----------------------------XXX-x-------xx-----x-------------------------------------------xx------------------------------------------------------------E------
---------------------------xEXX--------xx-------x-----------------------------------------xxXx------X------------------xxx-------------------------------S------
-------------------------xxxXXX--xxxxxxx---------x---------------------------------------xxXX-x-----X-----------------xx-------------------xxxx-----------------
-------------------------xXXXXX--Ex--<x-----------x-------------------------------------xxXXX--xxxx-X----------------xx-------------------xx---x---------?------
----------E--------------xXXXXX-<>---[>------------x-----------------------------------xxXXXX---xXx-X-------------xxxx-----oo------------xx-----x---------------
---------<>-------------xxXXXXX-[]---[]-------------x--------Q------QS----------------xx-XXXX---XX--X---------QQ-xx<x---------x--------xxx-------xxx----xxx-----
-----------------------xxXXXXXX-[]---[]--------------x--x----------------------------xxXXXXXX--XXX-xX-----------xx-[>--------xx-------xx<>-------<>----xxX-xxx-x
---xxx--------xxx-----xx-XXXXXX-[]---[]---X-------X---xxxxx---------E---------------xxXXXXXXX-XXXX--x-xxx------xx--[]-------xx-------xx-[]-------[]----x-X--X-xx
xxxx-Exxxxxxxxx--xxxxxx--XXXXXXXXXXXXXXXX-XXXXXXXXXXXXXXX--xxxxxxxxxxxxxxxxxxxxxxxxxx----XXXXXXXXX---xx--xxxxxxx---[]E----xxx--xxxxxxx--[]-E-----[]-xxx--X--XXXX
XXXX--XXXXXXXXX--XXXXXXXXXXXXXXXXXXXXXXXX-XXXXXXXXXXXXXXX-XXXXXXXXXXXXXXXXXXXXXXXXXXXXXXXXXXXXXXXXXXXXX--XXXXXXXXXXXXXXXXXXXXXXXXXXXXXXXXXXXXXXXXXXXXXXXXXX-XXXX