----------------------------------------------------------------------------------------------------------------------------------------------------------------
----------------------------------------------------------------------------------------------------------------------------------------------------------------
----------------------------------------------------------------------------------------------------------------------------------------------------------------
----------------------------------------------------------------------------------------------------------------------------------------------------------------
------------------------------------------------------------------------------------------------SSSSSSSSSSSSSSSSSSSSSSSSSSSSSSSSSSSSSSSSSSSSSSSSSSSSSSSS--------
---------------------------------------------------------xxx----------------------------------------------------------------------------------------------------
-----------------------------------------------E--------xx--x-XX------------------------------------------------------------------------------------------XXX---
-----------------------------------xxx-----------------xx----x----------xxxx------------?Q-----------------------------------oooo-oooo--------------------------
----------------------------------xx------------------xx------x--------xx---x-------------------------------------o---------------------------------------------
---------------------------------xx-------------xxx--xx--------x------xx-----x----xx--------------------------xxxxx--------S-SSSS-SSSS-S------------------------
-------------------xxx-------xxxxx----------xxxxx--xxXX---------x---xxx-------x--xx-x--QQ-----------------xxxxx--S-x-------SoS--SoS--SoS-------------xxxxx------
------------------xx--x-----xx--XX---------xxXXXX--XX------------x-xxXX--------xxx---x------------------xxxXXXX-----xx-----SSS--SSS--SSS-----xxxx---xxXXX-xxxx--
-------------xxx-xx----x---xx---XXX---x---xx-------XX-------------xx------------x-----x---------------xxxXXXXXXXX--XX-xx-------------------Exx---x-xxEXXX-XXX-x-
------------xx--xx--------xx----XXXX---xxxx----------------------XXXX-----------X------xxxxxxx------xxxXXXXXXXXXX--XXXX-x------------------xx-----xxXXXXX------x
xxxxxxxxxxxxxX--XX------xxx-----XXXX---XXXX-------------------------------------X-----XXXXXXX-xxxxxxxXXXXXXXXXXXXE-XXXX--xxxxxxxxxxxxxxxxxxxX-----XXXXXXX-------
XXXXXXXXXXXXXX--X------XXXX-----XXXX--------------------------------------------X-----X------XXXXXXXXXXXXXXXXXXXXXXXXXXXXXXXXXXXXXXXXXXXXXXXX-----XXXXXX--------