----------------------------------------------------------------------------------------------------------------------------------------------------------------
----------------------------------------------------------------------------------------------------------------------------------------------------------------
----------------------------------------------------------------------------------------------------------------------------------------------------------------
----------------------------------------------------------------------------------------------------------------------------------------------------------------
-----------------------------------------------------------------------------------------------------------------------------S---------------------------------x
--------------------------------------------------------------------------------------------------------------------------------------------------------------xx
-------------------------------------------E---------------------------------------------------------------------------------------------------------------xxxx-
----------------------------SSS----------SSSS------------------------------S---?SS--------------------------------------SSSSSS-----------?----------------xxXXX-
---------------------------------------------------------------------------------------------------------------------------------------------------------xx-----
--------------------------------------------------------------------------------------------oo---------------------------------------------------------xxx------
---------------X-----------------------------------------------------------------------xxxxx-------------------oooooo---------------------------------xXXX------
--------ESSSSSSX--------S----------------SSSS--------------Q---------QQ----S----------xxXXX-x-----------------o--------xxxx-----------------xxx------xx---------
--------------------------------------------------------------------------------B----xxXXXX--x------------------------xx---x---------------xxX-x----xx----------
xxxx----------------------------------xx------xxx-------------------------------b---xxXXXXX---x---------xxx----------xx-----x-------------xx-X--xxxxx-----------
x---xxxxxxxxxxxxxxxxxxxxxxxxxxxxxxxxxxxExxxxxxxE-xxxxxxxxxxxxxxxxxxxxxxxxxxxxxxxxxxxxXXXXXX----xxxxxxxxxxXXxxxxxxxxxxx-------xxxxxxxxxxxxxx--X-XXXXXX-----------
X---XXXXXXXXXXXXXXXXXXXXXXXXXXXXXXXXXXXXXXXXXXXXXXXXXXXXXXXXXXXXXXXXXXXXXXXXXXXXXXXXXXXXXX---XXXXXXXXXXXXXXXXXXXXXXXXX------XXXXXXXXXXXXXXXXXX-XXXXXX-----------