----------------------------------------------------------------------------------------------------------------------------------------------------------------
----------------------------------------------------------------------------------------------------------------------------------------------------------------
----------------------------------------------------------------------------------------------------------------------------------------------------------------
----------------------------------------------------------------------------------------------------------------------------------------------------------------
----------------------------------------------------------------------------------------------------------------------------------------------------------------
-----------------------------------------------------------------------------XXXXX--------xx--------------------------------------------------------------------
------------------------------------------------------------------------------------E--xxxx-xxxxxxxxx-----------------------------------------------------------
-----------------------------------?-----------------------E---XX----xxxx---------SSSSxx-XX--QQQ?QQQ-x------SSSSS--------------------?Q-------------------------
--------------------------------------------------------------------xx---x-----------xx--XX-----------x---------------------------------------------------------
-----------------------------------------------------------xx-xxx--xx-----x---------xx--XXX----E-------x-----------------------xx----------------E---------xx---
-------------------SS?-------S----------------------------xx-xx--xxx-------x------xxx---XXX--SSSSSSS----x---------------------xx-x--QQ--------------------xx-x--
-------ESSQ------------------------------------------xxx-xx--XX-XXXX--------x-----SSS--XXXX-----------E--x----SSS------------xx---x--------xxxxxxxxxx----xx---x-
-----------------------xxxx----------xxxx-----------xx--xx------------------->---<----XXXXX----X------X---x----------xxx----xx-----x------xxXXXXXXXX-x--xx-----x
----------------------xx<>-x--------xx<>-x---------xx--XXX-----------------X-]---[---XXXXXX----X------X----x------xxxx--xxxxx-------xxxxxxx--------X--xxx-----XX
xxxxxxxxxxxxxxxxxxxxxxx-[]--xxxxxxxxx-[]--xxxxxxxxxx-----------------------X-]---[--XXXXXXX-E--X------X-----xxxxxxxXXX--XXXXXX-----XXXXXXXX--------X-XXXXX------
XXXXXXXXXXXXXXXXXXXXXXXXXXXXXXXXXXXXXXXXXXXXXXXXXXXXXX---------------------XXXXXXXXXXXXXXXXXXXXXXXXXXXXXXXXXXXXXXXXXXX-------------X---------------X-X----------