----------------------------------------------------------------------------------------------------------------------------------------------------------------
----------------------------------------------------------------------------------------------------------------------------------------------------------------
----------------------------------------------------------------------------------------------------------------------------------------------------------------
----------------------------------------------------------------------------------------------------------------------------------------------------------------
----------------------------------------------------------------------------------------------------------------------------------------------------------------
----------------------------------------------------------------------------------------------------------------------------------------------------------------
----------------------------------------------------------------------------------------------------------------------------------------------------------------
----------Q-------------------X---------------------------------------------------------------------------------------------------------------------------------
------------------------------X--------------oooo------------------------------------------------E--------------------------------------------------------------
--------------------------xxx-X---------------------------------------------xx---------------XXXXXXX----------------------------------------xxxx--xxx----xxxxx--
-------------------------xxXx-X----------xxxx------------------------------xx-x--------------xxxxx---?-------------------------------------xxX--xxx--x--xx----xx
-----xxxx-?-------------xxXX--X---------xx<>-x----------------------------xx---x-xx-----xxxxxx----x-----xxx--------------------S?QQ?------xx-X--XXX---xxx----XXX
----xx<>-x-------------xxXXX-xX--------xx-[]--x-------E------------------xx-----xx-x---xxXXXXX-----x---xxX-x-----------------------------xx--X--XX-----x--------
---xx-[]--x-----B---xxxxXXXX--x-----B-xx--[]---x-----<>------------xxx--xx-----XXX--xxxx------------x-xx-X--x-xxx---B-----------xxxxxxxxxx--EX--------<>--------
xxxx--[]---xxxxxxxxxxXXXXXXX---xxxxxxxx---[]----xxxxxxxxxxxxxxxxxxxx--xxxX---------XXXXX-------------xx--X---xxE-xxxxxxxxxxxxxxxxXXXXXXXXXXXXX--------[]--------
XXXXXXXXXXXXXXXXXXXXXXXXXXXXXXXXXXXXXXXXXXXXXXXXXXXXXXXXXXXXXXXXXXXX--XXXX---------------------------XX--XXXXXXXXXXXXXXXXXXXXXXXXXXXXXXXXXXXXX--------[]--------