----------------------------------------------------------------------------------------------------------------------------------------------------------------
----------------------------------------------------------------------------------------------------------------------------------------------------------------
----------------------------------------------------------------------------------------------------------------------------------------------------------------
----------------------------------------------------------------------------------------------------------------------------------------------------------------
----------------------------------------------------------------------------------------------------------------------------------------------------------------
----------------------------------------------------------------------------------------------------------------------------------------------------------------
--------------Q-?-Q----------xxxx--------------------------------------xxxX-------------------------------------E-----------------------------------------------
-------oo-------------------xx---xx-----xxxxS-------------------------xxXXX-----------------------------------SSSSSSSSSSSSSSSSSSSSS-----------------------------
------XX------------E---E--xx------x---xx--xxx-----------------------xxXXXX-------------------------------------------------------------------------------------
-------------xxx----xxxxxxxx--------x-xx------x-xxx-----------------xxXXXXX----------------------------------E--------------------------------------------------
--------xxxxxxE-xxxxxXXXXXXX---------xx----E-EExx--xx---------xxxxxxxXXXXXX-------------------------------------------------------------------------------------
-------xxXXXXXEXXXXXXX---------------XX--------XX-XX-x-------xxE---xXXXXXXX--------------Q-----------------S?S--------------------------------------------------
------xx---------------------------------------XX-----xxx---xx<>-X-XXXXXXXX------------------------------------------------------------------x-XXXXXXXXXXXXXXXXX
-----xx----------------------------------------XX-----XX-xxxx-[]-X-XXXXXXXX--xxxxxxxxx-------xxxxxx----B-----------xxxxxxxxxxxxxxxx----x----xx------------------
xxxxxx-----------------------------------------X------XXXXXXXXXXXXXXXXXXXXXXXxXXXXXXE-xxxxxxxx--EE-xxxxxxxxxxxxxxxxx---------------xxxxxxxxxx-------------------
XXXXXX-----------------------------------------X------XXXXXXXXXXXXXXXXXXXXXXXXXXXXXXXXXXXXXXXX--XXXXXXXXXXXXXXXXXXXX---------------XXXXXXXXXXXXXXXXXXXXXXXXXXXXX