----------------------------------------------------------------------------------------------------------------------------------------------------------------
-------------------------------------------------------------------------------------------xxx------------------------------------------------------------------
------------------------------------------------------------------------------------------xx--x-----------------------------------------------------------------
-----------------------------------------------------------------------------------------xx----x----------------------------------------------------------------
----------------------------------------------------------------------------------------xx------x---------------------------------------------------------------
---------------------------------------------------------------------------------------xx--------x--------------------------------------------------------------
-----------------------------------------------------------------------------------xxxxx----------x-------------------------------------------------------------
----------------------------------------------------------------------------------xxXXXX-----------x------------E---XXXXX---------------------------------------
------------------------------------------------------------------------------S--xxXXXXX----------oox--------------------------E--------------------------------
--------------------------------------------------------------------------------xxEXXXXX-------------x----------xx-xxxxxx-------------------xx----------xxxx-xxx
-----------------------------------------------<>-------------E----------------xxXXXXXXX--------------x--------xx-xx-----xxxxxx------------xx-x------xxxx---xx--
-----------------------------------------------[]--------QQQQQQ---------------xxXXXXXXXX---------------x------xx--XX----XXXXXX-x------xxxxxx---x----xxXXX--XXX--
-------xxx-------------------------------------[]--XXXXXX------xxxx----------xxXXXXXXXXX----------------xxxxxxx-----------------xxxxxxx---x-----x--xx------XX---
------xxX-x-----xxx-------------------------x--[]--------------x<>-x--------xxXXXXXXXXXX---------------XXXXXXXX-----------------XXEXXXX---X------xxx------------
xxxxxxx-X--xxxxxx--xxxxxxxxxxxxxxxxxxxxxxxxxxxx[]---------------[]--xxxxxxxxx-XXXXXXXXXX---------------X------------------------------X---XX-----XXX------------
XXXXXXXXXXXXXXXXX--XXXXXXXXXXXXXXXXXXXXXXXXXXXXXXXXXXXXXXXX-<><XXXXXXXXXXXXXX-XXXXXXXXXX----------XXX--X------------XXXXX-------------X---XXX-------------------