----------------------------------------------X-----------X------------XXXX--X------------------------XXXXXXXXXXXXXXXX------------------------------XXXXXXXXXXXX
----------------------------------------------------------------------------------------------------------------------------------------------------------------
----------------------------------------------------------------------------------------------------------------------------------------------------------------
----------------------------------------------------------------------------------------------------x-----------------------------------------------------------
-------------S-------------------------------------------------------------------------------------xx-----------------------------------------------------------
--------------------------------------------------------------------------------------------------xx-x----------------------------------------------------------
-----------------------------------------------------------------------------------------------xxxx---x---------------------------------------------------------
--------SSSSSS--------------------------------------------------------------------------------xxXXX----x----------------------------E----xxx-XXX----------------
-----------------------------------------------------------?Q----QQ?-------------------------xx---------x---E-----------------------xxxxxx--x-------------------
----------------------------------------------------------------------------x---------------xx-----------x-------------------------xx-XXXX---x----X-------------
-----------------------------------------------------xx----------------------x------------xxx-------------x-----------------------xx----------xx----------------
-------xxxx----------------------------------E------xx-x--QQ-----SSS-------oX-x------S---xxXX--------------x---QQ?QQQ-----xxxxxxxxx-------------x---------------
------xx---x--------------xxx------------xxx-------xx---x-------xxxx--------X--xE-------xx-X----------------x--------xxxxxxXXXXXXXX--------------x--------------
-----xx-----x------x-----xxB-x--------B-xxX-x-----xx-----x-----xx---x-------X---x------xx--------------------x------xx---x------------------------x-------------
xxxxxx-------xxxxxx-xxxxxx-b--xxxxxxxxxxx-X--xxxxxx-------xxxxxx-----x---xxxX----xxxxxxx------------------X---xxxxxxx---XX-------------------------x----B-------
XXXXXX------XXXXXXXXXXXXXXXXXXXXXXXXXXXXXXXXXXXXXXX------XXXXXXX------xxxx--X---XXXXXXXE-------------XXXXXXXXXXXXEEXX-------------------------------xxxxxxxxxxxx