----------------------------------------------------------------------------------------------------------------------------------------------------------------
----------------------------------------------------------------------------------------------------------------------------------------------------------------
----------------------------------------------------------------------------------------------------------------------------------------------------------------
----------------------------------------------------------------------------------------------------------------------------------------------------------------
----------------------------------------------------------------------------------------------------------------------------------------------------------------
-------------xx----------------------------------------------------------------------------------------------------------------------------------o--------------
----------xxxx-xxxxxxxxx-------------------------------SSSSS-----------------------------------xx--------------------xx-----------------------------------------
---------xxXXX--QQQ?QQQ-x-------------------------------[]---------------------E--E---E--E---Exx-x-------S----------xxX------------------------SSS-------E------
--------xxXXXX------------------------------------------[]-----------E----E-E----------------xx---x----------------xx-X---------S-----------------------<>------
-------xxXXXXX----E---------------------------------?---[]-------xxxxxxxxxxxxxxxxxxxxxxxxxxxxx-----x--------------xxX-X---------------------xxxxxxxxx---[]------
------xxXXXXXX--SSSSSSS------------SSSSSS?--------------<>------xxXSSSSSSSSSSSSSSSSSSSSSSSSSS-------x------------xx-X-X-------------------xxx---x----xx-XXX-----
-----xx-XXXXXX-----------S------S------------------------------xxXX--------------------------------------S------xxX-X-X---x--------------xx<>---S---<>-x--------
----xxXXXXXXXX----X----------------------------------xxx-E----xxXXX----o------oooooooo--ooooo------------------xxXX-X-X--xx-xxxxxx------xx-[]-------[]--x-xxxx--
---xxXXXXXXXXX----X-----------------------xxxxxxxxxxxxB-xxxxxxxXXXX----------------------------------------xxxxxXXX-X-Xxxx-xxE--X-x----xx--[]-------[]---xx<>-x-
xxxx----XXXXXX-E--X------xxxxxxxxxxxxxxxxxx---XXXXXXXXX-XXXXXXXXXXX----o------ooooooooo-ooooo--------xxxxxxx--xXXXX-X-X-x--X<>--X--xxxxxE--[]----E--[]----x[]--x
XXXXXXXXXXXXXXXXXXXXXXXXXXXXXXXXXXXXXXXXXXX---XXXXXXXXX-XXXXXXXXXXXXXXXXXXXXXXXXXXXXXXXXXXXXXXXXXXXXXXXXXXXX-XXXXXX-X-XXXXXX[]--X--XXXXXXXXXXXXXXXXXXXXXXXXXXXXX