----------------------------------------------------------------------------------------------------------------------------------------------------------------
----------------------------------------------------------------------------------------------------------------------------------------------------------------
----------------------------------------------------------------------------------------------------------------------------------------------------------------
-------------------------------------------------------------------------------------------------------------------------ooo------------------------------------
-------------------------------------------------------------------------------------------------------------------------o-o------------------------------------
-----------------------------------------x---------------------------------------o--------------------------------------xxxxx-----------------------------------
----------------------------------------xx---------------------------------------o-------------------------------------xxXXX-x----------------------xxx---------
-----------------------------?---------xxX----------------------------------------------------------------------------xx------x------------------xxxx--x-----XX-
--------------------------------------xxEX--------------------------------------------------------x------------------xx--------x----------------xxXXX---x-------
-------------------------------------xxEXX---------------------------------------------------------x-E----------xxxxxx----------xooo-----------xx--------x--xxx-
-------------------------------------xXXXX--------------------------------------x----X----------------XXX-----xxx--XXX----------oxoo----------xx----------xxx--x
-------------B--Q------QQQQ--Q-------XXXXX-------------B---XXXX----------------xx----------------------------xx<>-----------------xxxxxxxxxxxxx-----------XXX-XX
-------------b-----------------------XXXXX-------------b--------------xxx-----xx----------------------------xx-[]-------------XXXXXXXXXXXXXXXXXXXXX-------------
-------------B---------E-------------XXXXX-------------B---xxx-------xxX-x---xx----------------------------xx--[]-----------------------------------------------
xxxxxxxxxxxxxxxxxxxxxxxxxxxxxxxxxxxxxXXXXXxxxxxxxxxxxxxxxxxx--xxxxxxxx-X--xxxxX---------------------x----xxxE--[]-----------------------------------------------
XXXXXXXXXXXXXXXXXXXXXXXXXXXXXXXXXXXXXXXXXXXXXXXXXXXXXXXXXXXX--XXXXXXXXXXXXXXXXX--------XXXXXXXXXXXXXX----XXXXXXXX-----------------------------------------------