----------------------------------------------------------------------------------------------------------------------------------------------------------------
----------------------------------------------------------------------------------------------------------------------------------------------------------------
----------------------------------------------------------------------------------------------------------------------------------------------------------------
-----------------------------------------------------------x----------------------------------------------------------------------------------------------------
-----------------------------------------------------------x----------------------------------------------------------------------------------------------------
----------------------------------------------------------xx----------------------------------------------------------------------------------------------------
---------------------------------------------------------xx--------------------------------------------------------------------------------------------------xxx
---------------SSSSSSSSSSS-------------------------------xS--X-----------------------------XXXXX------------------------------------------------------------xxXX
--------------------------------------SS-----------------x-----------------------XXXXoo--------------------------------------------------------------------xxXXX
-----------------------------------------x--------------xx------------------------------------------------------------------------------------------------xxXXXX
----------------------------------------xx-xxxxxx--SSSSxxS-----------------------------------------------------------------------------------------------xxXXXXX
Q--------------------------------------xxXxxXSSS-x-----x-----------<>---XXXX--X--------------------XXXXXXX-------------------------QQQQQQQQQ?-----------xxXXXXXX
--------------------------------------xxXXx-X-----x----x-----------[]----------------------------------------------------------------------------------xxXXXXXXX
-----xxxx---------xxxxxxxx----------ExxXXX--X------x------E--------[]--------------------------------------------------xxxxxxxxxxxxxxxxxxxxxxxxxxxxxxxxxXXXXXXXX
xxxxxxEE-xxxxxxxxxx-------xxxxxxxxxxx-XXXX-EX-------xxx------------XX--------------------------------------------------xXXXXXXXXXXXXXXXXXXXXXXXXXXXXXXXXXXXXXXXX
XXXXXXXXXXXXXXXXXXX-------XXXXXXXXXXX-XXXXXXXXXXX--XXXXXXXXX-------XX----------------------------------------XXXXXXXXXXXXXXXXXXXXXXXXXXXXXXXXXXXXXXXXXXXXXXXXXXX