----------------------------------------------------------------------------------------------------------------------------------------------------------------
----------------------------------------------------------------------------------------------------------------------------------------------------------------
----------------------------------------------------------------------------------------------------------------------------------------------------------------
----------------------------------------------------------------------------------------------------------------------------------------------------------------
-----------------------------------------------------xx---------------------------------------------------------------------------------------------------------
--------------------------------xxxxxx--------------xx-x-----xxxxxxxxxx-----------------------------------------------------------------------------------------
-------------------------------xx-----xSSS---------xx---xxxxx--xx---XX-x----------------------------------------------------------------------E-----xxx---------
------------------------------xx-E-----x--xxxxxxxxxx----x--X---E----[]--x---E----------E----------------------------o-------------------------xxxxxxx--x--------
-----------------------------xx---------xxxXXXXXXXXX----E--X--------[]---x-------------------------------------------------------------------xx-XXXXX---x-------
----------xxxxxxxxxxxxxxxxxxxx-----------xXXXXXXXX------XX-X--------[]--E-x-----ooo----------------xxx--xxxx-xxxxxxxxxx--xxx----------------xx-----------x------
----------xXXXXXXXXXXXXXXXXXXX-----------XXXX-----------XX-X--------[]-<>--x----ooo-------------xxxx--xxx---xx---XXXXX-xxx--x---------xxxxxxx-------------o----S
---------x------------------------------XXXXX-----------XX-X--------<>-[]---x------------------xxXXX--XXX--XXX--XX-----XXX---xx------xxXXXXXX-------------x-----
--------xx-----------------------------XXXXXX-----------XX-X-----------[]----x----------------xxXXXXE-----------X--------------x----xx---------------------x----
--xxxxxxx-----------------------------XXXXXX----<>------XX-X---------E-[]-E---xxxxxxxxxx------xXXXXX----------------------------x--xx-----------------------x---
xxx--XXXX-----------------------------XXXXXX----[]------XX-X-------XXXXXXXXXXXXXXXXXXXXX---XXXXXXXX-----------------------------Exxx-------------------------xxx
XXX------------------------------X----XXXXXX----[]---XXXXX-XX------XXXXXXXXXXXXXXXXXXXXX---XXXXXXXX------------------------------XXXXXX----------------------XXX