----------------------------------------------------------------------------------------------------------------------------------------------------------------
----------------------------------------------------------------------------------------------------------------------------------------------------------------
----------------------------------------------------------------------------------------------------------------------------------------------------------------
------------------------SS----SSSSSSSSSSSSSSSSSSSSS-x-----------------------------------------------------------------------------------------------------------
------------------------SSSSSS---[]----------------xxx----------------------------------------------------------------------------------------------------------
------------------------SSSSS----[]------E--------xx--x---------------------------------------------------------------------------------------------------------
------------------------SSSSS----[]---QQQQQ------xxX---x--------------------------------------------------------------------------------------------------------
------------------------S-S------[]-------------xxS-----x----E--------------------------------------------------------------------------------------------XSSSSS
---------------------------------[]------------xx--------x--<>---------------------oooo-------------------------------------------------------------------X-----
-----------------------x---------[]--xxxxxxxxxxx------------[]--------------------------------------------------------------------------------------------X-----
----------?QQ---------xxxx-------[]-xxSSSSSSSSSS----------x-XXX----------------xxxx----------------------------------------Q--?--------oo----------------EX--E-X
---------------------xxX--x------<>xx-SSSSSSSSSS---------X-x------------------xx<>-x------------------------------------Q-E-------------------------------XSS?SX
--------------------xxXX---x------xx--SSSSSSSSSS-------EXX--x-xxxx-----------xx-[]--x------------------x------------------E-------------------------------------
---xxxxxxxxxxxxxxxxxxXXX-E--xxxxxxx---SSSSSSSSSS-------XXX---xx<>-x---------xx--[]---x------xxxxxxx---xxxx------------------------------------------------------
xxxxXXXXXXXXXXXXXXXXXXXX-EEXXXXXXXXE--XXXXXXXXXXXXXXX-XXXX----x[]--xxxxxxxxxx---[]----xxxxxxx------xxxxX--xxxxxxxxxxxxxxxxxxxxxxxxxxxxxxxxxxxxxxxxxxxxxxxxxxxxxx
XXXXXXXXXXXXXXXXXXXXXXXXXXXXXXXXXXXX--XXXXXXXXXXXXXXXXXXXXXXXXXXXXXXXXXXXXXXXXXXXXXXXXXXXXXXX---XX-XXXXX-XXXXXXXXXXXXXXXXXXXXXXXXXXXXXXXXXXXXXXXXXXXXXXXXXXXXXXX