----------------------------------------------------------------------------------------------------------------------------------------------------------------
-------------------------------------------------------------------------------------------------------------------------------------------------x--------------
---x--------------------------------xxxxxxxxxxxxxxxxxxxxxxxxxxxxxxxxxxxxxxxxxxxxxxxxxxxxxxxxxxxxxxxxxxxxxxxxxxxxxxxxxxxxxxxxxxxxxxxxxxxxxxxxxxxxxxxx------------
----x------------------------------xxSSSSSSSSSSSSSSSSSSSSSSSSSSSSSSSSSSSSSSSSSSSSSSSSSSSSSSSSSSSSSSSSSSSSSSSSSSSSSSSSSSSSSSSSSSSSSSSSSSSSSSSSSSSSS--x-----------
-----x----------------------------xx-----------------------------------------------------------------------------------------------------------------xxxxx------
------xxxxx----------------------xx------------------------------------------------------------------------------------------------------------------XXx--x---xx
------XXXX-x---------------------XX-------------------------------------------------------------------------------------------------------------------XX---xxxx-
------------x-----------------------------------------------------------------------------------------------------------------------------------------XX---SSSS-
-------------xxx--------------------------------------------------------------------------------------------------------------------------------------XXX-------
--------------x-x-------------------------------------------------------------------------------------------------------------------------------------XX--------
--------------S--x--------------------<>--------<>---<>---<>---<>---<>---<>---<>---<>---<>---<>---<>---<>---<>---<>---<>---<>---------<>----<>--------XX--------
------------------x------E------------[]--------[]---[]---[]---[]---[]---[]---[]---[]---[]---[]---[]---[]---[]---[]---[]---[]---------[]----[]--------XX------ES
-------------------xx---------E-------[]--ooo---[]---[]---[]---[]---[]---[]---[]---[]---[]---[]---[]---[]---[]---[]---[]---[]--oooo---[]----[]--------XX-E---<>-
-------------------X-xxxxxxx-<>-------[]--ooo---[]---[]---[]---[]---[]---[]---[]---[]---[]---[]---[]---[]---[]---[]---[]---[]--oooo---[]----[]--------XX<>---[]-
xxx----------------XXXXXXXXX-[]-------[]--XXX---[]---[]---[]---[]---[]---[]---[]---[]---[]---[]---[]---[]---[]---[]---[]---[]--oXXX---[]----[]-------XXX[]---[]-
XXX----------------XXXXXXXXX-XX-------[]--XXX---[]---[]---[]---[]---[]---[]---[]---[]---[]---[]---[]---[]---[]---[]---[]---[]--XXXX---[]----[]----XXXXXX[XXXXXXX