----------------------------------------------------------------------------------------------------------------------------------------------------------------
----------------------------------------------------------------------------------------------------------------------------------------------------------------
----------------------------------------------------------------------------------------------------------------------------------------------------------------
----------------------------------------------------------------------------------------------------------------------------------------------------------------
----------------------------------------------------------------------------------------------------------------------------------------------------------------
----------------------------------------------------------------------------------------------------------------------------------------------------------------
-------------------------------SSS-----------------------------------------------------------------E------------------------------------------S-----------------
----------SSSSS------------------------------------------------------xxxxx-------------------------S------------------------------------------------------------
--------------------------------------------------------------------xx-<>-xx---------------------------------------------------------------------S--------------
-------------------------------X-----------------------------------xx--[]---x----------------------?------------------------------------------------------------
-------------------------------XEE----------------------------E--xxx---[]----xxx-?--------------o---------------------------------------------------------------
-------------------------------XSSSSSQS--S----------------------xx<>--QQQ?---<>-x-----------------xxx--------------------QQ--------------oo-------------SSS-----
---xxx---------------------------------------------------------xx-[]---------[]--x----B----------xxX-xxxxx-------Q?QQ-----------xxxxxx---oo--xxxxxx-------------
--xxB-x--xxxxxx-----------------------------------------------xx--[]---------[]---x---b-------xxxx-X--x<>-x--------------------x---XX-xxxxxxxx---X-x-----------x
xxx-b--xxx-----xxxxxxxxxxxxxxxxxxxxxxxxxxxxxxxxxxxxxxxxxxxxxxxx---[]---------[]----xxxxxxxxxxxx----X---[]--xxxxxxxxxxxxxxxxxxxxx---XXXXXXXXXXX---X--xxxxxxxxxxxx
XXXXXXXXXX-----XXXXXXXXXXXXXXXXXXXXXXXXXXXXXXXXXXXXXXXXXXXXXXXXXXXXXX--------XXXXXX<>XXXXXXXXXX--XXXX-XXXXXXXXXXXXXXXXXXXXXXXXXX---XXXXXXXXXXX---X--XXXXXXXXXXXX