----------------------------------------------------------------------------------------------------------------------------------------------------------------
----------------------------------------------------------------------------------------------------------------------------------------------------------------
----------------------------------------------------------------------------------------------------------------------------------------------------------------
------------------------------------------------------------XXXX------------------------------------------------------------------------------------------------
-------------------------------------------------------------[]-------E-----------------------------------------------------------------------------------------
-----------------------------------------------------xxx-----[]-----------------xxxx-----------------------------------------------------------o----------------
----E---E-E-----------------------------------------xx--x----<>----------------XXXX-x---------------------------------------------------------------------------
----S--<><>------------XXX------xxxx----xxx--------xx----x-------EXX---XX-----XXEXX--------------------------xx------------------------------SSS----------------
-------[][]------xxx-----------xx---x--xx--x------xx------x---E-EXXX---------XXXXXX--xx---------------------xx-x------------------------------------------------
----?--QQQQ-----xx--x--xxx----xx-----xxx----xxxxxxx-------------XXXX--------XXXXXXX--E-x-------------------xx---x-------------------------xxxxxxxxx-------------
---------------xx----xxx--xxxxx-------x-----XXXXXXX---------xxxxXXXX--------XXXXXXX-<>--x-------------E---xx-----x-?-----------------E--xxx---x----xx-----------
---xxx--------xx-----XXX-XXXXXX------XX--------------------xx---XXXX-------XXXXXXXX-[]---x--------------xxx----E--x--------------------xx<>---S---<>-x----------
--xxX-x------xx--------------------------------------------x---<XXXX-------XXXXXXXX-[]----x------------xx<>----X---x------------------xx-[]-------[]--x---------
-xx-X--xxxxxxxX-------------------------------------------X----[XXXX-------XXXXXXXX-[]-E---xxxxxxxx---xx-[]----X----x----------------xx--[]-------[]---x--------
xx--X--XXXXXXXX-------------------------------------------X----[XXXX--X----XXXXXXXXXXXXXXXXXXXXXXX-xxxx--[]E---X-----xxxxxxxxxxxxxxxxx---[]----E--[]----xxxxxxxx
XXXXXX-XXXXXXXX-------------------------------------------X----[XXXXXXX----XXXXXXXXXXXXXXXXXXXXXXXXXXXXXXXXXXXXXXXXXX<>XXXXXXXXXXXXXXXXXXXXXXXXXXXXXXXXXXXXXXXXX