----------------------------------------------------------------------------------------------------------------------------------------------------------------
----------------------------------------------------------------------------------------------------------------------------------------------------------------
----------------------------------------------------------------------------------------------------------------------------------------------------------------
----------------------------------------------------------------------------------------------------------------------------------------------------------------
--------------------------------------------------------------xxx-----------------------------------------------------------------------------------------------
------------------------------------------------------------xxx--x----------------------------------------------------------------------------------------------
-------------------------------------------------------------XX---x---------------------------------------------------------------------------------------------
-------------------------------------------------------------------x------------------------------------------------------------------------Q-Q-Q---------------
--------------------------------E-----------------------------------x-------------------------------------------------------------------------------------------
-----------------------------------------------------------x---------xx-----------------------------------------------------------------------------------------
----------------------------------------------------------xx----XXXXXX-x-------------------------------------xxxxxx---------------------------------------------
------------x----------xxxx-----------QQQQ?--------------xxX------------x------------------------XXXX-------xxXSSS-x-----------SSS----xxxx--Q-Q-Q--QQQQ---------
-----------xx--x--E---xx<>-x----------------------------xxXX-------------x---------------------------------xx-X-----x--x-------------xx<>-x---------------------
---xxx----xxX-xx-<>--xx-[]--xxxxxxxxxxxxxxxxxxxxxxxxxxxxxXXX--------------x----xxxx----x---xxx---xxx------xx--X------xx-x-----------xx-[]--x-------E------------
xxxx--xxxxxXXxxX-[]--XXXXXXXXXXXXXXXXXXXXXXXXXXXXXXXXXXXXXXX---------------xxxxx---xxxx-xxxx--xxxx--xxxxxxx--EX------XX--xxxxxxxxxxxxE-[]---xxxxxxxxxxxxxxxxxxxx
XXXX-XXXXXXXXXXX-XX--XXXXXXXXXXXXXXXXXXXXXXXXXXXXXXXXXXXXXXX----------XXXXXXXXXX-X-XXXXXXXXX--XXXX--XXXXXXXXXXXXXXX--XX-XXXXXXXXXXXXXXX[]XXXXXXXXXXXXXXX<>XXXXXX