----------------------------------------------------------------------------------------------------------------------------------------------------------------
----------------------------------------------------------------------------------------------------------------------------------------------------------------
----------------------------------------------------------------------------------------------------------------------------------------------------------------
---------------------------------------------------------------------------------------------------------------------------------------SSSSS--------------------
-SSSSSSSSSSSSSSSSSSSSSSSSSSSSSSSSSSSSSSSSSSSSSSSSSSSSSSSSSSSSSSSSSSSSSSSSSSSSSSSSSSSSSSSSSSSSSSSSSSSSSSSSSSSSSSSSSSSSSSSSSSSSSSSSSSSSSS---[]--------------------
---------------------------------SSSSSSSSSS--SSSS-------------------------------------------------------------SS--------------------------[]--------------------
---------------------------------SSSSSSSSSS--SSSS-------------------------------------------------------------SS--------------------------[]--------------------
-------------------------oooo------------SS-------------------oooooooo--oooo------------------------o-------SS----------------------------[]--------------------
----------xx-----------------------------SS-----------------------------------------------------------------SS--------------------o-------[]--------------------
---------xx-x-xxx------S-SSSS-S----------SS-------------------SSSSSSSSS-SSSS-S----------------------S-S-----SS-------------xxxxxxxx-------[]---xx--------xxx----
--------xx---xx--x-----SoS--SoS--ooooooooSS---E---------------SSSSSSSSSoS--SoS-----------------------oS-----SS---------xxxxx--x--S-x------[]--xx-x------xx--xx--
------xxx----<>---x----SSS--SSS--SSSSSSSSSS--SSSS---------------------SSS--SSS-----------------------SS-----SSSS------xxXXXX--X-----xx----<>-xx---x---Exx---X-x-
-----xx<>----[]----x------------------------EE----------------------------------------------------------------SS-----xxEXXXXXXXXX--XX-x-----xx-----xxxxx----XX-x
----xx-[]----[]-----x---------------------------xxxx-xxxx-xxxx--------------------------xxxxxxx-xxxx----------SS----xxXXXXXXXXXXX--XXX-xxxxxx-----XXXXXX----XXXX
xxxxx--[]----[]--E---xxxxxxxxxxxxxxxxxxxxxxxxxxxx---xx---xx---xxxxxxxxxxxxxxxxxxxxxxxxxxx--x---xx---xxxxxxxxxxxxxxxxxXXXXXXXXXXXXE-XXXXXXXXXX----------X----XXXX
XXXXXXXXXXXXXXXXXXXXXXXXXXXXXXXXXXXXXXXXXXXXXXXXX---XX---XX--XXXXXXXXXXXXXXXXXXXXXXXXXXXX-XX---XX--XXXXXXXXXXXXXXXXXXXXXXXXXXXXXXXXXXXXXXXXXX----------X----XXXX