----------------------------------------------------------------------------------------------------------------------------------------------------------------
----------------------------------------------------------------------------------------------------------------xxx---------------------------------------------
--------------------------------------------xxx----------------------------------------------------------------xx--x--------------------------------------------
-------------------------------------------xx-----xx-----xxx-------------------------xxx-----xx-----xxxxxx----xx----x-------------------------ooxxx-------------
------------------------------------x-----xx-----xx-x---xx--x-----xxx-------xxx-----xx--xx--xx-x---xx-----x--xx------x-----xxxxxxx--------xxx-xxx--x------------
-----------------o----------------xx-xxxxxx-----xx---x-xx----xxxxxx--xxxxxxxx--x---xx-----xxx---x-xx-------xxx--------xxxxxx---x--xxxxxxxxx--xXXX---x----------x
-----------------------E--------xxx--XXXXXX----xx-----xx-----XXXXXX--XXXXXXXX---x-xx-------x-----xx--------XXX--------XXXXXX---?---x--XXXXX--X-------x--------xx
---------------SSS-----S---------XX------------XX-----XX-------------------------xx-------XX-----XX-------------------------------XX------------------x---E--xx-
--------------------------------XXX----------------------------------------------XX-------------------------------oo-----------------------------------xxxxxxx--
------------xxxxxxxxx--?--------XXX-------------------------------------------------------------------------------SS-----------------------------------XXXXXXX--
-------E--xxx---x---------------XXX-----------------------------------------------o----------------------------------------XXXEX-------------E------------------
---------xx<>---S-----xxx-------XXX-----------------------------------------------o--XX-----------------------------------------------------<>------------------
--------xx-[]--------xxX-x------XXX--------------------------------------------------------------------------------------------------------X[]------------------
-------xx--[]-------<x-X------ExXXX-----------------------------------------------------------------------o---o-----------------------------[]XXXXXX------------
xxxxxxxx---[]----E--[--X--xxxxxxXXX----------------------------------XXXXXXXXXX-------------------------------X-------------------------------------------------
XXXXXXXXXXXXXXXXXXXXXXXXX-XXXXXXXXXX-------------------------------------------------------------------------------XX-------------------------------------------