----------------------------------------------------------------------------------------------------------------------------------------------------------------
----------------------------------------------------------------------------------------------------------------------------------------------------------------
------------------xxx-------------------------------------------------------------------------------------------------------------------------------------------
-----------------xx--x------------------------------------------------------------------------------------------------------------------------------------------
----------------xx----x------------------------------------------------------------------------------------------------------------S----------------------------
---------------xx------x----------------------------xx----------------------------------------------------------------------------------------------------------
--------------xx--------x--x----------------------xxx-xxxxx-----------------------------------------------------------------------------------------------------
--------------XX---------x--x--------------------xxXX--QQQ-x----------------------------E-------------------------------------SSSSSS----------------------------
--------------XX----------x--x------------------xxXXX-------x--------------------------SSSS---------------------------------------------------------------------
--------------XX--------------x----------------xxXXXX--------x--------------------------------------------------------------------------------------------------
--------------XX---------------x--------------xxXXXXX--SSS----x--------------------X-E--E-----------------------------------------------------------------------
-------------oXXS-----------X---x------------xxXXXXXX----------xxx-----------------XS?SSSSS---X-x-------------------------xx-xxxx---------------xx--------------
--------------XX------------X----x----------xxXXXXXXX----------<>-x------------xxx---------EE-Xxx----------------------x-xx<xx---x-------------->-x-------------
------xxxx----XX------------X-----x---B----xxXXXXXXXX----------[]--x--xxx-----xxX-xSSSSSSSSSSSxx----------------------xxxx-[x-----x------------E]--x------------
xxxxxxx---xxxxXX------XXXXX-X------xxxxxxxxxXXXXXXXXX-E--------[]---xxxE-xxxxxx-X--xxxxxxxxxxxx--xxxxxxxxxxxxxxxxxxxxxxXx--[-------xxxxxxxxxxxxx]---xxxxxxxxxxxx
XXXXXXX--XXXXXXXXX----XXXXXXXXXXXXXXXXXXXXXXXXXXXXXXXXXXXXXXXXXXXXXXXXXXXXXXXXXXXXXXXXXXXXXXXXXXXXXXXXXXXXXXXXXXXXXXXXXXXXXX------XXXXXXXXXXXXXXXXXXXXXXXXXXXXXX