----------------------------------------------------------------------------------------------------------------------------------------------------------------
----------------------------------------------------------------------------------------------------------------------------------------------------------------
----------------------------------------------------------------------------------------------------------------------------------------------------------------
------------------------------------------------------------------------------------------------------x---------------------------------------------------------
-------------------------------------------------------------------------------------------------------xxx------------------------------------------------------
------------------------------------------------------------------------------------------------------<>--x---------------o------------xxxxxxxxxx---------------
------------------------------------------------------------------------------------------------------[]---x---------------o----------xx--x---XX-x--------------
----------------------------------------------------------------------------------------------XXX-----XX----x--------------XX--------xx---E---[]----------------
------------xx--------------------------xxx------------------------------------------------------------------x----------------o-----xx--------[]--X---------S---
-----------xx--------------------------xx--x-xxx--------------------------------------------------------------x--------------XXX---xx---------[]--X-----Q?------
----------xx--------------------xx----xx----xx--xx---------------------------------------E---------------------xS-----xxxx-------xxXX---------[]----------------
--------xxx----------xxxx------xx-xxxxx----XXX--X-x---------------------------------QQQQQQQ---------------------x----xxXX-xxx---xxX-----------<>----------------
-------xx<>---x-----xx---x----xx--XXXXX---------XX-x-XXXXXXXXXXXXXXXXXXXXXXXXXXXXXXX-----------------------------x--xxXXX----xxxx------------------------xxxxx--
------xx-[]----x---xx-----xxxxx---X-------------XXX---------------------------------------------------------------xxxXXXX---XXXXX--------------E--xxxxxxxx--X-x-
xxxxxxx--[]--E--xxxx-----XXXXXX---X-------------XXX---------------------------------------------------------------XXXXXXX--------------------XXXXXXXXXXXXX--X--x
XXXXXXXXXXXXXX--XXXX--------------X-------------XXXXXXXXXXXXXXXXXXXXXXXXXXXXXXXXXXXXXX-<><>--------X--------------XXXXXX---------------------XXXXXXXXXXXXX--X--X