----------------------------------------------------------------------------------------------------------------------------------------------------------------
----------------------------------------------------------------------------------------------------------------------------------------------------------------
----------------------------------------------------------------------------------------------------------------------------------------------------------------
------------------------------------------x------------------------------------------------------------------------------xxxxxxxxxxxxxxxxxxxxxxxxxxxxxxxxxxxxxxx
------------------------------------------x----------------------------------------------------------------------------xxxSS????SSSSSSSSSSSSSSSSSSSSSSSSSSSSSSSS
-----------------------------------------xx------o------------------------------------------------------------------xxxxSS--------------------------------------
----------------------------------------xx------------xxxxxx--------------------------------------------------------xSSS----------------------------------------
-----------------SSSSSSSSSSSSSSS--------xS-----SSS---xx?SSS-x-------------------------------------------------------x-------------------------------------------
---------------E------------------------x------------x-------x-----------------------------------------------------xx-------------------------------------------
----------------xxxxx------------------xx---xxxxxxxxxx-------Ex-------------------------------------xxxxxxx-------xxS-------------------------------------------
--------------xxx----xx---------xxxx--xxS--xx---x---xE------<>-x----------------------E------E-----xx--x<>-x----xxx-------XXXXX-------------------------XXX-----
-------------xx<>---<>-x-------xx<>-x-x----<>---S---<>---E--[]--x---------------------------<>-----x----[]--x---x<>------XXXXXX---------------------------------
------------xx-[]---[]--x-----xx-[]--xx----[]-------[]--<>--[]---x---------------------xxx--------------[]---x---[]-----XXXXXXX---------------------------------
----B-xxx--xx--[]---[]---xx--xx--[]------E-[]-------[]--[]--[]----x-------------------xxX-x-------x-----[]----xx-[]----XXXXXXXX---XXX-----XX---XXXX-------------
xxxxxxx--xxx---[]---[]---X-xxx---[]--------[]----E--[]--[]--[]-----xxxxxxxxxxxxxxxxxxxx-X--xxxxxxxx---XXXXXXXXXX-[]---XXXXXXXXX---------------------------------
XXXXXXX--XXXXXXXX---XX---XXXXXXXXXXX--XXXXXXXXXXXXXXXXXXXXXXXXXXXXXXXXXXXXXXXXXXXXXXXXXXXXXXXXXXXXXXX-XXXXXXXXXXXXXXXXXXXXXXXXXX--------------------------------