----------------------------------------------------------------------------------------------------------------------------------------------------------------
-----------------------------------------------------------------------xxx--------------------xxx---------------------------------------------------------------
----------------------------------------------------------------------xx--x----------xxx-----xx--x--------------------------------------------------------------
-------------------------------------------------------------xxx--?--xx----x--------xx--x---xx----xxxxxxxxxxxxxxxxxxxxxxxxxxxxxxxxxxxxxxxxxxxxxxxxxxxxxxxxxxxxxx
------------------------------------------------------------xx--x---xx------xx-----xx----x-xx------SSSSSSSSSSSSSSSSSSSSSSSSSSSSSSSSSSSSSSSSSSSSSSSSSSSSSSSSSSSSS
-----------------------------------------------------------xx----xxxx-------E-xxxxxx-----Exx-------SSSSSS-------------------------------------------------------
-------------SSS------------------------------------E-----xx-----XXXX---------XXXXXX------XX-------SSSSSS-------------------------------------------------------
-----------------------------XX-------------xxx-----xxxxxxx----------------------------------------SSSSSS-----------------------E---------------E---------------
-----------------------------XX---------xxxxx--x---xx-XXXXX--------------------------------------------------------------------<>--------------<>---------------
-------------X-----------xxx-XX--------xxoox----x-xx---------------------------------------------------------------------------[]--------------[]---------------
-------------XEE---------xXx-XX--------XXEXX-----xx------------------------------------------------oo--------------------------[]--------------[]---------------
-------------XSSSSS------XX--XX-------x---------XXX--------------------E---------------------------SS----XX-------------------?SSS--E---------?SSS--E----------X
------------------------xXX-xXX------xx-------------------------------<>--------------------------------XXX-------E----------------<>--------------<>----XXX----
-----------------------xxXX--x------xx--------------------------------[]--------------------------E----XXXX------<>----------------[]--------------[]-----------
xxxxxxxxxxxxxxxxxxxxxxxx-XX---xxxxxxxE-------------------------------X[]X----------------------XX<>---XXXXX------[]----------------[]--------------[]-----------
XXXXXXXXXXXXXXXXXXXXXXXX-XXXXXXXXXXXXXX-------------------------------------------------------XXX[]XXXXXXXXXXXXXXXXXXXXXXXXXXX----XXX--XXXXXXX----XXX-----------