----------------------------------------------------------------------------------------------------------------------------------------------------------------
----------------------------------------------------------------------------------------------------------------------------------------------------------------
----------------------------------------------------------------------------------------------------------------------------------------------------------------
------------------------------------xxxxxxx-SSSSSSSSSX----------------------------------------------------------------------------------------------------------
------------------------------------XXXXXXX<]-------[]----------------------------------------------------------------------------------------------------------
------------------------------------XXXXXXX[]-------[]----------------------------------------------------------------------------------------------------------
------------------------------------XXXXXXX[]-------[]--------------------------------------------------------------E-------------------------------------------
------------------------------------XXXXXXX-]-------[]-----xxx----------------------------------------------------SS--------------------------------------ooo---
------------------------------------XXXXXXX-]-------[]----xx--x-----E--xxxx-------------------------------------------------------------------------------X-----
------------------------------------XXXXXXX---------[]---xx----xxxxxxxxx---x-------------------------------------------------------xxx--------------------------
------------------------------------XXXXXXX---------[]--xx-E--XXXXXXXXXX----xxx---------------------------------------------------xxXX-------xx----------xxx-xx-
------------------------x-----------XXXXXXXxx-------->-xx--X----------------<>-x---------------------------S---------------------xx---------xx-xxxxxxxxxxx--xx-x
-----------------------x-x----------XXXXXXXX-x--------xx---X----------------[]--x-----------------------------------------------xx---------xx--XXXXXXXXXXX--XX--
-----------------xxxx-xxX-x-xxx-----XXXXXXXX--xxxxxxXxx----X----------------[]---x--xxx---xxx-xxxx-------------------xxxxxxxxxxxx-----xxxxxx---X---------------X
xxxxxxxxxxxxxxxxxx---xx-X--xx-----XXXXXXXXXXXXXXXXXXXXX----X----------------[]----xxx--xxxxE-xx---xxxxxxxxxxxxxxxxxxxXXXXXXXXXXXXX----XXXXXX---X----------------
XXXXXXXXXXXXXXXXXX--XXXXXXXXX-----XXXXXXXXXXXXXXXXXXXXX----X--------------XXXXXXXXXXX--XXXXXXXX--XXXXXXXXXXXXXXXXXXXX--------------------------X----------------