----------------------------------------------------------------------------------------------------------------------------------------------------------------
----------------------------------------------------------------------------------------------------------------------------------------------------------------
----------------------------------------------------------------------------------------------------------------------------------------------------------------
--------------------------xxx-----------------------------------------------------------------------------------------------------------------------------------
--------------------------XXX---------------------------------------------------------------------------------------------------------------SSS---xx------------
--------------------------XXX--------------------------------------------------------------------------------------------------------------------xx-x---------xx
--------------------------XXX---xxxx--xx----------------------X-----------------------------------------------------------------------------?---xx---x-----xxxx-
------------------SS?SSS--XXX--xxXX--xx-x----------------------XXXXXXX-------X-----------------XXX---------------------XXX------------------??-xx-----x---xxXXX-
--------------------------XXX-xxXXX-xxX--x------------------E---------------X-----------------------------------------------------------------xxX------x-xx-----
--------------------------XXXxxXXXX-x-X--Ex-------------XXXXXX-------------------------------------------------------------------------------xx---------xx------
--------------------------XXXxXXXXX-X-X-<>-x------------xxxxx----------------------------------------------------------------------ooo------xx----------XX------
Q-----------------SSSSSS--XXXXXXXXX-X-X-[]--xxxxxxxxxxxxx----x----------------------XXXXX--<>--------XXX---XXXXXXXXX--------XXXX--XXXXX-----SSS-----------------
----------------E---------XXXXXXXXX-X-X-[]--XXXXXXXXXXXXX-----x---------xxx----------------[]-------------------------------------------------------------------
---------------------xxxxxXXXXXXXXX-X-X-[]---------------------xx-xxx--xxX-x---------------[]-------------------------------------------------------------------
xxxxxxxxxxxxxxxxxxxxxx---xXXXXXXXXX-X-X-[]-----------------------xx--xxx-X-----------------XX----------------------------------------------X-------XX-----------
XXXXXXXXXXXXXXXXXXXXXX-X-XXXXXXXXXXXX-XXXXXX---------------------XX--XXXXXXXX--------------XX-----------------------------------------XXXX-XXXX-----------------