----------------------------------------------------------------------------------------------------------------------------------------------------------------
----------------------------------------------------------------------------------------------------------------------------------------------------------------
----------------------------------------------------------------------------------------------------------------------------------------------------------------
-------------------------------------------------------------------------------------------------------------xxx------------------------------------------------
-------------------------------------------------------------------------------------------------------------XXX--------------------------------------SSSSSSSSSS
-------------------------------------------------------------------------------------------------------------XXX---------------------------------xxx--SSSSSSSSSS
-------------------------------E--ooo----------------------------------------------------------------------xxXXX---------------------------------x--x-SSSSSSSSSS
--------------Q-------------------ooo---------------------------------------------------------------------xxXXXX-------------------------------xxX---xSSSSSSSSSS
-----------------------------xxxx------------------------------------------------------------------------xx-XXXXxxx---------------------------xx-X----x---------
--------------------------xxxx---xxxxx------xxxxxx------------------------------------------------------xxX-XXXXx--x------------------------xxxX-X-----x-xxx----
-------------------------xx--E----x---xxxxxxx--x--x----xxx---------------------------------------------xx-X-XXXX?---x---------------------xxx-XX-X-----oxx?-xxxx
------------S?SQQQ------xx-XXX---XX--XXXXXEXX--X---x--xx------------S---------XXXX--------------------xxX-X-XXXX--S--xxx----------------xxx-?-XX-X----S?S???SSSS
-----------------------xx------------X------X--X----xxx--<--------E----------------------------------xxXX-X-XXXX-----<>-x---------B----xx<>---XX-X----SSS---SSSS
----------------------xx-------------X------X--X-----x---[x---------xxx-------xxx-------------------xxXXX-X-XXXX-----[]--x---xxx--b---xx-[]--XXX-X----SS----SSSS
xxxxxxxxxxxxxxxxxxxxxxx--------------X------X--X---XXX---X-xxxxxxxxxx--xxxxxxxx--xxxxxxxxxxxxxxxxxxxxXXXX-X-XXXXX----[]---xxxx--xxxxxxx--[]--XXX-X------E-ooSSSS
XXXXXXXXXXXXXXXXXXXXXXX--------------X------X--X---------XXXXXXXXXXXX--XXXXXXXX--XXXXXXXXXXXXXXXXXXXXXXXX-X-XXXXX----XXXXXXXXX--XXXXXXXXXXXXXXXXXXXXXXXX-XXXXXXX