----------------------------------------------------------------------------------------------------------------------------------------------------------------
----------------------------------------xxxxxxx--------------------------------------------------------------------------------------------xxxxx----------------
----------------------------------------x-----xxxx-------------------------------------------------------------------------------------xxxxx----x---------------
--------------------------------------------------x--------------------xx-------------------------------------------------------------xx--x------x--------------
---------------------------------------------------x--xxx-------------xx-x-----------------------------------------------------------xx---X-------xx------xxx-?-
--------XXXXXXX-------------------------------------xxx--x-----xx----xx---x---------------------------------------------------------xx------------E-xxxxxxx--x-x
-----------------------------------------------------EX---x---xx-xxxxx-----xxx-----------------------------------------------------xx---------------XXXXXXX---xx
---------------------------------------------X-------------x-xx--SSSSS-----SSxSSSSSSSSSSSSSSSSSSSSSSSSSSSSSSSSSSSSSS---------------XX-------------------------XX
------------------------------------------------------------xx----------------x----------------------------------------------------XX---------------------------
------------------------------------------------------------<>-----------------x--------------------------------------------------EXX---------------------------
------------------------------------------------------------[]------------------x-------------------------------------------------XXX---------------------------
---------------------S---------------E----------------------XXX------------------x-----------------------------------------------XXXXS--------------------------
-------->-----<----E----------------<>----------------------------E------E--------x---------------------------------------------XXXXX-----X---------------------
--------]-----[------xxx-xxx--------[]---------------------------<>-----<>---------xx----xxxxxxxxxxxxxxxxxxxxxxxxxxx----------xXXXXXX---------------------------
xxxxxxxx]-----[xxxxxxx--xx--xxxx----[]-X-------------------------[]-----[]---------X-xxxxx--------------------------xxxxxxxxxxxXXXXXX---------------------------
XXXXXXXXXXXXXXXXXXXXXX--XX--XXXX----XXXX-----X------------XXXXXXXXXXXXXXXXXX-------XXXXXXX--------------------------XXXXXXXXXXXXXXXXXXX-------------------------