----------------------------------------------------------------------------------------------------------------------------------------------------------------
----------------------------------------------------------------------------------------------------------------------------------------------------------------
----------------------------------------------------------------------------------------------------------------------------------------------------------------
----------------------------------------------------------------------------------------------------------------------------------------------------------------
----------------------------------------------------------------------------------------------------------------------------------------------------------------
----------------------------------------------------------------------------------------------------------------------------------------------------------------
------------?---------------------------------------------------------------------------------------------------------------------------------------------------
------------E-----------------------------------------------------------------XQQ?QQX--?SSS------------------XSS?SSS--SS---S-------------------------S----------
---------------E--------------------------------------------------------------X-----X------------------------X--------------------------------------------------
--------------<>--------------------------------------------------------------X-----X------------------------X----------------------------Exx-------------------
--------------[]---ooooo-----------------------------------Q------------------XE-E--X---------------------X--X----------------------------X>-x---------------xxx
--------------[]--XXXXXXX---------------------QQ?---SSSS-----------------QQ---XQQ-QQX-----QQQ----QQ----SSSX-EXSSSSSS-----QQQQ------------XX]--x------QQ-----xxXX
----x-xxx-----[]---------------------XXXXXXXXX-----------x-------E----------------------B-----------------------------B----------x------XXX]---x-----------xx---
---xxxxE-xxxxx[]-----------------?---------------------Ex-x-----<>------------------E---b-----------------------------b---------xx-----XXXX]----x---------xx----
xxxxXX<>XXXXXXXX-------------E------------------B--xxxxxx--xxxxxxxxxxxxxxxxxxxxxxxxxxxxxxxxxxxxxxxxxxxxxxxxxxxxxxxxxxxxxxxxxxxxxx--XXXXXXXX]-----xxxxxxxxxx-----
XXXXXX[]XXXXXXXX--------XXXXXXXXX-XXXXXXXXXXXXXXXXXXXXXXXXXXXXXXXXXXXXXXXXXXXXXXXXXXXXXXXXXXXXXXXXXXXXXXXXXXXXXXXXXXXXXXXXXXXXXXXX-XXXXXXXXXXXXXXXXXXXXXXXXXXX--