----------------------------------------------------------------------------------------------------------------------------------------------------------------
----------------------------------------------------------------------------------------------------------------------------------------------------------------
----------------------------------------------------------------------------------------------------------------------------------------------------------------
---------------------------------------------------------------------------------------------------------------------------------------------------------------x
---------------------------------------------------------------------------------------------------------------------------------------------------------------X
---------------------------------------------------------------------------------------------------------------------------------------------------------------X
-----------------------------------------------------------------------------------------------------------------------------------E---E-----------------------X
---------------------------------------------------------------E--E--E--------SSSSS---------------------------------SSSQ--------SSSSSSSSSSSSS?QSS?SQSS?SS?SSS--X
--------------------------------------------------------------SSSSSSSSSS---------------------------------------------------------------------------------------X
-----------------------------------------------------------------------------------------------xxx-------------------------------------------------------------X
-------Q--------X-------------------------------Q---------X-E--E--E--E-----------------xxxxxxxxx--xx-----------------------------------E-----------------------X
----Q-E-----SSSSX---------------------QQ-------------xxx--XS?SSSSSSSSSSS---X----------xxXXXXXXXX--X-x------------------S-----------E---QQ?QSSSSSSSSSSSSSSSSSS--X
------E--------------xxx----------------xxx---------xxX-x---------------EE-X---------xxXXX--------XX-xx-------xxxx---------------------------------------------X
--------------------xxX-x--------------xxB-x-------xx-X--xSSSSSSSSSSSSSSSSSX-xxxxxx-xxXXX---------XXXX-xxxxxxxxxB-x-----------xxxx------------------------xxxxxX
xxxxxxxxxxxxxxxxxxxxx-X--xxxxxxxxxxxxxxx-b--xxxxxxxx--X---xxxxxxxxxxxxxxxxxxxx-----xxXXXX---------XXXXXXXXXXXXX-b--xxxxxxxxxxxx---xxxxxxxxxxxxxxxxxxxxxxxxx---xX
XXXXXXXXXXXXXXXXXXXXXXXXXXXXXXXXXXXXXXXXXXXXXXXXXXXX--XXXXXXXXXXXXXXXXXXXXXXXX----XXXXXXX---------XXXXXXXXXXXXXXXXXXXXXXXXXXXXX---XXXXXXXXXXXXXXXXXXXXXXXXX-X-XX