----------------------------------------------------------------------------------------------------------------------------------------------------------------
----------------------------------------------------------------------------------------------------------------------------------------------------------------
---------------------------------------------------------------------xxxxx--------------------------------------------------------------------------------------
----------------------------------------------------------xxxxxxxxxxxx----xxxxxxxxxxxxxxxxxxxxxxxxxxxxxxxxxxxxxxxxxxxxxxxxxxxxxxxxxxxxxxxxxxxxxxxxxxxxxxxxxxxxxx
----------------------------------------------------------SSSSSSSSSSSS----SSSSSSSSSSSSSSSSSSSSSSSSSSSSSSSSSSSSSSSSSSSSSSSSSSSSSSSSSSSSSSSSSSSSSSSSSSSSSSSSSSSSSS
-------------------------------------------------------xxxSSSSS-----------SSSS----------------------------------------------------------------------------------
------------------------------------------------------xx--SSSSS-----------SSSS----------------------------------------------------------------------------------
----------------xxx------------E---------------------xx---SSSSS-----------SSSS--------------E-------------------------------------------------------------------
---------------xx--x-----------------x--------------xx----S--------------------------------<>-------------------------------------------------------------------
------xxxx----xx----xx----------------x-----------xxx-----S--------------------------------[]------------E------------------------------------------------------
----oxx---xxxxx----XX-xxxx-xx----------xxx-------xxXXEXX---?oo----E---------E--------------[]-----------<>---------------------------------------------------XXX
---xx<>---XXXXX--------XX-xS-x---------<>-x-----xx-X-------??S---<>--------<>-------------?SSS--E----E--[]----------------------------------------X--XX---------
--xx-[]----------------XX-----x--------[]--x---xx----------------[]--------[]---E----E---------<>---<>--[]---------------------------------XXX------------------
-xx--[]----------------XXX-----x-------[]---xxxx-----------------[]--------[]--<>---<>---------[]---[]--[]---------------------------XX-------------------------
xx---[]----------------XXX------xxxxx--[]--XXXXX-----------------[]--------[]--[]---[]---------[]---[]--[]------------------------------------------------------
XX---XX--------------XXXXXXXX---XXXXXXXXXX----------------XXXXXXXXX---XXXXXXXXXXXXXXXXXXXX----XXX--XXX--XX------------------------------------------------------