----------------------------------------------------------------------------------------------------------------------------------------------------------------
----------------------------------------------------------------------------------------------------------------------------------------------------------------
----------------------------------------------------------------------------------------------------------------------------------------------------------------
---------------------------------------------------------------xxx----------------------------------------------------------------------------------------------
---------------------------------------------------------------XXX----------------------------------------------------------------------------------------------
---------------------------------------------------------------XXXXXXXX-----------------------------------------------------------------------------------------
---------------------------------------------------------------XXX----------XX----------------------------------------------------------------------------------
-----------------------------------------------------SS--------XXX----------[]---------------------------------------------------------------------------------X
---------------ooo---------------------------------------------XXX----------[]----------------------------------------------------------------------------------
---------------------------------------------------------------XXX----------[]----------------------------------------------------------------------------------
-----------xxxx------------------------------------xxxxxx------XXX----------<>SSSSSS--------------------------------------------------------------------Xxx-----
----------xx<>-x----------S?S-------------------xxxxXXXX-x-----XXX-----xx-------------B---xxxx---------------------------xxxx------------------------xxxxx------
--xxx----xx-[]--x----------------------------xxxxXXXXX----x----XXX>---<>-x---Exxx-----b--xx<>-x-------------------------xx---------------------xxxx--x-XXX------
-xxX----xx--[]------x----------------xxx--xxxxXXXXXX-------x---XXX]---[]--xxxxxE-xxxxxxxxx-[]--xxxxxx------------------xxX-------------xxx----xx<>-xxx----------
xx-X-xxxxE--[]---xxxxxxxxxxxxxxxxxxxxx--xxxXXXXXXX----------xxxXXX]---[XXXXXXX<>XXXXXXXXXXXXXXXXXXXXXxxxxxxxxxxxxxxxxxxx-X-E-xxxxxxxxxxx-Exxxxx-[]-XXX----------
XXXXXXXXXXXXXXXXXXXXXXXXXXXXXXXXXXXXXX--XXXXXXXX------XX--XXXXXXXXXXXXXXXXXXXX[]XXXXXXXXXXXXXXXXXXXXXXXXXXXXXXXXXXXXXXXXXXXXXXXXXXXXXXXX--XXXXXXXXX-------------