----------------------------------------------------------------------------------------------------------------------------------------------------------------
----------------------------------------------------------------------------------------------------------------------------------------------------------------
-----------------------------------------------------xxxxxxxxxxxxxxxxxxxxxxxxxxxxxxxxxxxxxxxxxxxxxxxxxxxxxxxxxxxxxxxxxxxxxxxxxxxxxxxxxxxxxxxxxxxxxxxxxxxxxxxx---
----------------------------------------------------xx-SSSSSSSSSSSSSSSSSSSSSSSSSSSSSSSSSSSSSSSSSSSSSSSSSSSSSSSSSSSSSSSSSSSSSSSSSSSSSSSSSSSSSSSSSSSSSSSSSSSSSS---
---------------------------------------------------xx-----------------------------------------------------------------------------------------------------------
----------------------------------------------xxxxxx------------------------------------------------------------------------------------------------------------
---------------------------------------------xxXXXXX------------------------------------------------------------------------------------------------------------
-----------------------------------xxxx-----xx------------------------------------------------------------------------------------------------------------------
----------------------------------xx---x---xx-------------------------------------------------------------------------------------------------------------------
---------------------------------xx-----x-xx--------------------------------------------------------------------------------------------------------------------
-------------------------E------xx-------xx------------------------------<>---<>---<>---<>---<>--------<>---<>---<>---<>---<>---<>---<>---<>---<>---<>---<>-----
---------------QQQQ-----<>-----xx-------XXX------------------------------[]---[]---[]---[]---[]--------[]---[]---[]---[]---[]---[]---[]---[]---[]---[]---[]-----
------------------------------xx-----------------------ooooooooooooooo---[]---[]---[]---[]---[]---oo---[]---[]---[]---[]---[]---[]---[]---[]---[]---[]---[]-----
---------------E-------------xx------------------------ooooooooooooooo---[]---[]---[]---[]---[]--ooo---[]---[]---[]---[]---[]---[]---[]---[]---[]---[]---[]--x--
xxxxxxxxxxxxxxxxxxxxxxxxxxxxxxX------------------------XXXXXXXXXXXXXXX---[]---[]---[]---[]---[]--XXX---[]---[]---[]---[]---[]---[]---[]---[]---[]---[]---[]---xx
XXXXXXXXXXXXXXXXXXXX<>XXXXXXXXX------------------------XXXXXXXXXXXXXXX---[]---[]---[]---[]---[]--XXX---[]---[]---[]---[]---[]---[]---[]---[]---[]---[]---[]---XX