----------------------------------------------------------------------------------------------------------------------------------------------------------------
----------------------------------------------------------------------------------------------------------------------------------------------------------------
----------------------------------------------------------------------------------------------------------------------------------------------------------------
--------------------------------------XXX-----------------------------------------------xxx---------------------------------------------------------------------
-------------------------------------[]]------------------------------------------------XXX---------xxx---------------------------------------------------------
-------------------------------------[]]----xxxx----------------------------------------XXX--------xx--x--------------------------------------------------------
-------------------------------------[>>----XXX-x---------------------------------------XXX--------EX---x-------------------------------------------------------
-------------------------------------<------EXX--x---E----------------------------------XXX--------------x-------xxXXXXXXXXXXXXXX-------------------------------
--------------------------------------EE----XXX---x-------------------------------------XXX-------------oox-----xx----------------------------------------------
------------------------ooooooo-------------XXX--E-x------------x-----------------------XXX----------------x---xx-----------------------------------------------
--------------------------xx--------xxxxx---XXX-<>--x-------xxxx-x-----o----------------XXX-----------------x-xx------------------------------------------------
--------------xxxxxxxx---xx-x------xx-------XXX-[]---x-----xx-XX--x---------x-----------XXX------------------xx--------------------------------Q----------------
-------------xxXXXXXX-x-xx---x----xx----<---XXX-[]----x---xx--XX---x-------xx----------xXXX------------------<>-------------------------------------------------
--------xx--xx---------xx-----xxxxx-----[---XXX-[]-E---xxxxX------X-xxxx--xx----------xxXXX------------------[]-------xxx-xxx-xxx------------------------------E
xxxxxxxxxExxx----------<>-----XXXXXX----[xxxXXXXXXXXXXXXXXXX---------x--xxx------xxxxxx-XXXxxxxxxxx----------[]E---xxxx--xx--xx--xxxxxxxxxxxxxxxxxxxxxxxxxxxxxxx
XXXXXXXXXXXXX----------[]---------------[XXXXXXXXXXXXXXXXXXX---------X--XXXXXXXXXXXXXXXXXXXXXXXXXXX-----XXXXXXXXXXXXXXX--XX--XX--XXXXXXXXXXXXXXXXXXXXXXXXXXXXXXX