----------------------------------------------------------------------------------------------------------------------------------------------------------------
----------------------------------------------------------------------------------------------------------------------------------------------------------------
----------------------------------------------------------------------------------------------------------------------------------------------------------------
----------------------------------------------------------------------------------------------------------------------------------------------------------------
------------------------------------------------------------------SSSSSSSSSS------------------------------------------------------------------------------------
----------------------------------------------------------------------------------------------------------------------------------------------------------------
--------------------------------------X------------------------------------------------------------------------------------------------------------------------o
----------------XXX---XX---XX---oo------------------------------------------------------------------------------------------------------------------------------
----------------------------------------------------------------------------------------------------------------------------------------------------------------
----------------xxx--xxx--xxx--xxx--xx------X------------------------------------------------------------------------------xxxxxx-------------------------------
----------xxxxxxx--xxx--xxx--xxx--xxx-x----------------oooo--------------xxxxx--oooo-X-----------------------------------xxx--x--xxX----------------------------
---------xxXXXXXX-XXXX-XXXX-XXXX--XXX--x----------XXX-XXXXXX------------xxXXX--XXXXXX----------------xxxx---------------xxXX--X--XX-----------------------------
--------xxXXX---------------------------x------------------------------xxEXXX-----------------------xx<>-x------xxx----xxXXX--X---------------------------------
-----xxxxXXX-----------------------------x----------------------------xxXXXXX----------------------xx-[]--xxxxxxx--xxxxxXXXX--X---------x------------xxxxx------
xxxxxxXXXXXX----------------------------------------------------xxxxxxxXXXXXX-----------xxxxxxxxxxxxXXXXXXXXXXXXX--XXXXXXXXX--X----------xxxxxxxxxxxxx----xxx---
XXXXXXXXXXXX-----------------------------------------------XXXXXXXXXXXXXXXXX--------XXXXXXXXXXXXXXXXXXXXXXXXXXXXX--XXXXXXXXX--X------XXXXXXXXXXXXXXXXX---XXXX---