----------------------------------------------------------------------------------------------------------------------------------------------------------------
--------------------------------------------xx------------------------------------------------------------------------------------------------------------------
------------------------------------------xxx-xx-------------------------------------------------xxxx-----------------------------------------------------------
-----------------------------------------xxx----x-----------------------------------------------xx---x-----------------------xxxxxxxxxxxxxxxxxxxxxxxxxxxxxxxxxxx
--------------------------xxxxx---------xx-------xx--------------------------------------------xx-----x---xxx------------x--xxSSSSSSSSSSSSSSSSSSSSSSSSSSSSSSSSSS
------------------------xxx----xxxxxxxxxx----------xxxxx------o-----------------------------xxxx------E-xxx--xxxxxxxxxxxx-xxx-----------------------------------
-----------------------xx<>----SSSSSSSSS-----------XXXX-x------oo-oo-----------------------xxXXX-------xx<>--XXXXXXXXXXXX-XXX-----------------------------------
--------x-------?-----xxX[]-------------S----------------xoo-----------------------xxx----xx-----------xX[]-----------------------------------------------------
---------x------------xXX[]-------------------------------x--xx---------xxxxxxxxxxxx--x--xx------------XX[]-----------------------------------------------------
----------x-----xx---XXXX[]--------------------------------xxx-x-------xxXXXXXXXXXXX---xxx-------------XX[]-----------------------------------------------------
----xxxx---x-xxxx---XXXXX[]----------<E-------XX-----------XXX--xxx---xx---------------XXXX------------XX[]-----------------X-----------------------------------
---xxXSSS---xx--S--XXXXXX[]----------[>-------------------------XX-x-xx---------------E----------------XX[]------------------------------------XXXXXX----E------
--xx-X------<>----XXXXXXX[]----------[]-----------------------------xx---------------<>----------------XX[]---------------------XXX---------------------<>-<>---
-xx--X------[]---XXXXXXXX[]----------[]----------------------------XXXX--------------[]----------------XX[]---------------------------------------------[]-[]---
xxE-EX------[]E--XXXXXXXXXXXXXXXXXXXXX]-XXX------------------------------------------[]----------------XXXXX--------------------------------------------[]-[]---
XXXXXXXXXXXXXXXXXXXXXXXXXXXXXXXXXXXXXXXXXXX------------------------------------------[]----------------XXXXX------------------------------------------XXXX-XX---