----------------------------------------------------------------------------------------------------------------------------------------------------------------
----------------------------------------------------------------------------------------------------------------------------------------------------------------
----------------------------------------------------------------------------------------------------------------------------------------------------------------
-----------------------------------------------------------------------------------------------------xxx--------------------------------------------------------
-----------------------------------------------------------------------------------------------------XXX--------------------------------------------------------
---------------------------------------------------------------------------------------------------XXXXX--------------------------------------------------------
--------------------------------------------------------------------------------------------------XX-XXX-------------------ooo---------------------------------x
-------------------------------------------SSSSSS---------------SSSSSS------S--------------------XXX-XXX-------------------ooo------xxxxxxS-------SSSSS---------
------------------------------------------------------------------------------------------------XXXX-XXX----------------xx---------xx----xxx--------------------
-----------------------------------------------------------------------------------------------XXXXX-XXX-------------xxxx-xxxxx---xx--------x-xxx---------------
-------------------X-----------Q--------------------------------------------------------------XXXXXX-XXX------------xx--E--x---xxxx------E-EExx--xx--------oo---
---------QQ------QQX--------Q-E---------------------------------------------S-----------------XXXXXX-XXX-----------xx-XXX-XX--XXXXX----------XX-XX-xxx--------x-
------------------------------E----------------------------------------------------xxxx-------XXXXXX-XXX------xxx-xx----------X--------------XX-XX-XX-x------xx-
------------------------------------------xxxxxxx----xxx-------xxxxxxx------------xx<>-x------XXXXXX-XXX-xxxxxx--xx-----------X--------------XX-XXXXX--x----xx--
xxxxxxxxxxxxxxxxxxxxxxxxxxxxxxxxxxxxxxxxxxx------xxxxx-Exxxxxxxx------xxxxxxxxxxxxx-[]--xxxxxxXXXXXX-XXXxx--XXX--<>-----------X--------------X--XXXXX--Exxxxx---
XXXXXXXXXXXXXXXXXXXXXX<>XXXXXXXXXXXXXXXXXXX------XXXXX--XXXXXXXX------XXXXXXXXXXXXXXXXXXXXXXXXXXXXXXXXXXXX----X--[]-----------X--------------X--XXXXXXXXXXXXXXXX