----------------------------------------------------------------------------------------------------------------------------------------------------------------
----------------------------------------------------------------------------------------------------------------------------------------------------------------
--------------------------------------xx---------xxx------------------------------------------------------------------------------------------------------------
----------------------------------------x-------xx--x---------------------------------------------------------------------------xxx-----------------------------
-------------------------------------x---x-----xx----x-------------------------------------------------------------------xxx---xx--x----------------------------
----------------------------xxx---xxxx---E----xx-----Ex-----------------------------------------------------------------xx--x-xx----x-------------X-------------
------------------E------------x-xx--X-------xx--------x------------------------------------------------E---E-E------E--xX---xx------x-------------X------------
-SSS-------------SSSSQ----------xx--------x--xS---------x----X-------------------------------S--SSS-----S--<><>--------xx----XX-------x-------------------------
---------------------------------E---------x-x-----------xxxx----------------------------------------------[][]--------x-------------oox--------E----------o----
--------------------------------->----------xx------------x--x------------X-----------------------------?--QQQQ------xxx----------------x---XXXXXX--------------
----------xxx-------------------X]-----------x------------?---x-------X--XX-------------E--------E------------------xx<>-----------------x--xxxxx----XXX--------
---------xxX-x-------S-----x---XX]-----------SS-------------E--x--------XXX------------<>----S--SSS----xxx---------xx-[]------------------xxx----x--------------
--------xx-XX-x----------xxx--XXX]--------------------------S---x------XXXX--E------------------------xxX-x-------xx--[]------------------XXX-----x-----------xx
xxxx----x-EXXX-x--------xx<>-XXXX]-----------------------X-------x----XXXXX--------------------------xx-X--xxxxxxxx---[]---------------------------x--xxxxxxxxx-
x---xxxx---XXXX-xxxxxxxxx-[]XXXXXXXXXX-------------------XX--SSS---XXXXXXXXxxxxxxxxxxxxxxxxxxxxxxxxxxx--X--XXXXXXXXXXXXX----------------------------xxx---XXXXXE
X---XXXX--XXXXXXXXXXXXXXXXXXXX-XXXXXXX----XXXXX----------XX----XX--XXXXXXXXXXXXXXXXXXXXXXXXXXXXXXXXXXXXXXX-XXXXXXXXXXXXX-------------XXXX-----------XXX---------