----------------------------------------------------------------------------------------------------------------------------------------------------------------
----------------------------------------------------------------------------------------------------------------------------------------------------------------
----------------------------------------------------------------------------------------------------------------------------------------------------------------
----------------------------------------------------------------------------------------------------------------------------------------------------------------
-------------------------------------------------------------------------------------------------------------------x-------------------------oo-----------------
--------------------------------------------------------------------------------------------------------------------x-----------------?-----XXXX----------------
---------------------------------------------------------SSS---------------------------------------------------------x-----?-----oo-----------------------------
--------QX------------S-----------------------------------------SSSSSSSS------S------------E----------------XXXXXX----x---------XXXX----------------------------
---------X-------------------------------------------------------------------------------------------------------------x---E------------E--------XXXXX----------
---------X-----------------------------------------------X--------------------------------------------------------------xxxx--------XXXXXX----xxxx--------------
---------X---------o--------------xxxxx------------------XEE---------xxxx---------------------------------------------------x----------------xx---x------------x
------QQQX----------------------xxx----x-----------Q-----XSSSSSQ----xx--xxx-QQQ-xxx------------------------------------------x-xxxxx-----oooxx-----x---------xxx
---------------------xxxx------xx<>-----xx-------------------------xx------x---xx--xx-------------x---------------------------xx----xxxxxxxxx-------x---------x-
------E--E----------xx<>-x----xx-[]----<>-x--xxx------------------xx--------x-xx---X-xxxxxxxxxxxxxx--------------------------XXX---XXXXXXXXXX--------x--------B-
xxxxxxxxxxxxxxxxxxxxx-[]--xxxxx--[]-E--[]--xxx--xxxxxxxxxxxxxxxxxxx----------xx----XXXXXXXXXXXXXXXX---------------------------------------------------xxxxxxxXX-
XXXXXXXXXXXXXXXXXXXXXXXXXXXXXXX--XXXXXXXXXXXXX--XXXXXXXXXXXXXXXXXXX------XXXXXX----XXXXXXXXXXXXXXXX----------------XXXXX-----------------------------XXXXXXXXXX-