----------------------------------------------------------------------------------------------------------------------------------------------------------------
----------------------------------------------------------------------------------------------------------------------------------------------------------------
-----------------------------------------------------------------------------------------------------------xxxxx---------------xxxxx----------------------------
-----------------------------------------------xxxxxxxxxxxxxxxxxxxxxxxxxxxxxxxxxxxxxxxxxxxxxxxxxxxxxxxxxxxxx----xxxxxxxxxxxxxxxx----xxxxxxxxxxxxxxxxxxxxxxxxxxxx
---------------------------------------xx-----xxSSSSSSSSSSSSSSSSSSSSSSSSSSSSSSSSSSSSSSSSSSSSSSSSSSSSSSSSSSSS----SSSSSSSSSSSSSSSS----SSSSSSSSSSSSSSSSSSSSSSSSSSSS
------------------------------x--x----xx-xxxxxx-----------------------------------------------------------------SSSS----------------SSSS------------------------
-------------------------xxxxx-xx-x--xxX-XXXXXX-----------------------------------------------------------------SSSS----------------SSSS------------------------
------------------------xxXXX--XX--x-xx-------------------------------------------------------------------------SSSS----E-----------SSSS----E-------------------
-----------------------xx-XXX--XX---xx---------------------------------------------------------------------------------<>------------------<>-------------------
----------------------xx-XXXX--XX----x-------------------------------E-------------------------------------------------[]------------------[]-------------------
---------------------xxXXXXXX--XX---->--------X--------------E---E--<>--------E-----XXX------------XXX------------E----[]-------------E----[]-------------------
--------------E-----xxXXXXXXX--XX----]----------------------<>--<>--[]-------<>----------------------------------<>---?SSS--E--------<>---?SSS--E---------------
----------xxx------xxXXXXXXXX--XX----]----------------------[]--[]--[]-------[]----------------------------------[]--------<>--------[]--------<>-----XXX---XXX-
------B--xxB-x----xxXXXXXXXXX--XX----]----------------------[]--[]--[]-------[]----------------------------------[]--------[]--------[]--------[]---------------
xxxxxxxxxx-b--xxxxxXXXXXXXXXX--XX---XX----------------------[]--[]--[]-------[]----------------------------------[]--------[]--------[]--------[]---------------
XXXXXXXXXXXXXXXXXXXXXXXX-XXXXX-XX---XX----------------------XXXXXX--XX-------XX-------------------------X---XXXXXXXXXX----XXX---XXXXXXXXXX----XXX---------------