----------------------------------------------------------------------------------------------------------------------------------------------------------------
----------------------------------------------------------------------------------------------------------------------------------------------------------------
------------------------xxxxxxxxxxxxxxxxxxxxxxxxxxxxxxxxxxxxxxxxxxxxxxxxxxxxxxxxxxxxxxxxxxxxxxxxxxxxxxxxxxxxxxxxxxxxxxxxxxxxxxxxxxxxxxxxxxxxxxxxxxxxxxxxxxxxxxxx
-----------------xxxxxxxSSSSSSSSSSSSSSSSSSSSSSSSSSSSSSSSSSSSSSSSSSSSSSSSSSSSSSSSSSSSSSSSSSSSSSSSSSSSSSSSSSSSSSSSSSSSSSSSSSSSSSSSSSSSSSSSSSSSSSSSSSSSSSSSSSSSSSSS
---------------xxxSSSSSS----------------------------------------------------------------------------------------------------------------------------------------
------------xxxxSS----------------------------------------------------------------------------------------------------------------------------------------------
------------xSSS------------------------------------------------------------------------------------------------------------------------------------------------
------------x---------------------------------------------------------------------------------------------------------------------------------------------------
-----------xx---------------------------------------------------------------------------------------------------------------------------------------------------
----------xxS---------------------------------------------------------------------------------------------------------------------------------------------------
--------xxx--------XXX---<>---<>---<>---<>---<>--------<>---<>---------------------------<>---<>----------<>---<>---<>---<>---<>---<>---<>---<>---<>---<>---<>--
-------xx<>--------------[]---[]---[]---[]---[]----S---[]---[]---------------------------[]---[]----------[]---[]---[]---[]---[]---[]---[]---[]---[]---[]---[]--
------xx-[]-----X--------[]---[]---[]---[]---[]----S---[]---[]--oooooooooooooooooooooo---[]---[]--ooooo---[]---[]---[]---[]---[]---[]---[]---[]---[]---[]---[]--
-----xx--[]----XX--------[]---[]---[]---[]---[]----S---[]---[]--oooooooooooooooooooooo---[]---[]--ooooo---[]---[]---[]---[]---[]---[]---[]---[]---[]---[]---[]--
xxxxxx---[]---XXX--------[]---[]---[]---[]---[]----S---[]---[]--XXXXXXXXXXXXXXXXXXXXXX---[]---[]--XXXXX---[]---[]---[]---[]---[]---[]---[]---[]---[]---[]---[]--
XXXXXXXXXXXXXXXXX--------[]---[]---[]---[]---[]----S---[]---[]--XXXXXXXXXXXXXXXXXXXXXX---[]---[]--XXXXX---[]---[]---[]---[]---[]---[]---[]---[]---[]---[]---[]--