----------------------------------------------------------------------------------------------------------------------------------------------------------------
----------------------------------------------------------------------------------------------------------------------------------------------------------------
----------------------------------------------------------------------------------------------------------------------------------------------------------------
--------------------------------------------------S-------------------------------------------------------------------------------------------------------------
-------------------------------------------------------------------------------------------xxx--------------------------------------------------------S---------
----------------------------------------------------------------------------------------xxxx--x-----------------------------------------------------------------
------------------------------------------------XXXX-----------------------------------xxXXX---x----------------------------------------------------------------
------------------------------------------------XXX----------xx------------------E----xx--------x------------------------------------------------SSSSSS---------
------------------------------------------------------------xx-x---------------------xx--------oox--------------------------------------------------------------
-----------------------------ooo------------xx-------------xx---x----------------xx-xx------------x-------------------------------------------------------------
------xo----QQQQQQQQQQQQ-----ooo-----------xx-x----------xxx-----x--------------xx-xx--------------x--SSSSSS?----------------------------Q----------------------
-----xx-----------------------------------xx---x--------xxXX------x------E-----xx--XX---------------x---------------------------------Q-E-------xxxx------------
----xxE---------------E------------------xx-----xx-----xxXXXX------xxxxxxxxxxxxx---------------------x------------------xxx-------------E------xx---x-----------
---xx-Xxx--xxxxxxxxxxxxxxxxxxxxxxxxxxxxxxx-----XX-xxxxxxXXXXXX----XXXXXXXXXXXXXX----------------------x-----------Exx--xxB-x------------------xx-----x----------
xxxx--X--xxXXXXXXXXXXXXXXXXXXXXXXXXXXXXXXX-----XXXXXXXXXXXXXXXX---X------------------------------------xxxxxxxxxxxxx-xxx-b--xxxxxxxxxxxxxxxxxxx-------xxxxxxxxxx
XXXX--X--XXXXXXXXXXXXXXXXXXXXXXXXXXXXXXXXX-----XXXXXXXXXXXXXXXXX--X----------------------------XXXXX--XXXXXXXXXXXXXX-XXXXXXXXXXXXXXXXXXXXXXXXXX------XXXXXXXXXXX