----------------------------------------------------------------------------------------------------------------------------------------------------------------
----------------------------------------------------------------------------------------------------------------------------------------------------------------
----------------------------------------------------------------------------------------------------------------------------------------------------------------
----------------------------------------------------------------------------------------------------------------------------------------------------------------
----------------------------------------------------------------------------------------------------------------------------------------------------------------
-----------------------------------------------------------------------------------------------------------------------E----------------------------------------
------------------------------E-----------------------------------------------------xx--E---E-E--?------------------SSSSSSSSSSSSSSSSSSSSSSSSSSSSSSSS------------
---------------------------SSSSS-----------------Q------------XX-------------------xxX--S--<><>--E--------------------------------------------------------------
----------------------------------------------------------------------------------xx-X-----[][]-----E-------------------------------------------------------E--x
---------------------------------------------------------------------------------xx--X--?--QQQQ----<>----EE--------------E---E---E---E----E---E-------xxxxxxxxxx
--------------------------------------------------------------------------------oxXX-X-------------[]----<>---------SSSSSS?SSS?SSS?SSS?SSSS?SSSSSSSS-xx-XXXXXXXX
----S-----------------------SSSS----XXXX--SQ-----Q------------------E----------xxXXX-X-xxx---------[]----[]-----------------------------------------xx----------
-E-------------------xxxx-----------------E-------------------------E-xxx-----xx-XXX-XxxX-x--------[]----[]----------------------------------------xx-----------
--------------------xx<>-x----------xxx--------------xxx-------------xxX-x---xx--XXX-Xx-X--xxxxxxxx[]----[]-----xxxxxxxxxxxxxxxxxxxxxxxxxxxxxxxxxxxx------------
xxxxxxxxxxxxxxxxxxxxx-[]--xxxxxxxxxxx--xxxxxxxxxxxxxxx--xxxxxxxxxxxxxx-X--xxxx---XXX-X--X--XXXXXXXXXX--XXXXXXXXXxXXXXXXXXXXXXXXXXXXXXXXXXXXXXXXXXXXX------------
XXXXXXXXXXXXXXXXXXXXXXXXXXXXXXXXXXXXX--XXXXXXXXXXXXXXX--XXXXXXXXXXXXXXXXXXXXXX---XX--XXXXX-XXXXXXXXXX--XXXXXXXXXXXXXXXXXXXXXXXXXXXXXXXXXXXXXXXXXXXXX------------