----------------------------------------------------------------------------------------------------------------------------------------------------------------
----------------------------------------------------------------------------------------------------------------------------------------------------------------
----------------------------------------------------------------------------------------------------------------------------------------------------------------
------------------------------------------xxx-------------------------------------------------------------------------------------------------------------------
------------------------------------------XXX-------------------------------------------------------------------------------------------------------------------
------------------------------------------XXX-------------------------------------------------------------------------------------------------------------------
------------------------------------------XXX-------------------------------------------------------------------------------------------------------------------
------------------------------------------XXX------------S-?-------------------------------------Q---------------------------------------------------------X--EX
------------------------------------------XXX-----S--------------------------------------------------------------------------------------------------------X---X
------------------------------------------XXX----------------------------------------------------------------------------------------------------X-EE----X-X---X
----------------------------xxxx-?--------XXX----------------------------------------------------------------------------------------------------XSSSSSSS--XSS?X
---------------------------xx<>-x---------XXX-----------xxxx------------------------------------QQ-----------------------E--SS----------------------------------
--------------------------xx-[]--x--------XXX-xxxxxx---xx<>-x---------------------B---------------------------B---------<>-------------------xxx----------------
---x----xxxxxxxxxxxx-----xx--[]---x-------XXXxxE--X-x-xx-[]--x--xxxxxx---xxxxxx---b-------xxx-----------------b---B-------------------xxx---xx--xxxxxxxxxxxxxxxx
xxxx-XXXxXXXXXXXXX--xxxxxxE--[]----xxxxxxxXXXX<>--X--xx--[]---xxx--EE-xxxx--EE-xxxxxxxxxxxx--xxxxxxxxxxxxxxxxxxxxxxxxxxxxxxxxxxxxxxxxxxE-xxxxX--XXXXXXXXXXXXXXXX
XXXX-XXXXXXXXXXXXX--XXXXXXXXXXXXXXX<>XXXXXXXXX[]--X--XXXXXXXXXXXX--XXXXXXX--XXXXXXXXXXXXXXX--XXXXXXXXXXXXXXXXXXXXXXXXXXXXXXXXXXXXXXXXXXXXXXXXX--XXXXXXXXXXXXXXXX