----------------------------------------------------------------------------------------------------------------------------------------------------------------
----------------------------------------------------------------------------------------------------------------------------------------------------------------
----------------------------------------------------------------------------------------------------------------------------------------------------------------
----------------------------------------------------------------------------------------------------------------------------------------------------------------
----------------------------------------------------------------------------------------------------------------------------------------------------------------
-------------------------------------------------------------------------------------------------------------------------------------------------------------xxx
--------------------------------------------------------------------E---xxx------------------E--------------------------------------------------------------xx--
----------------------------------SQSS------xx------E---XXXX--------xxxxx--xxxxS-------SSS--SQSSSSSSSSSSSSSSSSSSS---------------------------------xxxxxx---xx---
-------------------------------------------xx----------------------xx-XXX-----xxx----------------------------------------------------------------xx-XXX-x-xx----
------------------------------------------xx--x-----xx-xxxxx------xx-------------x-xxx----------------------------------------------------------xx--oo---xx-----
-----------------------------------------xx----x---xx-xx----xxxxxxx-----------E-EExx--xx-----------------------------------------------xxxxxxxxxx-------XXX-----
------Q---------------------------S?SS-xxx------x-xx--XX---XXXXXXXX---------------XX-XX-x---SQ-------------------------------xxx------xxXXXXXXXXX---------------
--------------------------------------xx<>-------xx-------------------------------XX-XX--x----------------------------x------xB-x----xxXXX----------------------
------------------xxx----xxxxxx------xx-[]------XXX-------------------------------XX-XXX--x------xxxxxxxxxxxxxxxx------x----xxb--x--xxXXX-----------------------
xxxxxxxxxxxxxxxxxxx--xxxxx--EE-xxxxxxx--[]E---------------------------------------X--XXX--Exxxxxxx---------------xxxxx-Exxxxx-BEE-xxxXXXX-----------------------
XXXXXXXXXXXXXXXXXXX-XXXXXX-XXXXXXXXXXXXXXXXXXX----------XXXX----------------------X--XXXXXXXXXXXXX---------------XXXXXXXXXXXXXXXXXXXXXXXX-----------------------