----------------------------------------------------------------------------------------------------------------------------------------------------------------
----------------------------------------------------------------------------------------------------------------------------------------------------------------
--------------------------------------------------------------------------------------------------------------------------------------x-------------------------
----------------------------------------------------------------------------------------------------------------------------------xxxxx-------------------------
----------------------------------------------------------------------------------------------------------------------------------XXXXX-------------------------
----------------------------------------------------------------------------------------------------------------------------------XXXXX-------------------------
-------------x----------------------------------------------------------------------------------------------xx--------------------XXXXX-------------------------
--------------x--------------------------------------------------------------------------SSSSSSSSSSSSSSS----X-x-------------------XXXXX------------------S------
---------------x---E------------------------------E---------------------------------------------------------X--x------------------XXXXX-------------------------
----------------x--------------------------------------------xxxx--xxxx-xxxxxx------------------------------X---x-----------------XXXXX-------------------------
-----------------xx-----------------------------------------xxX--xxx---xx--<>-x-----------------------------X----x---------------oXXXXX-------------------------
----------------XX-x-xxxx----------------------------------xx-X--XXX--XXX--[]--x----------------------------X-----x---S-----------XXXXX--SSSSSQ---------xxxx----
--------------------xx---x-----xxx------------------------xx--X--XX---XX---[]---x---------------------------X------x--------------XXXXX----------------xx<>-x---
---xxx--------------XX----xxxxxx--x---xxxxx-----xxxxxxxxxxx--EX------------[]----x---------xxxxxxxxxxxxx----X-------x----xxx-xxxxxXXXXXx--------------xx-[]--x-x
xxxx--xxxxxxx------------XXXXXXX---xxxx-EE-xxxxxXXXXXXXXXXXXXXX------------[]-----xxxxxxxxxx------------xxxxX-------ExxxxxE-x--x--XXXXX-xxxxxxxxxxxxxxx--[]---xx
XXXX--XXXXXXX------------------X--XXXXX-XXXXXXXXXXXXXXXXXXXXXXX------------XXXX---XXXXXXXXXX------------XXXXXXXXXXXXXXXXXXXXX-XX--XXXXXXXXXXXXXXXXXXXXXXXXXXXXXX