----------------------------------------------------------------------------------------------------------------------------------------------------------------
----------------------------------------------------------------------------------------------------------------------------------------------------------------
----------------------------------------------------------------------------------------------------------------------------------------------------------------
-----------------------------------xxxxxxxxxxxxx----------------------------------------------------------------------------------------------------------------
-----------------------------------XXXXXXXXXXXXX----------------------------------------------------------------------------------------------------------------
-----------------------------------XXXXXXXXXXXXX----------------------------------------------------------------------------------------------------------------
-----E-----------------------------XXXXXXXXXXXXX-------------------------------------------oo------------------------------------------------E------------------
-SSSSSS----------------------------XXXXXXXXXXXXX--------------SSSSSSSS---------------xx----------------xxxE------------------XX-----------SSSSS--SSS------------
-----------------------------------XXXXXXXXXXXXX---------------------------------------x---------xxxxxxx--x-----------------------------------------------------
---------------------------E-------XXXXXXXXXXXXX-----------------------E----------------x-------xxXXXXXX---x------xxx------------------------------------x------
--E-------------------------------oXXXXXXXXXXXXX---------------E---E----XXXXXXXXXXXXX----xx----xx-----------xxxxxxx--xx--------x-----------------------xxxx-----
SSSSSSS--QQ--------------S?QS----xxXXXXXXXXXXXXX----S---------SSSSSSSS------------------XX-x--xx------------XXXXEXX--X-x--------x----------SSSS--SSS-xxx<>-x----
---------------xxx--------------xx-XXXXXXXXXXXXX--E-----------------------------------------xxx-------------------X--XX-x--------x------------------xx<>[]X-x---
--------------xxX-x------------xx--XXXXXXXXXXXXX----xxx-----------xxx-----------------------XXXX------------------X--XXX-x--------x----------------xx-[][]XX-x--
xxxxxxxxxxxxxxx-X--xxxxxxxxxxxxx---XXXXXXXXXXXXXxxxxx--xxxxxxxxxxxx--xx----------------------------------ooo------X--XXXX-xxxxx----xxxxxxxxxxxxxxxxx--[][]XXX-xx
XXXXXXXXXXXXXXXXXXXXXXXXXXXXXXXX---XXXXXXXXXXXXXXXXXX--XXXXXXXXXXXX--XX----------------------------------XXX------X--XXXXXXXXXXXXXXXXXXXXXXXXXXXXXXXXXXXXXXXXXXX