----------------------------------------------------------------------------------------------------------------------------------------------------------------
----------------------------------------------------------------------------------------------------------------------------------------------------------------
----------------------------------------------------------------------------------------------------------------------------------------------------------------
---------------------------------------x----------------------x-------------------------------------------------------------------------------------------------
-------------------------------------x--xx----------x------xxx-x---------------------------------------------------------------------------------------------xxx
-------------------------------------xx<>-xxxxxxxxxx-xxxxxxx----x-----------------------------------------------------------------------------------------xxxx--
------xxx--------------------------xxX-[]-XXXXXXXXXX-XXXXXXX-----x--------------------------------------------------------------XX-----------------------xxXXX--
-----xxX-x--------------XXX-------xxXX-XX-------------------------x-------------------------------------------------------------------------------------xx------
----xxXX--x----------------------xx-XX---------------------------oox----------------------------------------------------------E----------o-------------xx-------
---xxXXX---x----xxxxx-xxxxx-----xxXXXX------------------------------x-----------------------------------------------------XXXXXX--------------------xxxx--------
---xXXXX----x--xx----xx----x---xxXXXXX-------------------------------x----------------------------------------------------xxxxx----XXX-------------xx--X--------
---XXXXX-----xxx----XXX-----xxxxXXXXXX--------------------------------x----------------------QQ------------xxx-------xxxxxx----x------------------xx-XXXX-------
---XXXXX------x----------------XXXXXXX---------------------------------x----------------------------------xxX-x-----xxXXXXX-----x----------------xx-------------
---XXXXX------B---------------XXXXXXXX----------------------------------x----xxx-------------------------xx-X--xxxxxx------------x--xxxxxxxxxxxxxx--------------
xxxXXXXXXXXXXXX--------------XXXXXXXXX-----------------------------------xxxxxE-xxxxxxxxxxxxxxxxxxxxxxxxxx--X-XXXXXXX-------------xxx---XXXXXXXXXX--------------
XXXXXXXXXXXXXXX--------------XXXXXXXXX---------------------------XXXXX---XXXXXXXXXXXXXXXXXXXXXXXXXXXXXXXXXXXX-X-------------------XXX---------------------------