----------------------------------------------------------------------------------------------------------------------------------------------------------------
----------------------------------------------------------------------------------------------------------------------------------------------------------------
----------------------------------------------------------------------------------------------------------------------------------------------------------------
----------------------------------------------------------------------------------------------------------------------------------------------------------------
----------------------------------------------------------------------------------------------------------------------------------------------------------------
----------------------------------------------------------------------------------------------xx----------------------------------------------------------------
-----------------------------------------------------X----------------------SSE---------xxxxxxx----------------------E----------E----------------E--------------
---------------------SSSSSSSSS------------------------X-------------SSSSS-----SS--------xXXXXXX----E---------------SSSSSQ-------S--------------SSSSSSSSSSS------
----------------------------------------------------------------S-----------------------XXXXXXX-----------------------------------------------------------------
----------------------------------------------------------------------------------------XXXXXXX------------xxx------------------?-------------------------------
-------------xxxx-----------------------------------------------E------------E---------oXXXXXXX----------xxx--xx---------------------------------E--------------
------------xx<>-x-QQQQ--------------------------------xx------------SSSSSSSSSSS--------XXXXXXX---------xxXX--X-x-------S-Q----xxx---------------QQ?QS-SSS------
-----------xx-[]--x------------------------------------>-x--xxxxxx----------------------XXXXXXX--------xxXXX--XX-x------------xxX-xx-----xxxx---------------xxxx
----------xx--[]---x-----xxxxx--------------B----------]--xxxE--X-x------------------xxxXXXXXXX-xxxxxxxxXXXX--XXX-x----------xx-X---x---xx<>-x---------xxxxx<><>
xxxxxxxxxxxE--[]----xxxxxx----xxxxxxxxxxxxxxxxxxxxxxxxxXXXXX<>--XX-xxxxxxxxxxxxxxxxxxx--XXXXXXX-XXXXXXXXXXXX--XXXX-xxxxxxxxxxxE-X----xxxx-[]--xxxxxxxxxx---x[][]
XXXXXXXXXXXXXXXXXXXXXXXXXX----XXXXXXXXXXXXXXXXXXXXXXXXXXXXXX[]--XXXXXXXXXXXXXXXXXXXXXX--XXXXXXXXXXXXXXXXXXXX--XXXXXXXXXXXXXXXXXXXX-XXXXXXXXXXXXXXXXXXXXX-X-XXXXX