----------------------------------------------------------------------------------------------------------------------------------------------------------------
----------------------------------------------------------------------------------------------------------------------------------------------------------------
----------------------------------------------------------------------------------------------------------------------------------------------------xxx---------
---------------------------------------------------------------------------------------------------------------------------------------------------xx--x--------
----------------------------------------------------------------------------------------------------------------------------------------oo--------xx----x-------
------------------------------------------------------------------E-----------------------------------------------------------------------xxxxxxxxx-----E-------
--------------------------------------------------------------------------------o-----------------------------------------------o--------xxXXXXXXXX-------------
-----Q---------XX---------------------------------------------------------------------------------------------E-----------------XX------xx----------------------
-----------------------------------------------------------------------------------------XXoo------------------------------------------xx---------------------S-
-------------------------------xxx------------------------------X-----------------------------------E-----xxxxx-------------------xxxxxx------------------------
-------------------------------xx-x----------------------------X---------ooooo---------------------<>----xxXSS-x-------------xxxxxx---XXXXX-------------------ES
-----Q--------------------S----x---xxx-----------------------------XXX--XXXXXXX----X--X--------XX--[]---xxXX----x-----------xxXXXXX---------------------------S-
------------------------E-----x----<>-x--------------------------------------------X---------------[]--xxXXX-----x---------xx-----------------------------xxxx--
--------xxxx--------------xxxxxx---[]--x-----x-------xxxx--xxx---------------------X---------------[]--xXXXX------x-------xx--------o--------------------xxE--x-
xxxxxxxxxEE-xxxxxxxxxxxxxxx--x-X---[]---xxxxx-xxxxxxxx---xxx--x--------------------X---------------XXXXXXXXX-------xxxxxxxx--------XXX-------------------X<>---x
XXXXXXXXXXXXXXXXXXXXXXXXXXX--XXXX--[]XXXXXXXX-XXXXXXXX--XXXX--X---------------XXXXXX---------------XXXXXXXXXXX-----XXXXXXXXXXX---------------------------X[]--XX