----------------------------------------------------------------------------------------------------------------------------------------------------------------
----------------------------------------------------------------------------------------------------------------------------------------------------------------
----------------------------------------------------------------------------------------------------------------------------------------------------------------
----------------------------------------------------------------------------------------------------------------------------------------------------------------
----------------------------------------------------------------------------------------------------------------------------------------------------------------
----------------------------------------------------------------------------------------------------------------------------------------------------------------
--------------------SE------------------------------------------------------------------------------------------------------------------------------------------
-------------------S-SSS--------------------------XXXXXXX----------------------------E----------------------------------------------------------X---------------
----------------------------------------------------------------------------------------------------------------------------------------------------XXXXoo------
-------------------------------------------------------------------------------------xxxx-------------xxxxxx-----------ooooo------------------------------------
-------------------------------------------------------------------xxxx----------xxxxx---xx-------xxxxx--x--x----------ooooo------------------------------------
------------xxxx--------------------------------------------------xx<>-x--------xxXSSS--<>-x-----xx-XXX--X---x---E------------X--XXX-------XX---XX----------XXXX
-----------xx<>-x---E-------------B------------------------------xx-[]--x------xx-X-----[]--x---xx--XXX--X----xxxxxxxxxxxxxx--X---------------------------------
----------xx-[]--x----xxxx--------b-----------------------------xx--[]---x----xx--X-----[]---x-xx---XXX--X---XXXXXXXXXXXXXXX--X---------------------------------
xxxxxxxxxxx--[]---xxxxx---xxxxxxxxxxxxxxxxxxxxxxxxxxxxxxxxxxxxxxx---[]----xxxxx---X-----[]----xx----XXX--X---X----------------X---------------------------------
XXXXXXXXXXXXXXXXXXXXXXX-X-XXXXXXXXXXXXXXXXXXXXXXXXXXXXXXXXXXXXXXXXXXXXX---XXXXXXXXXXXXXXXXXXXXXX--XXXXX--X---X--------------XXX--------------------------X------