----------------------------------------------------------------------------------------------------------------------------------------------------------------
----------------------------------------------------------------------------------------------------------------------------------------------------------------
----------------------------------------------------------------------------------------------------------------------------------------------------------------
----------------------------------------------------------------------------------------------------------------------------------------------------------------
-SSSSSSSSSSSSSSSSSSSSSSSSS--------------------------------------------------------------------------------------------------------------------------------------
----------------------------------------------------------------------------------------------------------------------------------------------------------xxx---
--------------------------------------------------------------------------------------------------------------------------------------------------------xxx--x--
--------------------------SSSSSS--------SSSSSSSSSSSS-----------------SS-----------------------------E--------------------------------------------------xxXX---x-
-------------------------------------------------------------------------------------------oooo------------------------------E------------------------xx-XX----x
------------------xxxxxxxxxxxxx-----<>----------------------------------------------------------------------------------------------------xxxxxx--xxxxxXXXX-----
--------------xxxxx--x---SSSSS-x----[]-----------------------------SS------------------xxxx----------xxx----Q---------------------------xxx--x--xxx--xXXXXX-----
----QQQQQQ---xxXXXX--X----------x--QQQQQQQ--------------------------------------------xx<>-x-------xxx--x------B-----------------------xxXX--X--XXX--XXXXXX-----
------------xxEXXXXXXXXXX--------x-----------------------------xxxx------------------xx-[]--x-----xxXX---x-----b----B-----------------xxXXX--X--XX---XXXXXX-----
-----------xxXXXXXXXXXXXX---------x-xxx-----xxxxxxxx------xxx-xx<>-x-xxxx---xxxx----xx--[]---x---xx-------xxxxxxxxxxxxxxxxxxxxxxxxxxxxxXXXX--X-------XXXXXX-----
xxxxxxxxxxxxXXXXXXXXXXXXXE-E---E---xx--xxxxxx-------xxxxxxx--xx-[]--xx---xxxx---xxxxx---[]----xxxx-------XXXXXXXXXXXXXXXXXXXXXXXXXXXXXXXXXX--X-------XXXXXX-----
XXXXXXXXXXXXXXXXXXXXXXXXXXXXXXXXXXXXX-XXXXXXX-------XXXXXXX--XXXXXXXXX-X-XXXX---XXXXXXXXXXXXXXXXXX-------XXXXXXXXXXXXXXXXXXXXXXXXXXXXXXXXXX--X-------XXXXXXXXXXX