----------------------------------------------------------------------------------------------------------------------------------------------------------------
----------------------------------------------------------------------------------------------------------------------------------------------------------------
----------------------------------------------------------------------------------------------------------------------------------------------------------------
----------------------------------------------------------------------------------------------------------------------------------------------------------------
----------------------------------------------------------------------------------------------------------------------------------------------------------------
----------------------------------------------------------------------------------------------------------------------------------------------------------------
--------------------------------XX------------------------------------------------------------------------------------------------------------------------------
-----SQQSSSQSS---------------------------------------------------------------------------------------------------------------xx----------SSSSSSSSSSSSS----------
-----------------------------------------------------xxx----XX--------------------------------------------------------------xx----------------------------------
----------------------xxxx--------------------------xx--x------------------------------------------------------------------xx-----------------------------------
--------------------xxx--<-------------------------xx----xx---------E--xxxx-----------------------------------------------xx------------------------------------
------SSSSSSSSS----xx<>--[---xx--------------xxxxxxx----XX-x----------xx<>-x---------------------QQQ--------------S-----xxx------------------------------------x
------------------xx-[]--[---X-x------------xxXXXXXX--------x--------xx-[]--xx-----------------------------------------xx<E-----------------------------------xx
-----------------xx--[]--[--xXX------------xxXXX-------------x------xx--[]-<>-x------x----xxx---------xxx-------------xx-[>----xxx------xxxxxxxxxxxxxx-------xx-
xxxxxxxxxxxxxxxxxx---[]--[xxxXX-------XX---xXXXX--------------xxxxxxx---[]-[]--xxxxxx-xxxxx--xxxxxxxxxx--xxxxxxxxxxxxxx--[]E---EE-xxxxxxx-------------xxxxxxxxE-
XXXXXXXXXXXXXXXXXXXXXXX--XXXXXX-------XXXXXXXXXX-------------XXXXXXXXXXXXXXXXXXXXXXXXXXXXXX-XXXXXXXXXXX--XXXXXXXXXXXXXXXXXXXXXXXXXXXXXXXX-------------XXXXXXXXXX