----------------------------------------------------------------------------------------------------------------------------------------------------------------
----------------------------------------------------------------------------------------------------------------------------------------------------------------
----------------------------------------------------------------------------------------------------------------------------------------------------------------
--------------------------------------------------------------------------------------------------S-------------------------------------------------------------
----------------------------------------------------------------------------------------SSSSSSSSSS--------------------------------------------------------------
------------------------------------------------------------------------------------------------------------------------x---------------------------------------
---------------------------------------------E---E-E---------------------------------------------------------------E---xx-ooo-----------------------------------
---------------------------------------------S--<><>-----------------------------------------------xxxx------------xxxxx----------------------------E-----------
--------xxx---------xx--------------------------[][]----------------------------------------------xx---x----------xx-XXX-----o----------------------------------
-------xx--x----xxxxx-xx---------------------?--QQQQ---------------------------------------------xx-----x--------xx----------------EE---------------------------
------xx----xx---xXSS---xx-----------------------------------QQQQ----------xxx------------------xx-------xxx-xxxxx-----------------<>------------xxx---QQ?QQQQQ-
----xxx----<>-x--XXX----X-x--------ooo------xxx------------B--------------xxX-x----------------xx--------XX-xx--XX-------------?---[]-----------xxE-x-----------
---xx<>----[]--xXXXX----XX-x-----------x---xxX-x-----------b---E---------xx-X--x-------------Exx------------<>---------------------[]----------xx<>--x-------E--
--xx-[]----[]---XXXX----XXX-x---------xx--xx-X--xxxxxxxxxxxxxxxxxxxxxxxxxx--X---xxxxx--------xx------XX-----[]---------------------[]---xxxxxxxx-[]---xxxxxxxxxx
xxx--[]----[]---XXXX----XXXX-xxxxxxxxxx-xxx--X--XXXXXXXXXXXXXXXXXXXXXXXXXXXXXXXXXXXX-xxxxxxxxxX-------------[]-------------------XXXXXXXxXXXXXXXXXXXXXXXXEEXXXXX
XXXXXXXXXXXXXX--XXX-----XXXXXXXXXXXXXXXXXXXXXXX-XXXXXXXXXXXXXXXXXXXXXXXXXXXXXXXXXXXXXXXXXXXXXXX-------------[]--------------XX---XXXXXXXXXXXXXXXXXXXXXXXXXXXXXXX