----------------------------------------------------------------------------------------------------------------------------------------------------------------
--------------------------------------------------------------------------------------------------------------------------------------------xxx-----------------
-------------------------------------------------------------------------------------------------------------------------------------------xx--x-------xxx------
------------------------------------------------------------------------------------------------------------------------------------------xx----x-----xx--x-----
-----------------------------------------------------------------------------------------------------------------------------------------xx-----------x----x----
-------------------------------------------o--------------------------------------------------------------------------------------xxxxxxxx-----------x------x---
---------------------------------------------------------------------------------------XXX---E-E--QQQ?QQQQ?QQQ?QQQQ--------------xx?QQQQQQ----------xx-------xxx
-------------------------------------x---SSS------------------------------------------------<><>----------------[]--------------xx---------------x--xS-------XXX
-----------------------------------xxx------------------------------------------------------[][]----------------[]-------------xx-----------------x-x-----------
-----------------------------------xXXxxxxxxxxx---------------------------------------------QQQQ----------------[]----------xxxx-------------------xx--------o-o
-----------------------------------xXXx---x----xx---------------------------------xxxxx-------------SSSSSSSSSSS-<>---------xxQQ?---S----------------x--------o-o
SS--Q----------Q-----XXXX---------xxXX>---S---<>-x---------S---------------------xxXXX-xxxx-------------------------------xx------------------------SS----------
E--------------------------------xxXXX]-------[]--x-----------------------------xxXXXX-XXX-x-------E---E--------xxx------xx-------------------------------------
---------xxxx--------xxx--------xx-XXX]-------[]---x-------------xxxxxxxx------xxXXXXX------xxxxxxxxxxxxxxxxxxxxxE-xxxxxxx--X-------EE--------------------------
xxxxxxxxxx---xxxxxxxxx--xxxxxxxxx--XXX]----E--[]----xxxxxxxxxxxxxxEXXXXX-xxxxxxxXXXXXX------XXXXXXXXXXXXXXXXXXXX<>-XXXXXXXXXXXXXXXXXXXX-------------------------
XXXXXXXXXX---XXXXXXXXX--XXXXXXXXXXXXXXXXXXXXXXXXXXXXXXXXXXXXXXXXXXXXXXXXXXXXXXXXXXXXX-------XXXXXXXXXXXXXXXXXXXX[]-XXXXXXXXXXXXXXXXXXXX----------XXXXX----------