----------------------------------------------------------------------------------------------------------------------------------------------------------------
----------------------------------------------------------------------------------------------------------------------------------------------------------------
-----------------------------------------------------------------------------------------------------------------------------xxx--------------------------------
----------------------------------------------------------------------------------------------------------------------------xx--x-----xxxx----------------------
----xxx---xxx--------------------------------------------------------------------------------------------------------------xx----x---xx---x---------------------
---xx--xxxx--x--------xxx------------xxxxxxx------------------------------------ooo-------------------------------------xxxx------x--xQ----x-xxx----------------
---EX--XXXX---x------xx--x--xxx-----xx--xx--xxx---------------------------------XXX----------------------E-----xxx-----xxXXX----X--xxx------xx--x---------------
---------------x----xx-E--xxx--xoo-xx---E---XX---------------------------?Q------------------------------xxxxxxx--xoo-xx------------x-------XX---x--------------
----------------x--xx-----XXX---x-xx--------XX-x--------------------------------------------------------xx-XXXXX---x-xx-----------XXXX------XX----x-----------xx
-----------------xxx-------------xx---------XX--x-------------------------------------------------xxx--xx-----------xx----------------------XX-----x-------xxxx-
-----------------XXX-------------XX---------XX---xxxxxx-------S---xxxx--QQ---------------------xxxx--xxx------------XX----------------------XX------x-----xxXXX-
--------------------------------------------XX---<>-<>-x---------xx---x-----------------------xxXXX--XXX------------------------------------XX----E--x---xx-----
--------------------------------------------XX---[]-[]--x-------xx-----x-------------E-------xxXXXXE----------------------------------------XX----X---x-xx------
--------------------------------------------XX---[]-[]---xxxxxxxx-------xxxxxxxxxxx-<>-------xXXXXX-----------------------------------------XX----X----xx-------
xxx----XXXXXXXXXX---------------------------XX---[]-[]--XXXXXXXXE------XXXXXXXXXXXX-[]---XXXXXXXXX------------------------------------------XX----X----XX-------
XXX-----------------------------------------XXXXXXXXXXX----------------X------------XX---XXXXXXXXX------------------------------------------XXXXXXXXX--X--------