----------------------------------------------------------------------------------------------------------------------------------------------------------------
----------------------------------------------------------------------------------------------------------------------------------------------------------------
----------------------------------------------------------------------------------------------------------------------------------------------------------------
----------------------------------------------------------------------------------------------------------------------------------------------------------------
----------------------------------------------------------------------------------------------------------------------------------------------------------------
--------------------------------------------------------------------------------------------------------------------------o-o-----------------------------------
----------------------------------------S---------------------------------------------------------------------------------o-o-----------------------------------
---------------E-----------------------------------XXX------------------------------------------------------------------xxx----------------------------SSSSS----
------------E--------------------------------------------------------------------------------------------------------xxxx--x-------------------xx---------------
--------xxxxxxxxxxxxxxxxx-----------------xxxxx-Exxxxx--------------------------------------------------------------xxXXX---xx----------------xx-x--------------
-------xxXSSSSSSSSSSSSSS-x--------------xxx----xxx----x----------------------------------------------------xxxxxxxxxx------XX-x--------------xx---x-------------
---E--xxXX----------------x------------xx<>----XXX-----xE----oxxxx-----------------------------xxx--------xxXXXXXXXXX-------------S--------xxx-----xxx---SSS----
---E-xxXXX----o------------x----------xx-[]----XX-------x----xx<>-x---------------------------xxX-x------xxXXX----------------------------xx<>-----<>-x---------
----xxXXXX------------------xxxxxxxxxxx--[]--------------xxxxx-[]--x------------xxx------xxx-xx-X--xxxxxxxXXX------------------x---------xx-[]-----[]--x------xx
xxxxxXXXXX----ooXXXXXXXXXXXXXXXXXXXXXXXX-XX-------------XXXXXX-[]---xxxxxxxxxxxxxE-xxxxxxx--xx--XXXXXXXXXXXXX-------------------xxxxxxxxxx--[]-----[]---xxxxxxx-
XXXXXXXXXXXXXXXXXXXXXXXXXXXXXXXXXXXXXXXX-XX--------------------XXXXXXXXXXXXXXXXXXXXXXXXXXX--XXXXXXXXXXXXXXXXX------------------XXXXXXXXXXXXXXXXXX--XXXXXXXXXXXX-