----------------------------------------------------------------------------------------------------------------------------------------------------------------
----------------------------------------------------------------------------------------------------------------------------------------------------------------
------------------------------xx--------------------------------------------------------------------------------------------------------------------------------
--------------------------------x-------------------------------------------------------------------------------------------------------------------------------
---------------------------------x------------------------------------------------------------------------------------------------------------------------------
----------------------------------x-----------------------------------------------------------------------------------------------------------------------------
-----------------------------------x-------XXX-------------------------------x---------------------------------------------------------------SSSS---------------
-----SSSSSSS------------------------x---------------------------oo------------x-------SSSSSSSSS----------SSS----S---------QQ?-----------------------------------
------------------xxxx---------------x-----------------------------------------x--------------------------------------------------------------------------------
B----------------xx---x---------------x--------xx--------------xxx----xxx-Exx---x------------------------------------------------------------X------------------
b--------xxxx---xx-----x---------------x------xx-x---xxxxxxxxxxx--xxxxx--xxx-----x------------------------E---------------SSS----------------XEEE---------------
----S---xx--xxxxx-------xxx-------------x----xx---x-xxXXXXXXXXXX--XXXXX--XXX--X---x-QQQQ---------S?S-----SSS----S--------xxxx-----S------E----SSSSSSSQ----------
-------xx------<>-------<>-x-------------x--xx-----xx--------------------XX--------x------------------------------------xx---x----------<>----------------------
------xx-------[]-------[]--xx------------xxx-----XXX-------------------------------x-----xxxxx------------------------xx-----x-------------------------xxx-----
xxxxxxx--------[]-E-----[]---x---------XXEXXXX---------------------------------------xxxxxx----xxxxxxxxxxxxxxxxxxxxxxxxx-------xxxxxxxxxxxxxxxxxxxxxxxxxx--xxxxx
XXXXXXX------XXXXXXXXX--XXXXXX----------------------X------------------------XXXXXXXXXXXXXX----XXXXXXXXXXXXXXXXXXXXXXXXX-------XXXXXXXXXXXXXXXXXXXXXXXXXX-XXXXXX