----------------------------------------------------------------------------------------------------------------------------------------------------------------
----------------------------------------------------------------------------------------------------------------------------------------------------------------
----------------------------------------------------------------------------------------------------------------------------------------------------------------
----------------------------------------------------------------------------------------------------------------------------------------------------------------
----------------------------------------------------------------------------------------------------------------------------------------------------------------
----------------------------------------------------------------------------------------------------------------------------------------------------------------
----------------------------------------------------------------------------------------------------------------------------------------------------------------
-----------xx-------SQSS--------SSS----------------------------E--S---------------------------------------------------------------------------------------------
----------xx--------------------------------------------------<>--------------------------------------------S---------------------------------------------------
---------xx---------------------------------------------------[]------X-EE------------------------------Q?------------------------------------------------------
--------xx--------------------xxxxxxx-------------------------[]------XSSSSSS-----------------------------------------------------------------------------------
------xxx----------SSSSSSSQQ-xxXXXXX-x----------------------SSXXS----------------------xxxx------E--------------------S--------QQ-------------------------------
-----xx<>-------E-----------xx-X------x---------------------E----xxxx-----------------xx<>-x-------------xxxxx------------------------------E---------xxxx------
----xx-[]------------------xx--X-------x------------------------xx<>-xxxxxxxxxxxxxxxxxx-[]--xxxxxxxxxxxxxx--X-x---------------------------------xxx--xx<>-x-----
xxxxx--[]E---xxxxxxxxxxxxxxx---X--------xxxxxxxxxxxxxxxxxxxxxxxxx-[]-XXXXXXXXXXXXXXXXXXXXXXXXXXXXXXXXXXXXX--X--xxxxxxxxxxxxxxxxxxxxxxxxxxxxxxxxxx--xxx-[]--xxxxx
XXXXXXXXXXXXXXXXXXXXXXXXXXXXXXXXXX----XXXXXXXXXXXXXXXXXXXXXXXXXXXXXX-XXXXXXXXXXXXXXXXXXXXXXXXXXXXXXXXXXXXX--X--XXXXXXXXXXXXXXXXXXXXXXXXXXXXXXXXXX--XXXXXXXXXXXXX