----------------------------------------------------------------------------------------------------------------------------------------------------------------
----------------------------------------------------------------------------------------------------------------------------------------------------------------
----------------------------------------------------------------------------------------------------------------------------------------------------------------
----------------------------------------------------------------------------------------------------------------------------------------------------------------
----------------------------------------------------------------------------------------------------------------------------------------------------------------
----------------------------------------------------------------------------------------------------------------------------------------------------------------
------------------------------------------------------------------------------------------------------------------------xxx------------------------------SSS--?-
--------------------------------------SSS-------------------xxxxxxx-------------S-------------------------?------------xx--x----------------------------S-----E-
-----------------------------------------------------------xx--XXX-x--------------------------------------------------xx-------------------------------SS-------
--------------------------xxx----xxxx-----------------xxx-xx---oo---xxxx-----------------------------------------xxxxxx-------------------------------SSS-------
-----------------------xxxx--xxxxx---xx------------xxxx--xx--------XXXX-x------------------xxxx-----------------xx---<>------------------------------SSSS-------
----------------------xxXXX--XXXXX--XX-x----------xxXXX--XX--------------x-----xxxx-------xx----Q------Q--S----xx----[]-------------------E----E----------------
---------------------xxXXXXE--------XX--x--------xxXXXXE------------------x---xx<>-x-----xx---<---------------xx-----[]-----------------------------xxx---------
-----xxx-xxx--------xxXXXXX---------XXX--x------xxXXXXX--------------------x-xx-[]--x---xx----[--------------xx------[]-----xxxxxxxxxxxxxxxxxxxxxxxxxB-xxxxxxxxx
xxxxxx--xx--xxxxxxxxxXXXXX----------XXX--ExxxxxxxXXXXX----------------------xx--[]---xxxxX----XxxxxxxxxxxxxxxxE---E--[]-----XXXXXXXXXXXXXXXXXXXXXXXXXXXXXXXXXXXX
XXXXXX-XXX--XXXXXXXXXXXXXX----------XXXXXXXXXXXXXXXXXX----------------------XXXXXXXXXXXXXX----XXXXXXXXXXXXXXXXXXXXXXXXXXXXXXXXXXXXXXXXXXXXXXXXXXXXXXXXXXXXXXXXXX