----------------------------------------------------------------------------------------------------------------------------------------------------------------
----------------------------------------------------------------------------------------------------------------------------------------------------------------
----------------------------------------------------------------------------------------------------------------------------------------------------------------
----------------------------------------------------------------------------------------------------------------------------------------------------------------
-------------------------------------------------------------------------------------------------------------------------------------------------------------SSS
----------------------------------------------------------------------------------------------------------------------------------------------------------------
------------------------------------------------------------------------------xxxxxx-----------------------------------------SSSSSSSSS--------------------------
-----SSS---------------------------------------Q-Q---------------------------xx?SSS-x---------------------------------------------------------------------------
-----------------------------------------------------------------------------x-------x--------------------------------------------------------------------------
------------------------------------------------------------------------xxxxxx-------Ex----------------------------------------xxxxxxxx----------xxxx----xxx----
-------------B-------------------------------------------------o---xxxxxx---xE------<>-x-------------------------------------xxxSSSSSS-x--------xxX--x--xx--x---
-------QQQ---b-------------------QQQQ---QQQ----Q-Q---ooo----------xxXSSx----<>---E--[]--x----------------xx---------Q-------xx<>--------x------xx-X---xxx----xxx
---------------------------E-------------------------------------xx-X-------[]--<>--[]---x--------------xx-x---------------xx-[]---------xx---xx--X----x-----SS-
---------------------xxx---------E------------------------------xx--X-------[]--[]--[]----x-----xxx-xxxxx---x-------------xx--[]--------XX-xxxx--EX---<>-----SS-
xxxxxxxxxxxxxxxxxxxxxxE-xxxxxxxxxxxxxxxxxxxxxxxxxxxxxxxxxxxxxxxxx--EX----E--[]--[]--[]-----xxxxxx--xx--x-----xxxxxxxxxxxxxxXXXXXXXXXXXXXXXXXXXXXXXX---[]-----SS-
XXXXXXXXXXXXXXXXXXXXXXXXXXXXXXXXXXXXXXXXXXXXXXXXXXXXXXXXXXXXXXXXXXXXXXXXXXXXXXXXXXXXXXXXXXXXXXXXX--XX--X-----XXXXXXXXXXXXXXXXXXXXXXXXXXXXXXXXXXXXXX---[]-----XX-