----------------------------------------------------------------------------------------------------------------------------------------------------------------
----------------------------------------------------------------------------------------------------------------------------------------------------------------
----------------------------------------------------------------------------------------------------------------------------------------------------------------
----------------------------------------------------------------------------------------------------------------------------------------------------------------
-------------------------------------------------------------------SSSSSSSSSSSSSSSSSSSSSSSSSSSSSSSSSSSSSSSSSSSSSSSSSSSSSSSSSS--[]SSSS---------------------------
--------------------------------------------------------------------------SSS------SSSSSSSSSSSSSSSSSSSSSSSS--------------------[]SSSS---------------------------
--------------------------------------------------------------------------SSS------SSSSSSSSSSSSSSSSSSSSSSSS--------------------[]SSSS---------------------------
-----------------------------------------------------------------------------------SSSSSSSSSSSSSSSSSSSSSSSS--QQ----------------[]SSSS---------------------------
--ooooo------------------------------------------------------------------------------------------------------------------------[]SSSS---------------------------
---------------------------------------------------------------------------------------xxx----------------xxx-xxx--------------[]SSSS---------------------------
-------------------------oo----xxxx------------------ooooo-------------------------xxxxx?-xxxxxxxxxxxxxxxxx--xx--x--------------]SSSS---------------------------
------------------------xxxx--xx-X-x-----------XXXX-XXXXXXXX---------QQQQQSSS-----xx-SSS??SSSSSSSSSSSSSSSSS--QQ---x------xxxxxx-]SSSS--------------QQQQQ?-QQQQQ?
-----------------------xx---xxx--XX-x-------E------------------------------------xx--SS---SSSSSSSSSSSSSSSSS--------xxx--xxSSSSSSSSSSS-xxxx----------------------
----------xxx---------xx-----x---XXX-x-----<>-------------------------------xxxxxx---SS---SSSSSSSSSSSSSSSSS--------<>-xxx-SSSSSSSSSSS-----xxxxxxxxxxxxxxxxxxxxxx
xxxxxxxxxxx-Exxxxxxxxxx----------XXXX-xxxx-[]--------------------xxxxxxxxxxxx---x------oooSSSSSSSSSSSSSSSSS------E-[]--x--SSSSSSSSSSS----XXXXXXXXXXXXXXXXXXXXXXX
XXXXXXXXXXX--XXXXXXXXXX--------XXXXXXXXXX--XX-------------XXXXXXXXXXXXXXXXXXX---X---XXXXXXXXXXXXXXXXXXXXXXXXXXXXXXXXXXXX--XXXXXXXXXXX----XXXXXXXXXXXXXXXXXXXXXXX