----------------------------------------------------------------------------------------------------------------------------------------------------------------
----------------------------------------------------------------------------------------------------------------------------------------------------------------
----------------------------------------------------------------------------------------------------------------------------------------------------------------
----------------------------------------------------------------------------------------------------------------------------------------------------------------
-----------S----------xxxx--xxx---------------------------------------------------------------------------------------------------------------------------------
---------------------xx---xxx--x--------------------------------------------------------------------------------------------------------------------------------
---------------------XX---XXX---x---------------------------------------------------------------------------------------------------------xxx-------------------
------SSSSSS---------------------x----------------------XXX-----------------E--S---------------------------------------------------------xxX-x------------------
----------------------------------x----------------------------------------<>-----------------------------------------------------------xxXX--x-----------------
-----------------------------------x---------------------------------------[]----------------------------------------------------------xxXXX---x--------E-------
---------------E--------------------xo-------------------------------------[]-----------------x---------------------------QQQQQ-------xxXXXX----xx----------xx--
-----xxxx-------------------------X--x-------------------------------------XXS---------------xx-xxx----------------------------------xxXXXXX----B-x--------xx-x-
----xx---x----------------------EXX---x---------------------------------------xxxx----------xxExxX-x-------------------------E------xxXXXXXX----b--x------xx---x
---xx-----x--------------o------XXX----x--------------------xxx--------------xx<>-x-----xxxxx-Xx-X--x----xxx---xxxxxxxxxxxxxxxxxxxxxxXXXXXXX----B---xxxxxxxX--XX
xxxx-------xxxXX---------X-----XXXX-----xxxxxxxxxxxxxxxxxxxxxE-xxxxxxxxxxxxxxx-[]--xxxxxx--x--X--X--Exxxxx--xxxxEXXXXXXXXXXXXXXXXXXXXXXXXXXXXXXXXXXXXXXXXXXX----
XXXX------XXXXXX--------------XXXXXXXXXXXXXXXXXXXXXXXXXXXXXXXXXXXXXXXXXXXXXXXXXXXXXXXXXXX--X--XXXXXXXXXXXX--XXXXXXXXXXXXXXXXXXXXXXXXXXXXXXXXXXXXXXXXXXXXXXXX----