----------------------------------------------------------------------------------------------------------------------------------------------------------------
----------------------------------------------------------------------------------------------------------------------------------------------------------------
----------------------------------------------------------------------------------------------------------------------------------------------------------------
------------------------------------SS-------------------------------------------------SSSSSSSSSSSSSSSSSSSSSSSSSSSSSSSSSSSSSSSSSSSSSSSSSSSSSSSSSSSSSSSSSSSSSSSSS
------------------------------------[]--------------------------------xxx----------------------------------------------------------------------------------SSSSS
------------------------------------[]------------------------------xx---x------------xxxxx----------------------------------------------------------------SSSSS
-----------------xxxxxx-------------<>-----------------SSSSS-------xx-----x--------XX-xxx--x---------------------------------------------------------------SSSSS
------x---------xxXXX--x------------------------------S-----------xx-------x-x-----xx-xSS---xxxxxxxxxxxxxxxxxxxxxxxxxxxxxxxxxxxxxxxxxxxxxxxxxx------------------
-------x-------xxXXXX---x------------E---------------SS-----------x---------x-x---xx-xxSS--SSSSSSSSSSSSSSSSSSSSSSSSSSSSSSSSSSSSSSSSSSSSSSSSSS-x-----------------
--------x-----xxXXXXX------------xxxxx------------Q?SSS-----------x------------xxxx---xSS--SSSSSSSSSSSSSSSSSSSSSSSSSSSSSSSSSSSSSSSSSSSSSSSSSS--xxxxxxxxxxxxxxxxx
---------x---xx-XXXXX----?QQQQ---xx<>-x-----?QQQQ---SSS----------xx------------XXXX---SSS--SSSSSSSSSSSSSSSSSSSSSSSSSSSSSSSSSSSSSSSSSSSSSSSSSS?SS?SS????????SSSSS
----------x-xxXXXXXXX-----------xx-[]--x------------------------xxS-----------------------------------------------------------------------------SSSSSSSSSSS-----
-----------xx-XXXXXXX-------E--xx--[]---x------E---xx----------xx------------------------<>-----------------------------------------------------SSSSSSSSSSS-----
----xx----<x--XXXXXXX---Xxxxxxxx---[]----xxxxxxxxxxx-xxxxxxxxxxx-------------------------[]---------------------------------------------------------------------
xxxxxE----[---XXXXXXX-XXXXXXXXXXXXXXXXXXXXXXXXXXXXXXXXXXXXXXXXXXXXXX-XXXXXXXX----------XXXXXXXXXXXXXXXXXXXXXXXXXXXXXXXXXXXXXXXXXXXXXXXXXXXXXXXXXXX-XXXXXXXXXXXXX
XXXXXXXXX-XXXXXXXXXXXXXXXXXXXXXXXXXXXXXXXXXXXXXXXXXXXXXXXXXXXXXXXXXX-XXXXXXXX---------XXXXXXXXXXXXXXXXXXXXXXXXXXXXXXXXXXXXXXXXXXXXXXXXXXXXXXXXXXXX-XXXXXXXXXXXXX