----------------------------------------------------------------------------------------------------------------------------------------------------------------
----------------------------------------------------------------------------------------------------------------------------------------------------------------
----------------------------------------------------------------------------------------xxxxxxxxx---------------------------------------------------------------
---------------------------------------------------------------------------------------xxSSSSSSSS---------------------------------------------------------------
-----------------------------------------------------------------------------------x--xx---------x--------------------------------------------------------------
------------------------------------------------------------------------------------xxx-----------x---------------------------o---------------------------------
------------------------------------------------------------------------------------XXX------------x---------------------------o--------------------------------
-------------------E--E--E--------------------QQQQ--------------------------------------------------x--------------------------------------------------------X--
------------------SSSSSSSSSS----------------------------------------------------xxx------------------x---------------------xxxx---------------------------------
-------------------------------------------------------------------------------xxX----------------------------------------xx------------------------------------
--------------X-E--E--E--E----------------------------------------------------xxXX----------------------------QQQQ--------XX---xxx------------------------------
---------S----XS?SSSSSSSSSSS---X--------xxx--Q?SSQQQ--S?S--------------------xxXXX-------------------X---------------xxxx------XX---------QQQQQ------Q----------
----------------------------EE-X-------xxX-x---------------------xxx--------xxXXXX-------oooooo----EXX---xxxx---E---xx<>-x--------------------------?-----------
---------xxxxxSSSSSSSSSSSSSSSSSX------xx-X--x-xxx---------------xxX--------xxXXXXX-------oooooo----XXXx-xx<>-xxxxxxxx-[]----------xxxx-xxxx----------------xxx--
xxxxxxxxxx--X-xxxxxxxxxxxxxxxxxxxxxxxxx--X---xx--xxxxxxxxxxxxxxxx-X-xxxxxxxxXXXXXX-------XXXXXX---XXXX-xx-[]-XXXXXXXXXXXX---------x---xxEE-xxxxxxxxxxxxxxxxx--xx
XXXXXXXXXX--XXXXXXXXXXXXXXXXXXXXXXXXXXXXXXXXXXX--XXXXXXXXXXXXXXXXXXXXXXXXXXXXXXXXX-------XXXXXX--XXXXXXXXXXX-XXXXXXXXXXXX---------X--XXXXXXXXXXXXXXXXXXXXXXX--XX