----------------------------------------------------------------------------------------------------------------------------------------------------------------
----------------------------------------------------------------------------------------------------------------------------------------------------------------
----------------------------------------------------------------------------------------------------------------------------------------------------------------
---xxxxx--------------------------------------------------------------------------------------------------------------------------------------------------------
---XXXXX--------------------------------------------------------------------------------------------------------------------------------------------------------
---XXXXXXXXXX-----------------------------------------------------------------------------------------------------------------------------------------o---------
---XXXXX--------------------------------------------------------------------------------------------------------------------------------------------------------
---XXXXX----------------SSS-----------------------------------E------XXX-------------E--------------------------------------------------------------SSS-------E-
---XXXXX---------------------xx-----------------------------------------------------<>-----------------------------------------------------------------------<>-
---XXXXX---------------------X-x----------xxxxxx----------xxxxx---------------------[]-----------------------------------------------------------xxxxxxxxx---[]-
---XXXXX-----------E--xxxxxxxX--x--------xx--<>-x--------xxXSS-x--------------------[]-----------X-----------------o---------------------X-----xxx---x----xx-XXX
---XXXXX-------------xxXXXXX-X---x-------<>--[]--x------xxXX----x------------ooo----XXX------SSSSX--------------------xxx---------ESSSSQQX----xx<>---S---<>-x---
--xXXXXX>---<x------xx-X-----X----x------[]--[]---x----xxXXX-----x----------------------------------------E----------xxX-x-------------------xx-[]-------[]--x-x
-xxXXXXX]---[-x----xx--X-----X-----x-----[]--[]----x--xxXXXX------xxxxxx---------------xxxx-------------------------xx-X--x-----------------xx--[]-------[]---xx
xx-XXXXX]---[--xxxxx---X-----X------xxxxx[]--[]-----xxxXXXXX-------x----xxxxxxxxxxxxxxxx---xxxxxxxxxxxxxxxxxxxxxxxxxx--X---xxxxxxxxxxxxxxxxxx---[]----E--[]----x
XXXXXXXXXXXXXXXXXXXXXXXXXX---X-XX---XXXXXXX--XXXXXXXXXXXXXXXXX-----X----XXXXXXXXXXXXXXXX---XXXXXXXXXXXXXXXXXXXXXXXXXXXXX---XXXXXXXXXXXXXXXXXXXXXXXXXXXXXXXXXXXXX