----------------------------------------------------------------------------------------------------------------------------------------------------------------
----------------------------------------------------------------------------------------------------------------------------------------------------------------
----------------------------------------------------------------------------------------------------------------------------------------------------------------
----------------------------------------------------------------------------------------------------------------------------------------------------------------
--------------------------------------------------------------------------------------------xxx--------SSSSSSSSSSSSSSSSSSSSSSSSSSSSSSSSSSSSSSSSSSSSSSSSSSSS-----
-------------------------------------------------------------------------------------------xx--x--xxx--SSSS------------SSSSSSSSSSSSSSSSSS--------------------oo-
--X-----------------------------------------------------E----------------------------------xX---xxx--x-SSSS------------SSSSSSSSSSSSSSSSSS--------------------oo-
--------------------------------------------------------S----------E--E--E----------------xx----XXX---xSSSS------------SSSSSSSSSSSSSSSSSS--QQ-------------------
------------------------------------------------------------------SSSSSSSSSS--------------x-----XXX----x--------------------------------------------------------
--------------------------------------------------------?-------------------------------xxx-----XXX-----x-------------------------------xxx-xxx-----------------
---------------------------xxxx-------------------------------X-E--E--E--E----------x--xx<>-----XXX-----oxxx------xxxxxxxxxxxxxxxxxxxxxxx--xx--x--------xxxxx---
--------------------------xx---------------------------xxx-x--XS?SSSSSSSSSSS---X---xx-xx-[]-----XXX----S?SS-x----xxSSSSSSSSSSSSSSSSSSSSSS--QQ---x------xxXXX-x--
-------------x-----------xx---<-----------------------xxX-x-x---------------EE-X--xxExx--[]-----XXX----SSS---x--xx--SSSSSSSSSSSSSSSSSSSSS--------xxx--xxEXXX--x-
------------xxxx--------xx----[----------------xxx---xx-X----xSSSSSSSSSSSSSSSSSX-xx-Xx---[]-----XXX----SS-----xxx---SSSSSSSSSSSSSSSSSSSSS--------<>-xxxXXXXX---x
xxxxxxxxxxxxx---xxxxxxxxxX----X-E--xxxxxxxxxxxxx--xxxx--X-----xxxxxxxxxxxxxxxxxxxx--XXEXXXX-----XXX------E-EE--xX-----SSSSSSSSSSSSSSSSSSS------E-[]--xXXXXXX----
XXXXXXXXXXXXXX-XXXXXXXXXXX----XXXXXXXXXXXXXXXXXX--XXXXXXXX-XXXXXXXXXXXXXXXXXXXXXXX--XXXXXXX-----XXXXXXXXX-XXXXXXX--XXXXXXXXXXXXXXXXXXXXXXXXXXXXXXXXXXXXXXXX-----