----------------------------------------------------------------------------------------------------------------------------------------------------------------
----------------------------------------------------------------------------------------------------------------------------------------------------------------
----------------------------------------------------------------------------------------------------------------------------------------------------------------
-----------------------------------------------------------------------------------------------------------------------------------------SS---------------------
-----------------------------------------------------------------------------------------------------------------------------------------[]---------------------
-----------------------------------------------------------------------------------------------------------------------------------------[]---------------------
------E-E---E-------------------S-E---------SSSS---------------------------E---E-E----------S--------------------------------------------<>---------------------
----SSSSSSSSSSSSSSSSS------------SSSSS?SS----------------------------------S--<><>------------------------------------------------------------------------------
------------------------------------------------------------------------------[][]-------------S------------------------------------------E--------------------x
---------------------------------------------------------------------------?--QQQQ-------------------------x---------------------------xxxx-----------------xxxx
------------------E-X--------------------------X------------------------------------------------------------x-------------------------xx<>-x-QQQQ?QQQQQ----xxQQ?
----------xxx---SS?SX--------S--E---SSSSSSSSSSSX--------------------------xxx----------oo-----------------x--x-----------------------xx-[]--x-------------xx----
-----E---xxX-x-----------------------------------------------------------xxX-x---------oo--xxxxxx-------xxx---x---------------------xx--[]---x-------E---xx-----
--------xx-X--x--------------------------------xxx----------------------xx-X--xxxxxxxxxxxxxx---X-x-----xx<>----xxxxxxxxxxxxxxxxxxxxxx---[]----xxxxxxxxxxxx--X---
xxxxxxxxx--X---xxxxxxxxxxxxxxxxxxxxxxxxxxxxxxxxx--xxxxxxxxxxxxxxxxxxxxxxx--X--XXXXXXXXXXXXXX---X--xxxxxx-[]XXXXXXXXXXXXXXXXXXXXXXXXXXXXXXXXXXXXXXEEXXXXXXXXXXXXX
XXXXXXXXXXXXXXXXXXXXXXXXXXXXXXXXXXXXXXXXXXXXXXXX--XXXXXXXXXXXXXXXXXXXXXXXXXXX-XXXXXXXXXXXXXX---X--XXXXXXXXXXXXXXXXXXXXXXXXXXXXXXXXXXXXXXXXXXXXXXXXXXXXXXXXXXXXXX